Frameno_fix,lineno_fix,Tokenname_fix,tokens_id,gaze_X_fix,gaze_Y_fix,timestamp_fix_start,timestamp_fix_end,time_duration
100,0,blank,0,105.21238,-79.31954,4259,4391,132
100,0,blank,0,-323,-105,4421,4526,105
100,0,blank,0,139.5287,-43.5097,4556,4597,41
100,0,blank,0,128.230566666667,-26.8796333333333,4654,4729,75
100,0,blank,0,538.11556,22.09958,4786,4951,165
100,0,blank,0,415.2013,-38.88265,5052,5118,66
100,0,blank,0,479.1204,-31.30675,5156,5231,75
100,0,blank,0,456.8718,-2.39785000000001,5269,5346,77
100,0,blank,0,420.00998,-1.1106,5417,5594,177
100,1,to,5,136.51635,5.78305,5633,5819,186
100,0,blank,0,453.451575,-5.867875,5848,5963,115
100,0,blank,0,-323,-105,5992,6171,179
100,0,blank,0,-323,-105,6171,6350,179
100,0,blank,0,-323,-105,6350,6538,188
100,0,blank,0,-323,-105,6538,6667,129
100,0,blank,0,-323,-105,6667,6742,75
100,29,multiply,208,128.907066666667,633.481433333333,6796,6992,196
100,29,multiply,208,135.6278,632.6142,6992,7025,33
100,0,blank,0,-323,-105,7095,7159,64
100,0,blank,0,-323,-105,7159,7833,674
100,0,blank,0,-323,-105,7833,7995,162
100,0,blank,0,374.105366666667,112.8347,8029,8201,172
100,7,"EnterrowsandcolumnsforMatrixArespectively:",69,429.731,137.9698,8201,8241,40
100,0,blank,0,113.87205,137.9265,8279,8357,78
100,0,blank,0,84.86122,113.58298,8438,8633,195
100,5,[,44,96.58996,105.8472,8633,8826,193
100,5,10,45,157.8007,92.4392333333333,8826,9002,176
100,0,blank,0,-323,-105,9031,9137,106
100,0,blank,0,230.342833333333,80.56205,9227,9395,168
100,0,blank,0,375.97535,84.3010333333333,9425,9600,175
100,0,blank,0,331.39075,88.1289833333333,9600,9777,177
100,5,10,45,331.965233333333,100.357666666667,9777,9864,87
100,5,10,45,123.940716666667,103.356416666667,9893,10069,176
100,5,],46,388.589716666667,104.762766666667,10098,10272,174
100,5,],46,386.3435,94.4341,10272,10301,29
100,0,blank,0,-323,-105,10330,10434,104
100,5,10,45,117.5453,95.1039,10460,10488,28
100,0,blank,0,123.248928571429,91.9867285714286,10549,10744,195
100,0,blank,0,133.929275,98.92505,10744,10860,116
100,5,comma,39,285.2537,103.910116666667,10890,11065,175
100,6,i,61,246.37605,115.123183333333,11065,11240,175
100,6,comma,64,184.900683333333,127.627083333333,11240,11416,176
100,0,blank,0,-323,-105,11446,11500,54
100,0,blank,0,113.9221,251.7864,11525,11551,26
100,5,10,45,122.271,107.733985714286,11605,11795,190
100,5,[,44,101.06475,98.6541,11795,11971,176
100,5,10,45,105.07755,97.22895,11971,12144,173
100,5,int,23,65.8608666666667,98.4708666666667,12144,12317,173
100,0,blank,0,55.8907,79.8022,12317,12345,28
100,0,blank,0,-323,-105,12403,12482,79
100,1,Multiplication,8,416.257814285714,15.3563285714286,12572,12763,191
100,1,Multiplication,8,449.67545,5.2816,12763,12938,175
100,0,blank,0,469.2037,-4.51730000000001,12938,12967,29
100,0,blank,0,205.539316666667,51.4441166666667,12997,13173,176
100,0,blank,0,62.8854,88.6907333333333,13173,13346,173
100,5,int,23,59.858325,107.73295,13346,13462,116
100,0,blank,0,-323,-105,13491,13570,79
100,5,int,23,68.3562714285714,92.7036142857143,13655,13847,192
100,5,int,23,68.6362,99.6147,13847,13876,29
100,0,blank,0,332.640366666667,89.7402333333333,13904,14075,171
100,5,],46,385.15715,110.86525,14075,14247,172
100,5,{,48,423.75405,105.4387,14247,14419,172
100,5,{,48,432.7343,94.58995,14419,14475,56
100,6,n1,55,140.623528571429,115.188342857143,14504,14703,199
100,6,comma,64,149.01925,121.16665,14703,14875,172
100,0,blank,0,243.018933333333,99.8798,14875,15046,171
100,6,k,65,312.949916666667,116.285883333333,15046,15220,174
100,5,10,45,339.459933333333,109.474633333333,15220,15392,172
100,6,;,66,314.818,116.9685,15392,15449,57
100,0,blank,0,406.54705,117.656416666667,15478,15650,172
100,0,blank,0,403.343116666667,126.19325,15650,15823,173
100,5,],46,387.6236,95.6501285714286,15823,16022,199
100,0,blank,0,407.1348,117.610566666667,16022,16194,172
100,0,blank,0,394.853733333333,90.9893833333334,16194,16366,172
100,0,blank,0,352.1988,99.355975,16366,16480,114
100,5,[,44,97.3797833333333,102.609816666667,16508,16680,172
100,0,blank,0,-323,-105,16708,16762,54
100,0,blank,0,136.7678,245.7342,16787,16812,25
100,0,blank,0,124.646085714286,80.7348857142857,16871,17062,191
100,0,blank,0,285.99,86.0572333333333,17090,17262,172
100,0,blank,0,283.234771428571,101.840785714286,17262,17461,199
100,5,=,47,411.328357142857,100.175171428571,17490,17688,198
100,0,blank,0,400.248328571429,98.7876285714286,17688,17886,198
100,0,blank,0,402.917516666667,104.924366666667,17886,18058,172
100,5,=,47,405.176116666667,110.68215,18058,18228,170
100,5,=,47,406.178233333333,108.192433333333,18228,18313,85
100,0,blank,0,-323,-105,18341,18419,78
100,0,blank,0,369.5723,83.926,18445,18485,40
100,5,10,45,363.87704,107.96426,18548,18682,134
100,0,blank,0,180.71778,90.11018,18710,18866,156
100,0,blank,0,39.54735,70.8996,18920,19108,188
100,3,main,19,52.0385333333333,53.4549666666667,19108,19285,177
100,3,main,19,79.6453333333333,57.4688166666667,19285,19458,173
100,3,(,20,85.5861,65.2559,19458,19516,58
100,0,blank,0,-323,-105,19545,19599,54
100,0,blank,0,410.5582,242.1419,19624,19650,26
100,0,blank,0,399.774528571429,-2.67561428571428,19713,19908,195
100,1,Multiplication,8,404.50425,15.645,19908,19967,59
100,0,blank,0,-323,-105,19997,20178,181
100,0,blank,0,-323,-105,20178,20365,187
100,0,blank,0,-323,-105,20365,20539,174
100,0,blank,0,-323,-105,20539,20718,179
100,0,blank,0,-323,-105,20718,20749,31
100,0,blank,0,-323,-105,20749,20945,196
100,0,blank,0,-323,-105,20945,21141,196
100,0,blank,0,-323,-105,21141,21312,171
100,0,blank,0,-323,-105,21312,21494,182
100,0,blank,0,-323,-105,21494,21675,181
100,0,blank,0,-323,-105,21879,22078,199
100,0,blank,0,-323,-105,22078,22254,176
100,0,blank,0,-323,-105,22254,22424,170
100,0,blank,0,-323,-105,22424,22595,171
100,0,blank,0,-323,-105,22595,22743,148
100,0,blank,0,-323,-105,22743,22926,183
100,0,blank,0,-323,-105,22926,23071,145
100,0,blank,0,-323,-105,23071,23244,173
100,0,blank,0,-323,-105,23244,23416,172
100,0,blank,0,-323,-105,23416,23592,176
100,0,blank,0,-323,-105,23592,23733,141
100,0,blank,0,-323,-105,23733,23852,119
100,0,blank,0,-323,-105,23852,24004,152
100,0,blank,0,-323,-105,24004,24209,205
100,0,blank,0,-323,-105,24209,24373,164
100,0,blank,0,-323,-105,24373,24553,180
100,0,blank,0,-323,-105,24553,24749,196
100,0,blank,0,-323,-105,24749,24934,185
100,0,blank,0,-323,-105,24934,25094,160
100,0,blank,0,-323,-105,25094,25221,127
100,0,blank,0,-323,-105,25221,25378,157
100,0,blank,0,-323,-105,25378,25542,164
100,0,blank,0,-323,-105,25542,25724,182
100,0,blank,0,-323,-105,25724,25866,142
100,0,blank,0,-323,-105,25866,26060,194
100,0,blank,0,-323,-105,26060,26205,145
100,0,blank,0,-323,-105,26205,26395,190
100,0,blank,0,-323,-105,26395,26439,44
100,0,blank,0,-323,-105,26439,26678,239
100,0,blank,0,-323,-105,26678,26709,31
100,0,blank,0,-323,-105,26709,26972,263
100,0,blank,0,-323,-105,26972,27231,259
100,0,blank,0,-323,-105,27231,27294,63
100,0,blank,0,-323,-105,27294,27642,348
100,0,blank,0,-323,-105,27642,27695,53
100,0,blank,0,-323,-105,27695,27870,175
100,0,blank,0,-323,-105,27870,28094,224
100,0,blank,0,-323,-105,28094,28125,31
100,0,blank,0,-323,-105,28125,28440,315
100,0,blank,0,-323,-105,28440,28616,176
100,0,blank,0,-323,-105,28616,28828,212
100,0,blank,0,-323,-105,28828,29124,296
100,0,blank,0,-323,-105,29124,29375,251
100,0,blank,0,-323,-105,29375,29700,325
100,0,blank,0,-323,-105,29700,29737,37
100,0,blank,0,-323,-105,29737,29995,258
100,0,blank,0,-323,-105,29995,30249,254
100,0,blank,0,-323,-105,30249,30503,254
100,0,blank,0,-323,-105,30503,30680,177
100,0,blank,0,-323,-105,30680,30798,118
100,0,blank,0,-323,-105,30798,30979,181
100,0,blank,0,-323,-105,30979,31004,25
100,0,blank,0,-323,-105,31004,31202,198
100,0,blank,0,-323,-105,31202,31406,204
100,0,blank,0,-323,-105,31406,31630,224
100,0,blank,0,-323,-105,31630,31820,190
100,0,blank,0,-323,-105,31820,31975,155
100,0,blank,0,-323,-105,31975,32151,176
100,0,blank,0,-323,-105,32151,32339,188
100,0,blank,0,-323,-105,32339,32508,169
100,0,blank,0,-323,-105,32508,32605,97
100,0,blank,0,-323,-105,32605,32780,175
100,0,blank,0,-323,-105,32780,32971,191
100,0,blank,0,-323,-105,32971,33112,141
100,0,blank,0,-323,-105,33112,33300,188
100,0,blank,0,-323,-105,33300,33480,180
100,0,blank,0,-323,-105,33480,33640,160
100,0,blank,0,-323,-105,33640,33823,183
100,0,blank,0,-323,-105,33823,33946,123
100,0,blank,0,-323,-105,33946,34044,98
100,0,blank,0,-323,-105,34044,34198,154
100,0,blank,0,-323,-105,34198,34282,84
100,0,blank,0,-323,-105,34282,34414,132
100,0,blank,0,-323,-105,34414,34586,172
100,0,blank,0,-323,-105,34586,34697,111
100,0,blank,0,-323,-105,35478,35632,154
100,0,blank,0,-323,-105,35632,35827,195
100,0,blank,0,-323,-105,35827,36011,184
100,0,blank,0,-323,-105,36011,36056,45
100,0,blank,0,-323,-105,36056,36418,362
100,0,blank,0,-323,-105,36479,36655,176
100,0,blank,0,-323,-105,36655,36834,179
100,0,blank,0,-323,-105,36834,37009,175
100,0,blank,0,-323,-105,37009,37101,92
100,0,blank,0,-323,-105,37193,37381,188
100,0,blank,0,-323,-105,37381,37560,179
100,0,blank,0,-323,-105,37560,37753,193
100,0,blank,0,-323,-105,37753,37893,140
100,0,blank,0,-323,-105,38155,38831,676
100,0,blank,0,-323,-105,38831,38997,166
100,0,blank,0,-323,-105,38997,39103,106
100,8,&,79,184.2778,166.5302,39227,39306,79
100,8,"%d%d",74,124.3376,176.7083,39306,39428,122
100,5,10,45,158.2685,95.9488,39642,39719,77
100,8,"%d%d",74,161.475433333333,169.61425,39758,39942,184
100,8,n1,80,261.435533333333,157.503433333333,39942,40049,107
100,0,blank,0,404.44424,176.5391,40076,40217,141
100,9,"EnterrowsandcolumnsforMatrixBrespectively:",85,574.715142857143,194.795142857143,40245,40440,195
100,9,"EnterrowsandcolumnsforMatrixBrespectively:",85,523.034814285714,189.704971428571,40440,40634,194
100,0,blank,0,451.0419,171.044528571429,40634,40828,194
100,0,blank,0,402.606125,166.69,40828,40939,111
100,0,blank,0,-323,-105,40968,41046,78
100,0,blank,0,312.770166666667,176.0122,41151,41225,74
100,9,"EnterrowsandcolumnsforMatrixBrespectively:",85,165.066357142857,190.4392,41250,41442,192
100,9,"EnterrowsandcolumnsforMatrixBrespectively:",85,173.28716,195.61484,41442,41629,187
100,9,"EnterrowsandcolumnsforMatrixBrespectively:",85,161.55955,192.758366666667,41629,41788,159
100,0,blank,0,455.2207,174.0109,41843,42032,189
100,7,"EnterrowsandcolumnsforMatrixArespectively:",69,451.38084,155.84226,42032,42165,133
100,9,"EnterrowsandcolumnsforMatrixBrespectively:",85,588.410975,183.965825,42192,42301,109
100,7,"EnterrowsandcolumnsforMatrixArespectively:",69,145.67546,149.71398,42357,42545,188
100,8,&,79,241.240016666667,166.409683333333,42545,42732,187
100,8,m1,77,208.514466666667,172.106733333333,42732,42915,183
100,8,"%d%d",74,131.9029,165.4855,42915,42942,27
100,0,blank,0,-323,-105,42998,43048,50
100,23,"\nEnterelementsinMatrixB:\n",163,245.2351,488.1262,43074,43099,25
100,8,comma,78,215.688485714286,173.754228571429,43152,43337,185
100,9,"EnterrowsandcolumnsforMatrixBrespectively:",85,252.1426,184.23638,43337,43521,184
100,9,"EnterrowsandcolumnsforMatrixBrespectively:",85,250.57765,189.365325,43521,43633,112
100,9,"EnterrowsandcolumnsforMatrixBrespectively:",85,441.255166666667,195.3121,43688,43816,128
100,9,"EnterrowsandcolumnsforMatrixBrespectively:",85,430.0859,196.76195,43816,43966,150
100,9,"EnterrowsandcolumnsforMatrixBrespectively:",85,364.99808,193.93266,43966,44152,186
100,9,"EnterrowsandcolumnsforMatrixBrespectively:",85,341.270416666667,190.64685,44152,44313,161
100,7,"EnterrowsandcolumnsforMatrixArespectively:",69,280.05965,152.49725,44313,44469,156
100,9,"EnterrowsandcolumnsforMatrixBrespectively:",85,284.61454,180.8346,44469,44651,182
100,8,&,79,240.4762,163.884133333333,44651,44734,83
100,0,blank,0,452.7831,172.432866666667,44762,44954,192
100,0,blank,0,509.04275,207.580575,44954,45135,181
100,0,blank,0,515.8248,176.1117,45135,45187,52
100,8,&,79,188.9261,173.65594,45237,45370,133
100,0,blank,0,-323,-105,45423,45526,103
100,9,"EnterrowsandcolumnsforMatrixBrespectively:",85,173.847614285714,180.980571428571,45602,45784,182
100,9,"EnterrowsandcolumnsforMatrixBrespectively:",85,167.12105,198.38,45784,45974,190
100,10,n2,96,248.710471428571,209.539342857143,45974,46168,194
100,9,"EnterrowsandcolumnsforMatrixBrespectively:",85,222.743171428571,199.209857142857,46168,46362,194
100,10,"%d%d",90,120.410271428571,212.2644,46362,46556,194
100,0,blank,0,141.3108,230.1162,46556,46752,196
100,0,blank,0,172.05906,214.25698,46752,46941,189
100,13,"Matrixmultiplicationnotpossible.\n",108,173.27312,271.01952,46941,47123,182
100,13,"Matrixmultiplicationnotpossible.\n",108,172.4476,267.3477,47123,47148,25
100,0,blank,0,328.072483333333,258.975866666667,47173,47363,190
100,0,blank,0,246.290283333333,250.684316666667,47363,47531,168
100,0,blank,0,-323,-105,47587,47640,53
100,0,blank,0,472.3443,238.7227,47665,47691,26
100,0,blank,0,-323,-105,47716,47875,159
100,0,blank,0,454.5352,261.3812,47933,48005,72
100,0,blank,0,422.996616666667,264.11925,48096,48282,186
100,10,"%d%d",90,118.039157142857,219.670942857143,48307,48503,196
100,10,comma,94,165.474371428571,216.399271428571,48503,48701,198
100,10,&,95,182.306057142857,220.674257142857,48701,48898,197
100,10,comma,94,165.999833333333,202.465583333333,48898,49088,190
100,9,"EnterrowsandcolumnsforMatrixBrespectively:",85,139.80448,192.64158,49088,49272,184
100,9,"EnterrowsandcolumnsforMatrixBrespectively:",85,134.39125,183.06765,49272,49329,57
100,8,&,79,239.727857142857,159.8009,49356,49552,196
100,0,blank,0,234.000842857143,120.569757142857,49552,49751,199
100,5,10,45,255.904766666667,108.77,49751,49944,193
100,8,n1,80,256.63654,170.44618,49944,50110,166
100,10,&,95,243.4898,206.0099,50110,50218,108
100,0,blank,0,-323,-105,50243,50421,178
100,0,blank,0,-323,-105,50421,50597,176
100,0,blank,0,-323,-105,50597,50768,171
100,0,blank,0,-323,-105,50768,50875,107
100,0,blank,0,163.812866666667,345.184333333333,50910,51056,146
100,17,"EnterelementsinMatrixA:\n",116,168.732525,355.2518,51056,51207,151
100,0,blank,0,280.073433333333,340.634166666667,51265,51444,179
100,0,blank,0,243.2662,340.0119,51444,51469,25
100,0,blank,0,422.368342857143,379.693742857143,51519,51706,187
100,0,blank,0,421.148366666667,382.768266666667,51706,51817,111
100,0,blank,0,-323,-105,51841,51920,79
100,0,blank,0,367.6909,424.4163,51946,51971,25
100,17,"EnterelementsinMatrixA:\n",116,342.493616666667,371.687533333333,52022,52201,179
100,0,blank,0,337.72965,345.52335,52201,52258,57
100,17,"EnterelementsinMatrixA:\n",116,169.320475,374.106375,52286,52476,190
100,17,"EnterelementsinMatrixA:\n",116,197.72855,369.8811,52476,52526,50
100,18,i,129,284.66018,388.65248,52603,52778,175
100,0,blank,0,225.073625,442.279475,52778,52960,182
100,21,"%d",148,207.9363,444.0116,52960,52985,25
100,0,blank,0,-323,-105,53040,53117,77
100,0,blank,0,248.91945,425.376116666667,53193,53353,160
100,0,blank,0,234.72118,589.11348,53411,53547,136
100,0,blank,0,199.359266666667,397.288933333333,53604,53708,104
100,0,blank,0,-323,-105,53786,53963,177
100,17,"EnterelementsinMatrixA:\n",116,250.0561,367.499066666667,54067,54142,75
100,0,blank,0,411.317166666667,377.658683333333,54168,54341,173
100,0,blank,0,389.93915,353.8455,54341,54399,58
100,17,"EnterelementsinMatrixA:\n",116,218.772033333333,356.08175,54427,54620,193
100,17,"EnterelementsinMatrixA:\n",116,308.460314285714,364.251757142857,54620,54818,198
100,17,"EnterelementsinMatrixA:\n",116,388.489183333333,363.7894,54818,54990,172
100,17,"EnterelementsinMatrixA:\n",116,451.81465,371.3372,54990,55130,140
100,0,blank,0,153.93524,352.5418,55155,55345,190
100,17,printf,114,142.184866666667,367.444866666667,55345,55475,130
100,18,++,130,295.112666666667,390.7392,55551,55738,187
100,17,"EnterelementsinMatrixA:\n",116,232.69238,364.86244,55738,55882,144
100,0,blank,0,-323,-105,55939,55989,50
100,0,blank,0,169.8437,486.0332,56014,56040,26
100,17,"EnterelementsinMatrixA:\n",116,223.98324,356.46322,56089,56265,176
100,0,blank,0,151.003671428571,354.975385714286,56318,56502,184
100,0,blank,0,155.49942,349.6939,56502,56668,166
100,0,blank,0,166.605475,337.02075,56668,56796,128
100,0,blank,0,286.85242,342.46868,56824,57009,185
100,17,"EnterelementsinMatrixA:\n",116,436.31718,366.4168,57036,57221,185
100,0,blank,0,450.28565,376.36155,57221,57337,116
100,0,blank,0,151.74225,384.831183333333,57366,57540,174
100,18,;,128,186.595,396.1865,57540,57684,144
100,18,<,126,226.332,380.422133333333,57684,57867,183
100,0,blank,0,325.244566666667,381.81415,57892,58090,198
100,18,++,130,300.79265,389.966783333333,58090,58253,163
100,17,"EnterelementsinMatrixA:\n",116,291.03648,372.4084,58253,58444,191
100,17,"EnterelementsinMatrixA:\n",116,278.69655,370.7039,58444,58498,54
100,0,blank,0,-323,-105,58527,58606,79
100,0,blank,0,363.131,481.6237,58632,58657,25
100,17,"EnterelementsinMatrixA:\n",116,366.952271428571,371.544957142857,58708,58896,188
100,0,blank,0,350.8408,386.5327,58896,58924,28
100,18,=,122,159.402285714286,383.302657142857,58982,59174,192
100,17,printf,114,138.441,374.658675,59174,59362,188
100,0,blank,0,205.791233333333,424.452333333333,59362,59524,162
100,0,blank,0,216.134466666667,440.0813,59524,59689,165
100,19,j,142,203.11365,418.15785,59689,59829,140
100,0,blank,0,184.573,422.20365,59829,59994,165
100,19,0,136,179.64635,400.769375,59994,60152,158
100,0,blank,0,200.516725,352.613,60152,60330,178
100,17,"EnterelementsinMatrixA:\n",116,208.30202,371.4566,60330,60516,186
100,17,"EnterelementsinMatrixA:\n",116,180.7604,368.164466666667,60516,60622,106
100,0,blank,0,366.308933333333,399.824,60647,60777,130
100,0,blank,0,355.582,406.39425,60777,60953,176
100,0,blank,0,338.940116666667,380.765216666667,60953,61140,187
100,18,(,120,132.493166666667,382.57305,61170,61362,192
100,0,blank,0,147.762933333333,406.0897,61362,61533,171
100,21,scanf,146,137.78045,453.041766666667,61533,61705,172
100,21,scanf,146,135.43034,459.25572,61705,61848,143
100,0,blank,0,159.7524,485.9249,61848,62014,166
100,23,"\nEnterelementsinMatrixB:\n",163,167.737316666667,489.5627,62014,62206,192
100,0,blank,0,174.47324,482.2394,62206,62400,194
100,23,"\nEnterelementsinMatrixB:\n",163,172.371457142857,503.154642857143,62400,62594,194
100,24,<,173,228.637733333333,510.8419,62594,62752,158
100,23,"\nEnterelementsinMatrixB:\n",163,257.173075,506.9586,62752,62904,152
100,0,blank,0,-323,-105,62931,63011,80
100,0,blank,0,285.335,348.0136,63037,63075,38
100,17,"EnterelementsinMatrixA:\n",116,272.5855,365.7707,63135,63313,178
100,0,blank,0,192.028416666667,381.783266666667,63313,63496,183
100,18,;,128,184.61435,394.507,63524,63637,113
100,18,),131,316.696666666667,384.339266666667,63666,63829,163
100,18,),131,320.358566666667,383.724566666667,63829,64004,175
100,0,blank,0,345.24652,387.44074,64004,64189,185
100,17,"EnterelementsinMatrixA:\n",116,327.442083333333,358.5994,64189,64375,186
100,17,"EnterelementsinMatrixA:\n",116,317.978025,356.6859,64375,64516,141
100,0,blank,0,-323,-105,64570,64767,197
100,0,blank,0,-323,-105,64767,64917,150
100,18,i,129,205.105757142857,391.717257142857,64944,65133,189
100,18,;,128,187.874833333333,380.744166666667,65133,65220,87
100,0,blank,0,346.316416666667,428.9751,65278,65453,175
100,0,blank,0,135.164133333333,420.885966666667,65481,65649,168
100,19,(,133,131.31318,415.93524,65649,65823,174
100,21,scanf,146,140.333325,454.504025,65823,66011,188
100,21,scanf,146,145.162871428571,454.774757142857,66011,66202,191
100,23,(,162,150.986475,507.317225,66202,66343,141
100,19,j,142,141.048833333333,417.768983333333,66368,66562,194
100,17,printf,114,117.16415,373.88385,66562,66612,50
100,0,blank,0,-323,-105,66641,66720,79
100,0,blank,0,248.0287,343.397,66745,66771,26
100,17,"EnterelementsinMatrixA:\n",116,285.850885714286,371.448385714286,66823,67011,188
100,0,blank,0,347.06622,383.72186,67011,67156,145
100,0,blank,0,347.072325,400.917725,67156,67316,160
100,0,blank,0,-323,-105,67346,67474,128
100,0,blank,0,323.3496,420.0178,67500,67526,26
100,18,i,129,293.85334,385.2943,67573,67726,153
100,19,++,143,302.199933333333,406.929933333333,67726,67834,108
100,19,;,141,186.541533333333,407.364666666667,67895,67972,77
100,0,blank,0,169.870685714286,401.070014285714,68056,68248,192
100,17,"EnterelementsinMatrixA:\n",116,161.84652,361.9827,68248,68411,163
100,18,;,128,191.3116,386.7242,68411,68468,57
100,0,blank,0,360.189657142857,392.758114285714,68543,68733,190
100,0,blank,0,363.456314285714,392.086642857143,68733,68932,199
100,0,blank,0,357.586133333333,384.7095,68932,69127,195
100,0,blank,0,370.386116666667,426.198266666667,69127,69319,192
100,0,blank,0,347.4384,407.81505,69319,69512,193
100,0,blank,0,337.144766666667,393.1122,69512,69686,174
100,17,"EnterelementsinMatrixA:\n",116,156.479766666667,374.5391,69768,69842,74
100,0,blank,0,-323,-105,69869,69974,105
100,17,"EnterelementsinMatrixA:\n",116,199.9604,366.5366,70035,70108,73
100,0,blank,0,346.55355,399.427783333333,70199,70388,189
100,0,blank,0,345.58195,409.621766666667,70388,70579,191
100,0,blank,0,347.48525,404.39675,70579,70636,57
100,0,blank,0,-323,-105,70664,70743,79
100,21,[,155,295.7617,456.5312,70769,70794,25
100,18,),131,315.0033,389.732216666667,70847,71026,179
100,0,blank,0,360.5312,404.5747,71026,71162,136
100,0,blank,0,-323,-105,71219,71296,77
100,0,blank,0,338.9678,404.22545,71321,71472,151
100,0,blank,0,353.873333333333,418.446666666667,71472,71671,199
100,0,blank,0,352.5976,378.34874,71671,71804,133
100,0,blank,0,370.734775,403.51995,71804,71987,183
100,0,blank,0,361.6716,387.06215,71987,72040,53
100,0,blank,0,197.26924,408.42416,72146,72296,150
100,19,0,136,174.00445,416.3785,72296,72403,107
100,0,blank,0,343.59875,409.736075,72478,72657,179
100,0,blank,0,239.427516666667,390.4343,72657,72844,187
100,18,<,126,230.057983333333,380.804233333333,72844,73032,188
100,0,blank,0,-323,-105,73089,73165,76
100,0,blank,0,357.22445,404.32355,73253,73436,183
100,23,"\nEnterelementsinMatrixB:\n",163,280.9487,501.40852,73465,73649,184
100,0,blank,0,256.6766,465.88345,73649,73807,158
100,0,blank,0,268.05355,475.7918,73807,73882,75
100,0,blank,0,438.051175,420.35415,73907,74085,178
100,0,blank,0,-323,-105,74140,74318,178
100,0,blank,0,-323,-105,74318,74504,186
100,0,blank,0,-323,-105,74504,74688,184
100,0,blank,0,-323,-105,74688,74729,41
100,21,(,147,178.522933333333,446.030716666667,74771,74965,194
100,0,blank,0,145.25245,404.0572,74965,75146,181
100,0,blank,0,123.91095,455.912266666667,75146,75329,183
100,24,i,176,138.01135,511.6002,75329,75514,185
100,0,blank,0,141.231666666667,485.628166666667,75514,75701,187
100,23,"\nEnterelementsinMatrixB:\n",163,226.77245,496.951025,75701,75824,123
100,23,"\nEnterelementsinMatrixB:\n",163,333.1205,504.9229,75855,76041,186
100,0,blank,0,338.4904,508.96785,76041,76103,62
100,24,=,169,159.64785,528.932766666667,76134,76321,187
100,25,=,182,159.071666666667,539.864483333333,76321,76508,187
100,0,blank,0,133.41815,571.751766666667,76508,76691,183
100,27,scanf,193,138.4587,575.65028,76691,76848,157
100,0,blank,0,-323,-105,76909,76988,79
100,0,blank,0,150.0272,522.1915,77014,77040,26
100,0,blank,0,125.43355,421.016583333333,77104,77283,179
100,0,blank,0,117.339166666667,389.8728,77283,77469,186
100,18,i,129,142.385075,380.299325,77469,77590,121
100,0,blank,0,-323,-105,77623,77766,143
100,17,"EnterelementsinMatrixA:\n",116,216.675883333333,371.0257,77888,78070,182
100,0,blank,0,167.77845,383.575516666667,78070,78250,180
100,0,blank,0,202.6614,378.056333333333,78250,78441,191
100,0,blank,0,278.957783333333,380.381633333333,78441,78618,177
100,19,++,143,307.960316666667,399.258516666667,78618,78795,177
100,17,"EnterelementsinMatrixA:\n",116,328.7312,375.512083333333,78795,78975,180
100,17,"EnterelementsinMatrixA:\n",116,312.81654,357.03556,78975,79126,151
100,0,blank,0,-323,-105,79157,79213,56
100,0,blank,0,295.37355,341.22795,79317,79428,111
100,0,blank,0,121.977066666667,387.858166666667,79458,79643,185
100,0,blank,0,117.09608,388.19012,79643,79794,151
100,18,(,120,129.353366666667,393.265883333333,79854,80043,189
100,0,blank,0,122.3881,387.92605,80043,80211,168
100,23,printf,161,132.33245,495.6069,80211,80402,191
100,0,blank,0,132.035816666667,469.005266666667,80402,80599,197
100,0,blank,0,114.27235,466.8138,80599,80663,64
100,0,blank,0,-323,-105,80725,80881,156
100,0,blank,0,197.666128571429,382.318042857143,80910,81107,197
100,0,blank,0,234.660633333333,412.1092,81107,81192,85
100,23,"\nEnterelementsinMatrixB:\n",163,314.173814285714,494.089971428571,81249,81435,186
100,0,blank,0,363.288633333333,537.873833333333,81435,81518,83
100,25,),191,319.443933333333,546.2037,81574,81751,177
100,23,"\nEnterelementsinMatrixB:\n",163,328.045516666667,492.16235,81751,81939,188
100,0,blank,0,322.997833333333,460.3597,81967,82054,87
100,0,blank,0,-323,-105,82083,82239,156
100,0,blank,0,383.68264,425.35734,82263,82462,199
100,0,blank,0,364.51446,408.20638,82462,82650,188
100,0,blank,0,362.18588,421.48538,82650,82818,168
100,0,blank,0,357.036066666667,436.718766666667,82818,82945,127
100,0,blank,0,-323,-105,82999,83075,76
100,0,blank,0,277.5319,527.7836,83100,83126,26
100,0,blank,0,196.6179,415.00125,83176,83354,178
100,0,blank,0,168.9044,379.3247,83354,83428,74
100,0,blank,0,-323,-105,83505,83682,177
100,0,blank,0,-323,-105,83682,83707,25
100,0,blank,0,215.742525,419.793425,83732,83833,101
100,0,blank,0,220.340833333333,436.272833333333,83890,83990,100
100,0,blank,0,364.0847,450.273,84015,84173,158
100,0,blank,0,-323,-105,84222,84299,77
100,0,blank,0,277.4696,384.4973,84324,84350,26
100,18,++,130,297.98495,395.1219,84464,84589,125
100,0,blank,0,374.6247,421.8407,84589,84669,80
100,18,++,130,312.6118,390.3982,84669,84845,176
100,0,blank,0,360.705866666667,386.6771,84845,85044,199
100,0,blank,0,327.239133333333,385.582533333333,85044,85143,99
100,19,j,142,288.5839,411.34275,85143,85269,126
100,0,blank,0,282.8669,408.4846,85269,85444,175
100,21,j,156,304.0692,450.813,85444,85493,49
100,0,blank,0,267.446825,351.5296,85519,85698,179
100,17,"EnterelementsinMatrixA:\n",116,240.4028,362.711766666667,85798,85872,74
100,0,blank,0,-323,-105,85897,86075,178
100,0,blank,0,-323,-105,86075,86253,178
100,0,blank,0,-323,-105,86253,86436,183
100,0,blank,0,-323,-105,86436,86629,193
100,0,blank,0,-323,-105,86629,86710,81
100,0,blank,0,-323,-105,86710,86886,176
100,0,blank,0,-323,-105,86886,87074,188
100,0,blank,0,-323,-105,87074,87593,519
100,0,blank,0,-323,-105,87593,87774,181
100,0,blank,0,-323,-105,87774,87925,151
100,0,blank,0,-323,-105,87925,88157,232
100,0,blank,0,-323,-105,88157,88335,178
100,0,blank,0,-323,-105,88335,88476,141
100,0,blank,0,-323,-105,88476,88687,211
100,0,blank,0,-323,-105,88687,89277,590
100,0,blank,0,-323,-105,89277,89493,216
100,0,blank,0,-323,-105,89493,89553,60
100,0,blank,0,-323,-105,89553,89802,249
100,0,blank,0,-323,-105,91638,91921,283
100,17,printf,114,121.3539,369.7071,92669,92727,58
100,17,printf,114,117.116125,373.030725,92822,92931,109
100,9,printf,83,84.0711,199.3767,92961,93052,91
100,1,Program,4,67.41335,13.3825666666667,93082,93266,184
100,1,Program,4,101.6344,21.4593333333333,93266,93448,182
100,2,include,12,65.38495,30.96985,93448,93571,123
100,0,blank,0,-323,-105,93661,93768,107
100,0,blank,0,152.4057,407.9394,93794,93819,25
100,0,blank,0,163.68395,398.92125,93872,94042,170
100,0,blank,0,212.1382,376.61395,94042,94222,180
100,17,"EnterelementsinMatrixA:\n",116,257.083366666667,359.380616666667,94222,94400,178
100,17,"EnterelementsinMatrixA:\n",116,221.055983333333,375.862,94400,94579,179
100,0,blank,0,-323,-105,94608,94741,133
100,17,"EnterelementsinMatrixA:\n",116,228.25765,364.301983333333,94769,94938,169
100,17,"EnterelementsinMatrixA:\n",116,199.358216666667,372.627283333333,94938,95121,183
100,0,blank,0,197.851383333333,378.965866666667,95121,95304,183
100,0,blank,0,222.5846,400.284716666667,95304,95483,179
100,19,<,139,232.9036,400.439516666667,95483,95665,182
100,0,blank,0,248.305033333333,424.3222,95665,95846,181
100,0,blank,0,247.192516666667,431.730633333333,95846,96029,183
100,0,blank,0,-323,-105,96060,96116,56
100,25,<,186,228.2045,537.7791,96141,96167,26
100,0,blank,0,217.849516666667,399.043016666667,96218,96388,170
100,0,blank,0,236.548433333333,419.10965,96388,96575,187
100,0,blank,0,244.1166,426.674866666667,96575,96759,184
100,0,blank,0,202.877883333333,388.3734,96759,96941,182
100,0,blank,0,215.345266666667,382.826666666667,96941,97122,181
100,0,blank,0,220.589625,378.05105,97122,97244,122
100,0,blank,0,-323,-105,97275,97330,55
100,0,blank,0,149.1818,783.8722,97355,97381,26
100,0,blank,0,216.56292,347.97586,97613,97802,189
100,17,"EnterelementsinMatrixA:\n",116,202.06895,367.12905,97802,97892,90
100,0,blank,0,-323,-105,97937,98123,186
100,0,blank,0,-323,-105,98123,98301,178
100,0,blank,0,-323,-105,98301,98414,113
100,0,blank,0,-323,-105,98414,98515,101
100,0,blank,0,-323,-105,98515,98645,130
100,0,blank,0,-323,-105,98645,99033,388
100,0,blank,0,-323,-105,99033,99205,172
100,0,blank,0,-323,-105,99205,99326,121
100,0,blank,0,-323,-105,99326,99525,199
100,0,blank,0,-323,-105,99525,99689,164
100,0,blank,0,-323,-105,99689,99875,186
100,0,blank,0,-323,-105,99875,100029,154
100,0,blank,0,-323,-105,100029,100268,239
100,0,blank,0,-323,-105,100268,100848,580
100,0,blank,0,-323,-105,100848,101018,170
100,0,blank,0,-323,-105,101018,101188,170
100,0,blank,0,-323,-105,101188,101374,186
100,0,blank,0,-323,-105,101374,101550,176
100,9,printf,83,103.37188,184.31552,101625,101784,159
100,8,m1,77,196.865325,166.177275,101811,101924,113
100,0,blank,0,-323,-105,101953,102029,76
100,8,m1,77,210.6169,173.798285714286,102113,102301,188
100,7,"EnterrowsandcolumnsforMatrixArespectively:",69,183.703233333333,151.8717,102301,102467,166
100,0,blank,0,178.719585714286,467.235828571429,102494,102689,195
100,0,blank,0,247.649414285714,426.343314285714,102689,102884,195
100,0,blank,0,245.71118,439.88404,102884,103022,138
100,0,blank,0,241.970114285714,479.931314285714,103077,103271,194
100,0,blank,0,238.920766666667,477.411616666667,103271,103438,167
100,0,blank,0,-323,-105,103465,103543,78
100,0,blank,0,239.6376,448.332,103569,103594,25
100,0,blank,0,213.1612,473.0419,103643,103668,25
100,0,blank,0,-323,-105,104071,104242,171
100,0,blank,0,-323,-105,104242,104340,98
100,0,blank,0,235.020828571429,480.171471428571,104372,104554,182
100,0,blank,0,268.662466666667,477.337283333333,104554,104722,168
100,24,m2,174,263.417828571429,511.971228571429,104778,104973,195
100,0,blank,0,266.907528571429,486.959042857143,104973,105165,192
100,23,"\nEnterelementsinMatrixB:\n",163,268.31425,497.6032,105165,105221,56
100,23,"\nEnterelementsinMatrixB:\n",163,264.1447,496.818933333333,105277,105359,82
100,0,blank,0,-323,-105,105387,105441,54
100,0,blank,0,156.7652,-103.9699,105466,105491,25
100,0,blank,0,258.118114285714,471.481928571429,105545,105726,181
100,23,"\nEnterelementsinMatrixB:\n",163,251.256942857143,487.338357142857,105726,105925,199
100,0,blank,0,256.258814285714,480.860285714286,105925,106124,199
100,0,blank,0,261.290371428571,483.663185714286,106124,106323,199
100,21,i,153,274.657166666667,455.783366666667,106323,106408,85
100,0,blank,0,264.15002,469.62064,106466,106607,141
100,0,blank,0,122.728585714286,485.303857142857,106635,106834,199
100,0,blank,0,154.666057142857,477.7848,106834,107032,198
100,0,blank,0,187.480542857143,477.134714285714,107032,107231,199
100,0,blank,0,193.49785,475.4799,107231,107289,58
100,0,blank,0,-323,-105,107315,107368,53
100,0,blank,0,208.556628571429,480.362542857143,107472,107652,180
100,24,;,175,189.5153,521.8301,107652,107708,56
100,0,blank,0,239.882575,472.0591,107737,107849,112
100,0,blank,0,262.500828571429,466.311185714286,107906,108105,199
100,0,blank,0,129.361214285714,468.014285714286,108132,108329,197
100,0,blank,0,139.686857142857,440.331942857143,108329,108525,196
100,21,scanf,146,154.9381,449.738114285714,108525,108724,199
100,0,blank,0,155.584428571429,434.492585714286,108724,108922,198
100,21,scanf,146,142.481975,452.334975,108922,109036,114
100,0,blank,0,-323,-105,109066,109172,106
100,19,n1,140,263.1999,419.6569,109199,109238,39
100,0,blank,0,242.958816666667,405.653916666667,109302,109477,175
100,0,blank,0,235.841366666667,394.92315,109477,109669,192
100,0,blank,0,235.06336,397.86084,109669,109858,189
100,0,blank,0,-323,-105,109891,110003,112
100,17,"EnterelementsinMatrixA:\n",116,270.7435,373.7112,110037,110080,43
100,18,m1,127,247.362883333333,390.667266666667,110205,110385,180
100,0,blank,0,151.579433333333,415.8738,110385,110573,188
100,0,blank,0,151.215033333333,419.082716666667,110573,110752,179
100,0,blank,0,-323,-105,110783,110864,81
100,19,j,142,140.956928571429,416.016257142857,110890,111078,188
100,0,blank,0,176.125383333333,470.365,111078,111249,171
100,0,blank,0,179.172433333333,483.47755,111249,111422,173
100,0,blank,0,157.060766666667,440.20495,111422,111596,174
100,0,blank,0,153.060883333333,438.103316666667,111596,111770,174
100,0,blank,0,182.2098,437.548166666667,111770,111942,172
100,0,blank,0,194.7898,431.61545,111942,112117,175
100,0,blank,0,223.069416666667,422.4951,112117,112292,175
100,0,blank,0,229.81745,420.41305,112292,112350,58
100,0,blank,0,-323,-105,112381,112436,55
100,0,blank,0,232.7406,453.2532,112462,112488,26
100,21,"%d",148,211.190057142857,451.549885714286,112541,112733,192
100,0,blank,0,125.8097,466.782183333333,112733,112932,199
100,0,blank,0,112.250766666667,480.706283333333,112932,113108,176
100,23,printf,161,92.7861,489.8661,113108,113254,146
100,21,comma,149,224.031575,461.1195,113284,113401,117
100,0,blank,0,-323,-105,113430,113534,104
100,19,;,141,188.1209,418.2526,113562,113601,39
100,19,0,136,182.6591,419.759442857143,113665,113860,195
100,0,blank,0,181.83895,425.077216666667,113860,114034,174
100,0,blank,0,-323,-105,114063,114117,54
100,0,blank,0,248.6415,623.631,114143,114168,25
100,21,&,150,251.689542857143,455.090628571429,114218,114405,187
100,0,blank,0,241.2867,459.530166666667,114405,114493,88
100,21,scanf,146,156.429583333333,450.3641,114522,114696,174
100,21,scanf,146,154.12995,458.19565,114696,114813,117
100,0,blank,0,244.823533333333,421.80265,114842,115017,175
100,21,comma,149,231.3632,455.27195,115017,115074,57
100,0,blank,0,-323,-105,115103,115183,80
100,0,blank,0,310.4133,474.4691,115208,115234,26
100,0,blank,0,312.342571428571,424.797471428571,115285,115473,188
100,0,blank,0,199.4322,515.116666666667,115473,115646,173
100,24,;,175,184.646433333333,520.6946,115646,115820,174
100,0,blank,0,186.0219,530.1611,115820,115849,29
100,0,blank,0,-323,-105,115908,116043,135
100,0,blank,0,200.9574,517.977614285714,116069,116260,191
100,24,=,169,159.16195,518.906833333333,116260,116435,175
100,0,blank,0,114.773983333333,511.516666666667,116435,116608,173
100,18,(,120,125.23435,384.871116666667,116637,116808,171
100,18,i,129,140.9833,392.859733333333,116808,116981,173
100,0,blank,0,151.638183333333,393.567883333333,116981,117154,173
100,0,blank,0,77.0947833333333,377.591583333333,117154,117327,173
100,17,printf,114,109.490766666667,372.170266666667,117327,117499,172
100,0,blank,0,161.26525,376.383475,117499,117614,115
100,0,blank,0,-323,-105,117672,117751,79
100,18,m1,127,258.5439,377.0758,117777,117835,58
100,19,n1,140,257.571783333333,399.81395,117893,118056,163
100,0,blank,0,170.933833333333,439.505766666667,118085,118256,171
100,0,blank,0,190.890216666667,423.1297,118256,118428,172
100,0,blank,0,242.569716666667,413.65335,118428,118602,174
100,19,<,139,226.63974,417.6284,118602,118746,144
100,0,blank,0,-323,-105,118775,118879,104
100,0,blank,0,218.312,417.1979,118904,118930,26
100,0,blank,0,211.0837,433.095857142857,118979,119168,189
100,24,=,169,163.28835,528.0571,119168,119342,174
100,23,"\nEnterelementsinMatrixB:\n",163,159.62515,493.574233333333,119342,119515,173
100,21,scanf,146,150.999516666667,454.82515,119515,119690,175
100,0,blank,0,262.297628571429,468.242871428571,119690,119889,199
100,0,blank,0,267.743466666667,464.318316666667,119889,120064,175
100,0,blank,0,260.4138,476.248333333333,120064,120238,174
100,0,blank,0,-323,-105,120268,120372,104
100,0,blank,0,228.4063,467.783542857143,120453,120640,187
100,21,(,147,178.10222,458.2475,120640,120804,164
100,0,blank,0,165.4997,476.79615,120804,120964,160
100,0,blank,0,218.32775,412.86455,120964,121132,168
100,19,0,136,179.693433333333,419.774233333333,121132,121323,191
100,0,blank,0,148.282025,428.226425,121323,121439,116
100,0,blank,0,-323,-105,121468,121573,105
100,18,<,126,226.46,389.529,121601,121641,40
100,0,blank,0,212.025583333333,436.7259,121704,121864,160
100,0,blank,0,170.1264,474.4742,122151,122180,29
100,0,blank,0,-323,-105,122204,122283,79
100,0,blank,0,186.894,427.1497,122363,122388,25
100,0,blank,0,137.0043,556.1144,122761,122802,41
100,23,printf,161,133.6624,504.649142857143,122822,123007,185
100,21,scanf,146,143.9972,460.7375,123007,123089,82
100,0,blank,0,-323,-105,123117,123194,77
100,21,scanf,146,153.5385,443.7425,123219,123244,25
100,21,scanf,146,158.866085714286,463.654614285714,123294,123471,177
100,0,blank,0,176.455071428571,470.509614285714,123471,123664,193
100,0,blank,0,196.751,469.061566666667,123664,123744,80
100,0,blank,0,-323,-105,123772,123927,155
100,21,"%d",148,215.5951,450.3038,123952,123977,25
100,23,printf,161,137.879728571429,491.986271428571,124137,124325,188
100,25,for,179,101.695357142857,532.408757142857,124325,124516,191
100,0,blank,0,90.7497,580.803457142857,124516,124708,192
100,25,for,179,94.6391,543.9779,124708,124735,27
100,0,blank,0,151.18972,511.85608,124762,124901,139
100,0,blank,0,-323,-105,124927,125005,78
100,0,blank,0,146.6758,537.8124,125030,125055,25
100,0,blank,0,117.224985714286,450.338014285714,125105,125285,180
100,0,blank,0,166.787214285714,426.469728571429,125285,125482,197
100,0,blank,0,181.724185714286,437.568785714286,125482,125677,195
100,0,blank,0,170.9483,468.3952,125677,125871,194
100,21,scanf,146,152.219757142857,459.603185714286,125897,126095,198
100,21,scanf,146,129.6287,459.75045,126095,126207,112
100,0,blank,0,-323,-105,126236,126389,153
100,0,blank,0,151.944,529.779471428571,126515,126713,198
100,24,(,167,132.954657142857,519.133271428571,126713,126908,195
100,23,"\nEnterelementsinMatrixB:\n",163,208.9229,498.7396,126908,126963,55
100,0,blank,0,203.5095,529.78495,126991,127159,168
100,0,blank,0,170.059171428571,485.928628571429,127187,127379,192
100,23,printf,161,135.510983333333,502.609066666667,127379,127549,170
100,23,printf,161,137.7839,493.0219,127549,127666,117
100,0,blank,0,-323,-105,127696,127772,76
100,0,blank,0,189.6421,613.1036,127797,127822,25
100,21,scanf,146,137.731714285714,443.010414285714,127878,128059,181
100,21,scanf,146,151.241,445.1803,128059,128144,85
100,0,blank,0,-323,-105,128199,128379,180
100,0,blank,0,152.294928571429,508.9502,128466,128661,195
100,23,(,162,151.886633333333,498.906733333333,128689,128775,86
100,24,++,177,305.22205,516.7631,128803,128942,139
100,0,blank,0,-323,-105,128971,129111,140
100,23,"\nEnterelementsinMatrixB:\n",163,285.838775,506.328875,129137,129244,107
100,23,printf,161,140.6117,502.704966666667,129274,129455,181
100,23,printf,161,97.3851833333333,504.061916666667,129455,129637,182
100,24,for,166,92.285,510.42555,129637,129698,61
100,0,blank,0,238.33604,514.70584,129728,129877,149
100,0,blank,0,-323,-105,129908,130046,138
100,24,m2,174,255.723828571429,515.076642857143,130076,130275,199
100,23,"\nEnterelementsinMatrixB:\n",163,214.959783333333,502.898466666667,130275,130455,180
100,23,"\nEnterelementsinMatrixB:\n",163,168.27195,501.070683333333,130455,130631,176
100,23,"\nEnterelementsinMatrixB:\n",163,172.81155,498.2996,130631,130690,59
100,0,blank,0,-323,-105,130719,130825,106
100,23,"\nEnterelementsinMatrixB:\n",163,301.5666,494.0936,130850,130885,35
100,0,blank,0,295.7715,485.2232,130965,130991,26
100,23,"\nEnterelementsinMatrixB:\n",163,315.01145,502.9398,131067,131239,172
100,0,blank,0,376.307983333333,517.84305,131239,131415,176
100,23,"\nEnterelementsinMatrixB:\n",163,383.10495,507.71115,131415,131474,59
100,0,blank,0,-323,-105,131533,131659,126
100,0,blank,0,215.332042857143,513.928985714286,131684,131873,189
100,0,blank,0,221.10955,509.975275,131873,131993,120
100,0,blank,0,-323,-105,132053,132156,103
100,0,blank,0,-323,-105,132156,132331,175
100,0,blank,0,-323,-105,132331,132492,161
100,0,blank,0,-323,-105,132492,132652,160
100,0,blank,0,-323,-105,132652,132765,113
100,0,blank,0,-323,-105,132765,132855,90
100,0,blank,0,-323,-105,132855,133015,160
100,0,blank,0,-323,-105,133015,133131,116
100,0,blank,0,-323,-105,133343,133419,76
100,25,0,183,181.7242,551.0432,133444,133470,26
100,21,scanf,146,171.633283333333,454.36265,133566,133739,173
100,0,blank,0,121.29835,463.71995,133739,133931,192
100,0,blank,0,150.441166666667,473.423316666667,133931,134108,177
100,0,blank,0,218.67415,476.043133333333,134108,134288,180
100,0,blank,0,244.49565,481.710433333333,134288,134465,177
100,0,blank,0,-323,-105,134495,134625,130
100,0,blank,0,104.067042857143,433.8549,134650,134840,190
100,0,blank,0,108.0409,440.815875,134840,134958,118
100,0,blank,0,216.33965,527.193725,134988,135106,118
100,21,scanf,146,138.493166666667,445.1113,135136,135312,176
100,0,blank,0,135.50275,437.58025,135312,135486,174
100,19,(,133,129.815116666667,401.152016666667,135486,135660,174
100,19,(,133,126.4724,403.603333333333,135660,135835,175
100,19,j,142,141.038466666667,416.74595,135835,136029,194
100,21,scanf,146,151.34015,455.86865,136029,136087,58
100,0,blank,0,-323,-105,136116,136221,105
100,0,blank,0,148.446,528.3186,136247,136282,35
100,0,blank,0,152.487675,513.520525,136345,136453,108
100,0,blank,0,273.0653,460.951833333333,136484,136573,89
100,0,blank,0,-323,-105,136602,136709,107
100,23,printf,161,119.346928571429,500.995814285714,136789,136977,188
100,23,printf,161,119.212233333333,499.219,136977,137151,174
100,24,i,176,137.98755,516.61375,137151,137325,174
100,23,printf,161,108.888633333333,507.003183333333,137325,137504,179
100,0,blank,0,-323,-105,137534,137697,163
100,0,blank,0,165.51625,480.60555,137737,137910,173
100,23,"\nEnterelementsinMatrixB:\n",163,233.238866666667,491.34735,137910,138094,184
100,0,blank,0,365.646716666667,484.861566666667,138124,138304,180
100,23,"\nEnterelementsinMatrixB:\n",163,169.22075,494.690416666667,138334,138516,182
100,23,"\nEnterelementsinMatrixB:\n",163,170.803883333333,492.93485,138516,138701,185
100,23,"\nEnterelementsinMatrixB:\n",163,162.175166666667,502.192066666667,138701,138883,182
100,23,"\nEnterelementsinMatrixB:\n",163,164.147,502.5267,138883,138943,60
100,24,;,175,270.85555,516.83985,138974,139157,183
100,24,;,175,268.926933333333,518.766233333333,139157,139249,92
100,27,scanf,193,126.423866666667,576.720783333333,139279,139466,187
100,0,blank,0,-323,-105,139528,139611,83
100,29,multiply,208,117.8328,623.7069,139640,139690,50
100,0,blank,0,177.963183333333,616.697216666667,139781,139964,183
100,29,comma,221,271.111833333333,624.930233333333,139964,140152,188
100,29,multiply,208,151.13165,624.013183333333,140152,140336,184
100,0,blank,0,107.64055,616.72995,140336,140522,186
100,29,multiply,208,101.774783333333,622.891233333333,140522,140705,183
100,29,m1,210,173.91265,638.960833333333,140705,140892,187
100,0,blank,0,239.089816666667,609.81355,140892,141079,187
100,29,n1,212,219.66365,624.660275,141079,141261,182
100,29,multiply,208,91.2502,638.1931,141261,141360,99
100,0,blank,0,92.8427,641.4007,141360,141543,183
100,31,"OnmatrixmultiplicationofAandBtheresultis:\n",228,138.755766666667,666.99435,141543,141738,195
100,31,"OnmatrixmultiplicationofAandBtheresultis:\n",228,235.6897,683.9609,141738,141895,157
100,0,blank,0,455.44138,685.01376,141926,142083,157
100,31,"OnmatrixmultiplicationofAandBtheresultis:\n",228,177.977883333333,674.361633333333,142114,142302,188
100,31,"OnmatrixmultiplicationofAandBtheresultis:\n",228,156.75955,676.153233333333,142302,142487,185
100,0,blank,0,465.76265,690.7329,142517,142697,180
100,0,blank,0,455.23305,733.8497,142697,142757,60
100,0,blank,0,560.418,699.248325,142786,142902,116
100,0,blank,0,72.4981,718.090833333333,142958,143130,172
100,32,(,232,101.64455,705.25525,143130,143270,140
100,0,blank,0,113.1124,753.2198,143270,143464,194
100,0,blank,0,113.378957142857,714.004314285714,143464,143662,198
100,0,blank,0,87.5361714285714,711.032014285714,143662,143856,194
100,0,blank,0,88.1706,777.7401,143856,143883,27
100,32,print,231,69.7382333333333,695.065716666667,143911,144081,170
100,0,blank,0,-323,-105,144109,144186,77
100,0,blank,0,136.5227,-103.8169,144211,144237,26
100,0,blank,0,154.461871428571,712.606257142857,144287,144470,183
100,0,blank,0,120.969771428571,724.542142857143,144470,144669,199
100,0,blank,0,74.6253714285714,720.892628571429,144669,144864,195
100,0,blank,0,51.9653142857143,716.115585714286,144864,145060,196
100,0,blank,0,106.425928571429,717.685814285714,145060,145256,196
100,0,blank,0,117.26855,710.997383333333,145256,145431,175
100,32,print,231,86.89785,697.329566666667,145431,145602,171
100,32,print,231,81.7190666666667,691.604833333333,145602,145689,87
100,0,blank,0,-323,-105,145718,145797,79
100,0,blank,0,213.1247,-103.8157,145823,145848,25
100,32,comma,236,168.483557142857,693.6812,145898,146084,186
100,32,comma,236,126.5405,702.62845,146084,146255,171
100,32,print,231,83.1626714285714,702.135542857143,146255,146454,199
100,0,blank,0,124.399,717.733957142857,146454,146648,194
100,0,blank,0,128.50768,728.1511,146648,146786,138
100,0,blank,0,51.7658571428571,708.491142857143,146812,147003,191
100,0,blank,0,61.0150857142857,708.636571428571,147003,147198,195
100,0,blank,0,76.7263142857143,713.039814285714,147198,147390,192
100,32,m1,233,118.357642857143,704.861842857143,147390,147582,192
100,0,blank,0,144.7349,716.8517,147582,147610,28
100,0,blank,0,-323,-105,147638,147790,152
100,17,"EnterelementsinMatrixA:\n",116,154.408642857143,365.958714285714,147816,148004,188
100,17,(,115,152.01065,361.17275,148004,148060,56
100,0,blank,0,-323,-105,148115,148300,185
100,0,blank,0,-323,-105,148300,148462,162
100,0,blank,0,-323,-105,148462,148652,190
100,0,blank,0,-323,-105,148652,148840,188
100,0,blank,0,-323,-105,148840,148979,139
100,0,blank,0,-323,-105,148979,149069,90
100,32,comma,236,124.75715,696.668933333333,149113,149285,172
100,32,m1,233,120.34794,702.17638,149285,149473,188
100,32,comma,236,131.020071428571,696.833014285714,149473,149672,199
100,32,comma,236,129.06652,694.30128,149672,149815,143
100,31,"OnmatrixmultiplicationofAandBtheresultis:\n",228,119.87415,672.71115,149815,149927,112
100,32,m1,233,112.4964,686.812533333333,149927,150104,177
100,0,blank,0,118.328416666667,684.843633333333,150104,150277,173
100,31,"OnmatrixmultiplicationofAandBtheresultis:\n",228,123.54955,679.794925,150277,150394,117
100,0,blank,0,152.6323,537.454633333333,150423,150600,177
100,29,multiply,208,131.574833333333,622.385166666667,150600,150775,175
100,0,blank,0,126.3034,640.996033333333,150775,150951,176
100,29,comma,221,197.498633333333,638.545166666667,150951,151127,176
100,29,n1,212,216.070066666667,623.53995,151127,151303,176
100,0,blank,0,223.115783333333,617.492383333333,151303,151476,173
100,31,"OnmatrixmultiplicationofAandBtheresultis:\n",228,146.0191,673.17695,151505,151677,172
100,31,"OnmatrixmultiplicationofAandBtheresultis:\n",228,164.004216666667,675.88815,151677,151850,173
100,0,blank,0,169.73026,661.2595,151850,151995,145
100,0,blank,0,553.858916666667,694.67705,152051,152225,174
100,0,blank,0,547.589366666667,694.823266666667,152225,152313,88
100,0,blank,0,1007.7132,689.1999,152373,152564,191
100,0,blank,0,1023.107,699.0307,152564,152595,31
100,0,blank,0,1032.79966666667,326.225333333333,152680,152856,176
100,0,blank,0,1043.6216,351.79912,152856,153039,183
100,0,blank,0,1029.05116666667,418.7995,153039,153237,198
100,0,blank,0,1019.7328,434.77392,153237,153407,170
100,0,blank,0,1041.23775,440.168225,153407,153599,192
100,0,blank,0,1055.337,451.583,153599,153624,25
100,31,"OnmatrixmultiplicationofAandBtheresultis:\n",228,296.8142,671.162816666667,153684,153882,198
100,0,blank,0,242.46935,689.2266,153882,154064,182
100,0,blank,0,257.078375,693.023075,154064,154185,121
100,23,"\nEnterelementsinMatrixB:\n",163,230.38215,506.155266666667,154245,154418,173
100,23,"\nEnterelementsinMatrixB:\n",163,236.757483333333,491.259816666667,154418,154598,180
100,0,blank,0,241.35335,509.89735,154598,154657,59
100,17,"EnterelementsinMatrixA:\n",116,165.403166666667,366.085733333333,154687,154773,86
100,0,blank,0,-323,-105,154803,154857,54
100,0,blank,0,210.0535,330.2161,154882,154907,25
100,0,blank,0,225.261314285714,337.441071428571,154959,155150,191
100,18,i,129,207.026633333333,393.464416666667,155150,155325,175
100,0,blank,0,219.639666666667,394.826683333333,155325,155498,173
100,0,blank,0,1037.59583333333,522.377066666667,155556,155735,179
100,0,blank,0,1028.45066666667,566.88175,155735,155931,196
100,0,blank,0,1030.9075,528.894316666667,155931,156128,197
100,0,blank,0,1017.5162,442.49186,156128,156325,197
100,0,blank,0,1026.5985,416.98265,156325,156518,193
100,0,blank,0,1031.11983333333,426.382166666667,156518,156700,182
100,0,blank,0,1027.347,434.7586,156700,156871,171
100,0,blank,0,1024.0735,448.1807,156871,157030,159
101,32,n2,235,143.885316666667,67.0045666666667,157784,157966,182
101,0,blank,0,140.130625,66.059,157966,158086,120
101,0,blank,0,-323,-105,158116,158196,80
101,0,blank,0,-323,-105,158276,158473,197
101,0,blank,0,-323,-105,158473,158653,180
101,0,blank,0,-323,-105,158653,158813,160
101,0,blank,0,-323,-105,158813,158888,75
101,32,comma,236,125.84035,65.01165,158925,158977,52
101,0,blank,0,106.289433333333,14.1170333333333,159007,159192,185
101,0,blank,0,109.2972,10.6429,159192,159226,34
101,0,blank,0,232.00768,84.16302,159256,159416,160
101,0,blank,0,603.31445,68.1661,159448,159576,128
101,0,blank,0,795.439333333333,57.8287666666667,159607,159794,187
101,0,blank,0,737.04785,61.0888666666667,159794,159982,188
101,0,blank,0,682.067,76.1283,159982,160014,32
101,0,blank,0,-323,-105,160076,160182,106
101,31,printf,226,62.2393,53.6791,160209,160236,27
101,32,print,231,45.9759,62.70505,160321,160375,54
101,31,"OnmatrixmultiplicationofAandBtheresultis:\n",228,217.591016666667,48.2122333333333,160405,160592,187
101,0,blank,0,324.659283333333,58.5431166666667,160592,160777,185
101,31,"OnmatrixmultiplicationofAandBtheresultis:\n",228,259.74645,52.66385,160777,160959,182
101,0,blank,0,311.244833333333,60.51965,160959,161141,182
101,0,blank,0,320.5044,69.7604,161141,161171,30
101,0,blank,0,447.83918,64.84464,161201,161354,153
101,0,blank,0,-323,-105,161384,161439,55
101,0,blank,0,563.52945,55.3141,161570,161722,152
101,31,"OnmatrixmultiplicationofAandBtheresultis:\n",228,566.2412,53.3057,161722,161835,113
101,0,blank,0,731.5905,72.8623166666667,161912,162105,193
101,0,blank,0,809.103333333333,71.6336833333333,162105,162286,181
101,0,blank,0,831.107333333333,70.64215,162286,162463,177
101,0,blank,0,816.6495,70.61935,162463,162583,120
101,0,blank,0,354.69245,57.24395,162643,162705,62
101,0,blank,0,-323,-105,162736,162818,82
101,31,"OnmatrixmultiplicationofAandBtheresultis:\n",228,403.7363,50.7532,162843,162869,26
101,0,blank,0,405.905633333333,67.4398666666667,162927,163102,175
101,0,blank,0,406.2321,57.807,163102,163133,31
101,0,blank,0,579.642183333333,69.2343666666667,163164,163348,184
101,0,blank,0,525.701583333333,69.5234333333333,163348,163532,184
101,0,blank,0,550.181833333333,66.9083,163532,163715,183
101,0,blank,0,596.126216666667,72.6226666666667,163715,163897,182
101,0,blank,0,586.787133333333,74.4671166666667,163897,164079,182
101,0,blank,0,364.49885,67.3314666666667,164109,164291,182
101,0,blank,0,292.30915,67.64535,164291,164474,183
101,0,blank,0,293.003683333333,73.0631333333333,164474,164658,184
101,0,blank,0,259.65215,70.5768166666667,164658,164840,182
101,0,blank,0,225.956,67.6546,164840,164900,60
101,0,blank,0,-323,-105,164931,165013,82
101,0,blank,0,573.6766,60.8501,165039,165064,25
101,0,blank,0,552.709516666667,69.8549833333333,165125,165300,175
101,0,blank,0,506.581875,74.63275,165300,165421,121
101,0,blank,0,294.031883333333,65.33305,165452,165633,181
101,0,blank,0,294.763366666667,74.6387166666667,165633,165815,182
101,0,blank,0,512.825416666667,70.2039666666667,165846,166029,183
101,0,blank,0,98.52835,123.943983333333,166090,166272,182
101,34,int,274,160.202666666667,107.177083333333,166272,166454,182
101,34,int,274,172.045616666667,108.483666666667,166454,166635,181
101,34,multiply,242,116.723466666667,105.500783333333,166635,166817,182
101,0,blank,0,145.237016666667,98.6834166666667,166817,167000,183
101,34,(,243,147.8625,112.90185,167000,167060,60
101,0,blank,0,270.086866666667,96.54075,167090,167272,182
101,34,comma,273,214.193883333333,100.933916666667,167272,167453,181
101,0,blank,0,109.96895,97.1509666666667,167453,167636,183
101,0,blank,0,112.347016666667,98.1734666666667,167636,167815,179
101,34,(,243,150.15694,100.65584,167815,167966,151
101,0,blank,0,-323,-105,167997,168078,81
101,34,int,274,174.2858,102.1469,168104,168154,50
101,34,int,274,183.8504,106.2563,168218,168243,25
101,0,blank,0,-323,-105,168270,168376,106
101,0,blank,0,303.2964,94.9371,168402,168435,33
101,34,n1,248,288.7644,106.060383333333,168498,168671,173
101,0,blank,0,270.891633333333,108.015783333333,168671,168852,181
101,0,blank,0,270.5217,115.757,168852,169032,180
101,34,int,274,340.00898,111.89028,169032,169183,151
101,0,blank,0,91.0941166666667,131.82565,169212,169390,178
101,0,blank,0,120.405883333333,130.193266666667,169390,169571,181
101,0,blank,0,141.548516666667,134.403233333333,169571,169751,180
101,36,int,285,130.0639,162.701783333333,169751,169932,181
101,0,blank,0,129.397933333333,133.101466666667,169932,170114,182
101,0,blank,0,134.027283333333,120.090416666667,170114,170296,182
101,0,blank,0,133.124366666667,121.642533333333,170296,170477,181
101,0,blank,0,136.072316666667,125.288833333333,170477,170658,181
101,0,blank,0,135.9874,122.7207,170658,170719,61
101,31,"OnmatrixmultiplicationofAandBtheresultis:\n",228,471.701033333333,53.0379,170749,170933,184
101,0,blank,0,416.651483333333,58.1904,170933,171117,184
101,0,blank,0,417.455783333333,62.9435833333333,171117,171301,184
101,34,multiply,242,114.202133333333,108.539533333333,171332,171517,185
101,0,blank,0,112.58516,123.41762,171517,171664,147
101,0,blank,0,-323,-105,171693,171747,54
101,47,c,338,172.507,391.2101,171772,171797,25
101,37,m1,302,150.998314285714,169.546857142857,171854,172041,187
101,37,m1,302,153.3325,176.289966666667,172041,172129,88
101,0,blank,0,484.956966666667,72.3028833333333,172189,172385,196
101,0,blank,0,447.355283333333,71.2289166666667,172385,172559,174
101,0,blank,0,407.67025,78.5734,172559,172618,59
101,0,blank,0,129.84165,135.667833333333,172648,172824,176
101,0,blank,0,128.16515,121.708183333333,172824,173004,180
101,36,int,285,123.01395,149.595633333333,173004,173184,180
101,0,blank,0,127.890916666667,179.050416666667,173184,173364,180
101,0,blank,0,237.749683333333,96.1124833333333,173395,173575,180
101,0,blank,0,241.233383333333,98.7018333333333,173575,173757,182
101,0,blank,0,227.28305,109.146066666667,173757,173938,181
101,34,m1,245,211.125425,109.2131,173938,174058,120
101,0,blank,0,-323,-105,174089,174169,80
101,0,blank,0,132.8676,136.9712,174197,174255,58
101,0,blank,0,132.046183333333,129.596016666667,174319,174489,170
101,0,blank,0,135.966616666667,133.280983333333,174489,174670,181
101,0,blank,0,136.170933333333,121.5259,174670,174848,178
101,34,multiply,242,131.926433333333,118.115166666667,174848,175026,178
101,0,blank,0,188.713016666667,121.1707,175026,175207,181
101,34,int,274,182.503183333333,118.741383333333,175207,175388,181
101,0,blank,0,139.479833333333,130.1906,175388,175567,179
101,0,blank,0,157.001866666667,124.969466666667,175567,175748,181
101,0,blank,0,223.5187,109.203066666667,175748,175929,181
101,0,blank,0,162.462833333333,123.690516666667,175929,176110,181
101,0,blank,0,130.77675,135.7632,176110,176288,178
101,0,blank,0,133.097833333333,123.1517,176288,176467,179
101,0,blank,0,137.619333333333,130.6638,176467,176647,180
101,0,blank,0,137.42545,132.071375,176647,176765,118
101,0,blank,0,-323,-105,176796,176876,80
101,34,int,274,239.6762,102.4084,176901,176933,32
101,34,int,274,248.85135,115.54435,176998,177169,171
101,34,int,274,241.5054,108.681516666667,177169,177350,181
101,0,blank,0,193.785316666667,138.09395,177350,177531,181
101,0,blank,0,147.376733333333,159.7459,177531,177709,178
101,36,int,285,131.568,144.35555,177709,177768,59
101,31,"OnmatrixmultiplicationofAandBtheresultis:\n",228,411.850633333333,43.3399166666667,177798,177980,182
101,31,"OnmatrixmultiplicationofAandBtheresultis:\n",228,415.255666666667,46.9707333333333,177980,178161,181
101,0,blank,0,419.072,61.3438,178161,178191,30
101,0,blank,0,526.85975,54.1547,178221,178283,62
101,37,m1,302,142.90135,177.571683333333,178344,178525,181
101,37,m1,302,142.7137,172.22525,178525,178703,178
101,37,),303,154.742116666667,165.388883333333,178703,178885,182
101,37,),303,160.1735,168.974783333333,178885,179065,180
101,37,),303,160.92235,173.9567,179065,179246,181
101,0,blank,0,162.290083333333,177.929016666667,179246,179426,180
101,34,(,243,149.96955,119.0105,179426,179606,180
101,0,blank,0,158.4297,128.8291,179606,179636,30
101,0,blank,0,-323,-105,179666,179772,106
101,34,int,274,164.62145,112.13535,179797,179847,50
101,0,blank,0,487.194366666667,55.8955333333333,179872,180053,181
101,0,blank,0,495.5486,68.4261,180053,180084,31
101,0,blank,0,127.003433333333,128.890416666667,180115,180296,181
101,0,blank,0,100.0152,94.05455,180296,180476,180
101,32,(,232,97.8477666666667,63.6142833333334,180476,180656,180
101,0,blank,0,117.826825,76.23865,180656,180776,120
101,0,blank,0,-323,-105,180806,180861,55
101,37,m1,302,147.039666666667,174.782633333333,180974,181148,174
101,37,),303,157.804566666667,185.064933333333,181148,181329,181
101,0,blank,0,-323,-105,181387,181535,148
101,0,blank,0,-323,-105,181535,181629,94
101,0,blank,0,-323,-105,182219,182396,177
101,0,blank,0,-323,-105,182396,182559,163
101,0,blank,0,-323,-105,182559,182748,189
101,0,blank,0,-323,-105,182748,182822,74
101,0,blank,0,198.952575,245.01345,182847,183022,175
101,0,blank,0,201.2526,231.919114285714,183022,183221,199
101,0,blank,0,191.097233333333,238.994533333333,183221,183309,88
101,0,blank,0,-323,-105,183339,183509,170
101,0,blank,0,-323,-105,183509,183593,84
101,0,blank,0,158.045116666667,218.616116666667,183630,183823,193
101,39,;,306,144.123766666667,215.916916666667,183823,184009,186
101,39,return,305,94.86555,223.432616666667,184009,184196,187
101,39,return,305,138.7645,226.346783333333,184196,184381,185
101,0,blank,0,173.6431,226.66204,184381,184537,156
101,0,blank,0,-323,-105,184568,184650,82
101,34,multiply,242,110.4499,106.0654,184676,184702,26
101,34,(,243,145.13695,100.4577,184770,184826,56
101,0,blank,0,183.13515,246.4435,184854,185042,188
101,0,blank,0,150.456466666667,256.320616666667,185042,185229,187
101,0,blank,0,146.994666666667,271.5916,185229,185410,181
101,0,blank,0,174.577,284.130116666667,185410,185590,180
101,43,<,319,146.329083333333,302.505466666667,185590,185771,181
101,43,(,317,118.6532,313.013033333333,185771,185951,180
101,0,blank,0,110.4463,297.9615,185951,185981,30
101,0,blank,0,133.595566666667,516.1567,186012,186194,182
101,0,blank,0,125.9763,499.2922,186194,186225,31
101,0,blank,0,86.2245833333333,657.507666666667,186256,186441,185
101,0,blank,0,109.940466666667,210.67945,186471,186657,186
101,39,return,305,139.249733333333,225.953433333333,186657,186750,93
101,0,blank,0,-323,-105,186781,186835,54
101,0,blank,0,207.9365,311.3455,186860,186885,25
101,0,blank,0,188.114025,230.707825,186938,187045,107
101,31,"OnmatrixmultiplicationofAandBtheresultis:\n",228,464.853933333333,49.2329,187076,187260,184
101,0,blank,0,465.8937,64.49455,187260,187322,62
101,0,blank,0,-323,-105,187350,187406,56
101,0,blank,0,396.001066666667,88.9526833333334,187530,187700,170
101,0,blank,0,408.583533333333,69.8854166666667,187700,187886,186
101,0,blank,0,405.9915,72.3462,187886,187918,32
101,0,blank,0,671.78985,66.1501666666667,187948,188132,184
101,0,blank,0,675.952,78.6013,188132,188163,31
101,0,blank,0,181.6228,249.762633333333,188224,188403,179
101,0,blank,0,262.1658,224.3054,188403,188431,28
101,0,blank,0,534.28115,73.6428333333333,188462,188638,176
101,0,blank,0,530.774566666667,77.2794666666667,188638,188817,179
101,0,blank,0,526.008266666667,69.943,188817,188908,91
101,32,;,239,207.898566666667,70.9116666666667,188939,189120,181
101,0,blank,0,205.145,78.0534,189120,189150,30
101,0,blank,0,-323,-105,189181,189341,160
101,0,blank,0,280.120257142857,72.7268428571429,189367,189562,195
101,0,blank,0,313.40395,73.9986333333333,189562,189740,178
101,0,blank,0,326.14845,92.0676,189740,189800,60
101,0,blank,0,-323,-105,189829,189910,81
101,0,blank,0,221.1153,143.0388,189936,189962,26
101,0,blank,0,-323,-105,189988,190194,206
101,0,blank,0,-323,-105,190194,190371,177
101,0,blank,0,-323,-105,190371,190517,146
101,0,blank,0,-323,-105,190517,190576,59
101,0,blank,0,252.5176,132.402,191097,191129,32
101,0,blank,0,65.7387142857143,313.107414285714,191147,191342,195
101,0,blank,0,105.744157142857,235.708628571429,191342,191540,198
101,0,blank,0,94.2744666666667,187.536316666667,191540,191709,169
101,0,blank,0,-323,-105,191766,191819,53
101,0,blank,0,307.8849,173.8538,191844,191870,26
101,31,"OnmatrixmultiplicationofAandBtheresultis:\n",228,280.060571428571,48.7857142857143,191920,192111,191
101,0,blank,0,255.775983333333,66.32645,192111,192292,181
101,32,),238,201.6007,69.90025,192292,192474,182
101,0,blank,0,177.310933333333,72.8351333333333,192474,192564,90
101,0,blank,0,-323,-105,192595,192651,56
101,0,blank,0,203.9038,317.8091,192676,192702,26
101,34,multiply,242,94.96525,104.544233333333,192751,192923,172
101,0,blank,0,133.211583333333,130.150733333333,192923,193116,193
101,0,blank,0,123.61305,136.2555,193116,193242,126
101,0,blank,0,136.5857,287.616616666667,193273,193457,184
101,0,blank,0,148.857,254.341083333333,193457,193635,178
101,0,blank,0,158.393333333333,219.6734,193635,193814,179
101,0,blank,0,155.487,221.76866,193814,193962,148
101,0,blank,0,-323,-105,193992,194097,105
101,39,return,305,134.7027,220.5576,194123,194148,25
101,0,blank,0,145.5352,229.2069,194197,194392,195
101,39,;,306,145.100083333333,224.137833333333,194392,194574,182
101,0,blank,0,152.2118,231.09845,194574,194754,180
101,0,blank,0,152.88275,232.368033333333,194754,194934,180
101,0,blank,0,-323,-105,194964,195020,56
101,0,blank,0,-323,-105,195070,195095,25
101,0,blank,0,130.3422,276.4016,195121,195146,25
101,0,blank,0,137.749266666667,279.80745,195206,195378,172
101,0,blank,0,130.781816666667,280.573166666667,195378,195558,180
101,0,blank,0,85.3006333333333,260.332483333333,195558,195750,192
101,0,blank,0,94.1234333333334,290.8761,195750,195932,182
101,43,j,318,125.1247,306.008183333333,195932,196115,183
101,0,blank,0,126.01315,325.0011,196115,196176,61
101,0,blank,0,-323,-105,196206,196286,80
101,41,i,311,140.4823,254.7438,196311,196339,28
101,41,(,310,131.980266666667,267.788583333333,196406,196579,173
101,0,blank,0,140.072116666667,283.855266666667,196579,196761,182
101,0,blank,0,160.6416,315.004216666667,196761,196943,182
101,41,if,309,101.27215,273.223233333333,196943,197125,182
101,41,if,309,98.5190833333333,270.354233333333,197125,197308,183
101,0,blank,0,92.9621333333333,271.161533333333,197308,197402,94
101,0,blank,0,-323,-105,197433,197587,154
101,0,blank,0,137.279566666667,282.492083333333,197613,197786,173
101,0,blank,0,137.9788,281.943016666667,197786,197971,185
101,0,blank,0,145.21135,289.651166666667,197971,198156,185
101,0,blank,0,151.265766666667,333.667266666667,198156,198340,184
101,0,blank,0,148.666225,337.05235,198340,198463,123
101,0,blank,0,102.984133333333,456.787583333333,198493,198682,189
101,0,blank,0,102.338566666667,463.705416666667,198682,198869,187
101,0,blank,0,73.1490333333333,558.4942,198869,199057,188
101,0,blank,0,73.11245,560.019583333333,199057,199243,186
101,0,blank,0,43.6273,628.971566666667,199243,199431,188
101,0,blank,0,39.9852,624.237066666667,199431,199525,94
101,41,else,308,81.4278,267.148033333333,199588,199775,187
101,41,else,308,79.9038666666667,271.037766666667,199775,199868,93
101,0,blank,0,-323,-105,199899,199956,57
101,0,blank,0,134.609757142857,308.348885714286,200062,200261,199
101,43,<,319,146.31955,314.0511,200261,200444,183
101,0,blank,0,142.074875,303.545,200444,200566,122
101,0,blank,0,-323,-105,200596,200678,82
101,0,blank,0,-323,-105,200758,201208,450
101,0,blank,0,-323,-105,201208,201310,102
101,45,if,323,124.3781,352.4726,201346,201378,32
101,0,blank,0,-323,-105,201420,201600,180
101,0,blank,0,-323,-105,201600,201777,177
101,0,blank,0,-323,-105,201777,201954,177
101,0,blank,0,-323,-105,201954,202065,111
101,0,blank,0,-323,-105,202065,202334,269
101,0,blank,0,-323,-105,202334,202684,350
101,0,blank,0,-323,-105,202684,202763,79
101,0,blank,0,-323,-105,202763,203053,290
101,0,blank,0,-323,-105,203053,203188,135
101,0,blank,0,169.15335,340.005133333333,203443,203626,183
101,45,(,324,162.070516666667,344.54445,203626,203810,184
101,0,blank,0,165.28118,334.25756,203810,203957,147
101,0,blank,0,-323,-105,204015,204150,135
101,0,blank,0,182.884466666667,342.85915,204186,204358,172
101,0,blank,0,118.94315,406.822466666667,204358,204541,183
101,0,blank,0,114.756683333333,453.320833333333,204541,204723,182
101,0,blank,0,115.777066666667,455.474016666667,204723,204908,185
101,0,blank,0,115.533333333333,459.137383333333,204908,205094,186
101,0,blank,0,136.3307,435.9856,205094,205279,185
101,0,blank,0,146.003883333333,380.18755,205279,205463,184
101,0,blank,0,157.5402,368.7542,205463,205494,31
101,0,blank,0,338.2737,367.17475,205524,205707,183
101,0,blank,0,302.397966666667,378.412616666667,205707,205892,185
101,47,[,358,290.7332,390.4556,205892,205922,30
101,0,blank,0,-323,-105,205954,206035,81
101,0,blank,0,455.1016,407.2653,206060,206100,40
101,0,blank,0,438.630116666667,377.364533333333,206164,206337,173
101,0,blank,0,371.329425,366.4454,206337,206458,121
101,0,blank,0,179.118516666667,374.443466666667,206490,206671,181
101,0,blank,0,181.879766666667,376.425533333333,206671,206853,182
101,0,blank,0,203.60055,364.370316666667,206853,207032,179
101,0,blank,0,206.9044,381.16885,207032,207093,61
101,0,blank,0,314.4278,393.49455,207122,207183,61
101,0,blank,0,346.33445,376.9195,207212,207276,64
101,0,blank,0,-323,-105,207337,207392,55
101,47,+,345,363.7797,393.6426,207417,207442,25
101,0,blank,0,378.945583333333,364.916766666667,207493,207663,170
101,0,blank,0,431.045016666667,382.684033333333,207663,207848,185
101,0,blank,0,443.061566666667,376.052866666667,207848,208033,185
101,0,blank,0,389.64725,369.59605,208033,208219,186
101,0,blank,0,197.27845,374.94025,208252,208437,185
101,0,blank,0,194.675216666667,372.9596,208437,208625,188
101,0,blank,0,183.577783333333,366.10885,208625,208816,191
101,0,blank,0,181.472283333333,369.897583333333,208816,209002,186
101,0,blank,0,185.05805,369.130833333333,209002,209191,189
101,0,blank,0,-323,-105,209224,209373,149
101,0,blank,0,-323,-105,209373,209450,77
101,0,blank,0,135.54404,370.0874,209486,209670,184
101,0,blank,0,188.55125,371.6021,209670,209859,189
101,0,blank,0,211.3923,385.4884,209859,209891,32
101,0,blank,0,-323,-105,209953,210135,182
101,0,blank,0,-323,-105,210135,210196,61
101,0,blank,0,287.3991,383.3287,210226,210408,182
101,0,blank,0,-323,-105,210435,210515,80
101,0,blank,0,178.0336,503.3563,210540,210566,26
101,47,j,359,183.661742857143,387.610557142857,210616,210807,191
101,0,blank,0,272.643866666667,392.651883333333,210807,210984,177
101,47,c,338,280.80495,390.58725,210984,211162,178
101,47,+,345,361.839783333333,386.003033333333,211162,211338,176
101,0,blank,0,342.185316666667,389.6264,211338,211515,177
101,47,j,359,329.563566666667,388.162466666667,211515,211603,88
101,0,blank,0,417.7007,378.29815,211632,211811,179
101,0,blank,0,420.5044,385.86145,211811,211870,59
101,0,blank,0,254.4157,380.556966666667,211900,212081,181
101,0,blank,0,201.939016666667,382.023916666667,212081,212260,179
101,0,blank,0,172.99895,385.512633333333,212260,212442,182
101,47,j,359,184.006033333333,392.137583333333,212442,212622,180
101,47,c,338,169.351866666667,394.17555,212622,212802,180
101,0,blank,0,154.56575,403.350516666667,212802,212982,180
101,0,blank,0,158.332266666667,408.077616666667,212982,213163,181
101,0,blank,0,299.643783333333,385.350816666667,213194,213374,180
101,0,blank,0,283.0589,373.88375,213374,213556,182
101,0,blank,0,280.068216666667,380.7986,213556,213738,182
101,0,blank,0,276.4296,375.732675,213738,213861,123
101,0,blank,0,160.19015,380.149633333333,213892,214074,182
101,0,blank,0,150.2557,385.5611,214074,214104,30
101,0,blank,0,-323,-105,214135,214190,55
101,47,],360,229.4849,396.7733,214318,214346,28
101,0,blank,0,333.04228,383.13492,214372,214535,163
101,0,blank,0,416.22336,385.41064,214535,214715,180
101,0,blank,0,452.839333333333,380.988233333333,214715,214899,184
101,0,blank,0,406.170066666667,379.223666666667,214899,215085,186
101,0,blank,0,381.81695,370.71,215085,215266,181
101,0,blank,0,442.4803,376.793883333333,215266,215448,182
101,0,blank,0,483.87365,377.65745,215448,215634,186
101,0,blank,0,482.515,375.2489,215634,215665,31
101,0,blank,0,-323,-105,215697,215829,132
101,0,blank,0,458.0674,366.6699,215855,215881,26
101,0,blank,0,460.651116666667,380.199933333333,215944,216122,178
101,0,blank,0,400.781566666667,374.86995,216122,216306,184
101,0,blank,0,391.271366666667,375.130783333333,216306,216488,182
101,0,blank,0,385.3437,379.890433333333,216488,216669,181
101,0,blank,0,191.732733333333,374.9564,216700,216881,181
101,0,blank,0,194.1284,373.65585,216881,216942,61
101,0,blank,0,-323,-105,216973,217081,108
101,45,k,325,171.5736,361.8375,217106,217132,26
101,0,blank,0,181.185975,370.439875,217191,217307,116
101,0,blank,0,390.23334,369.42876,217336,217490,154
101,0,blank,0,177.7278,376.4778,217520,217702,182
101,0,blank,0,179.094333333333,379.4478,217702,217885,183
101,0,blank,0,180.9824,377.2675,217885,218066,181
101,0,blank,0,179.814516666667,385.355133333333,218066,218248,182
101,47,j,359,188.926,389.2089,218248,218279,31
101,0,blank,0,406.25295,370.427783333333,218311,218491,180
101,0,blank,0,388.085266666667,372.448216666667,218491,218673,182
101,0,blank,0,382.670916666667,367.02665,218673,218855,182
101,0,blank,0,373.45065,361.08595,218855,218917,62
101,0,blank,0,177.05355,373.551266666667,218947,219131,184
101,0,blank,0,183.122333333333,382.50345,219131,219315,184
101,0,blank,0,190.814625,378.8446,219315,219437,122
101,0,blank,0,-323,-105,219468,219499,31
101,0,blank,0,377.7589,373.952957142857,219551,219750,199
101,0,blank,0,425.674466666667,373.1517,219750,219933,183
101,0,blank,0,472.540383333333,369.815133333333,219933,220119,186
101,0,blank,0,372.41845,372.440883333333,220119,220302,183
101,0,blank,0,323.9412,377.779483333333,220302,220484,182
101,0,blank,0,185.129166666667,379.217316666667,220484,220667,183
101,0,blank,0,184.719933333333,378.950466666667,220667,220851,184
101,0,blank,0,189.858566666667,379.39205,220851,221032,181
101,47,j,359,188.4091,402.2637,221032,221063,31
101,0,blank,0,407.04085,383.5972,221093,221216,123
101,0,blank,0,-323,-105,221246,221303,57
101,0,blank,0,449.367,405.1773,221329,221354,25
101,0,blank,0,456.06005,382.098316666667,221408,221578,170
101,0,blank,0,476.948433333333,377.238433333333,221578,221670,92
101,0,blank,0,168.227666666667,380.960333333333,221702,221887,185
101,47,c,338,173.746875,386.2732,221887,222011,124
101,0,blank,0,334.069383333333,364.931383333333,222041,222223,182
101,0,blank,0,374.782316666667,368.917666666667,222223,222405,182
101,0,blank,0,380.687733333333,368.315,222405,222588,183
101,0,blank,0,365.84228,373.4706,222588,222751,163
101,0,blank,0,324.79495,369.6479,222751,222922,171
101,0,blank,0,186.40305,371.6518,222922,223121,199
101,0,blank,0,186.60818,365.8391,223121,223298,177
101,0,blank,0,186.929675,370.94,223298,223421,123
101,0,blank,0,-323,-105,223453,223586,133
101,0,blank,0,175.86515,359.4419,223610,223780,170
101,0,blank,0,171.587266666667,367.713833333333,223780,223873,93
101,0,blank,0,-323,-105,223935,223987,52
101,0,blank,0,370.7532,426.5794,224013,224039,26
101,0,blank,0,334.0107,356.995433333333,224092,224170,78
101,0,blank,0,203.994233333333,365.928883333333,224200,224385,185
101,0,blank,0,186.207333333333,368.0073,224385,224569,184
101,47,c,338,166.09915,395.22155,224569,224632,63
101,0,blank,0,-323,-105,224664,224858,194
101,0,blank,0,-323,-105,224858,225035,177
101,0,blank,0,-323,-105,225035,225216,181
101,0,blank,0,-323,-105,225216,225408,192
101,0,blank,0,-323,-105,225408,225570,162
101,0,blank,0,-323,-105,225570,225734,164
101,0,blank,0,-323,-105,225734,225918,184
101,0,blank,0,-323,-105,225918,226068,150
101,0,blank,0,-323,-105,226068,226249,181
101,0,blank,0,-323,-105,226249,226387,138
101,0,blank,0,329.185983333333,359.3679,226545,226740,195
101,0,blank,0,283.991466666667,359.7943,226740,226921,181
101,0,blank,0,236.067833333333,374.422116666667,226921,227102,181
101,0,blank,0,236.680333333333,370.688983333333,227102,227285,183
101,45,n1,327,217.579166666667,359.8795,227285,227466,181
101,0,blank,0,266.640433333333,355.4401,227466,227645,179
101,0,blank,0,322.205133333333,342.539866666667,227645,227827,182
101,0,blank,0,294.501083333333,362.425233333333,227827,228009,182
101,0,blank,0,228.271083333333,373.310233333333,228009,228193,184
101,0,blank,0,198.46466,385.18506,228193,228346,153
101,0,blank,0,-323,-105,228377,228433,56
101,0,blank,0,-323,-105,228485,228630,145
101,47,i,348,219.913266666667,393.089533333333,228662,228838,176
101,47,[,358,285.068933333333,396.744133333333,228838,229023,185
101,0,blank,0,384.23545,403.647883333333,229023,229205,182
101,0,blank,0,359.028616666667,371.938716666667,229205,229386,181
101,0,blank,0,326.9783,348.572416666667,229386,229568,182
101,0,blank,0,246.847433333333,364.872766666667,229568,229751,183
101,0,blank,0,231.477266666667,366.853133333333,229751,229842,91
101,0,blank,0,-323,-105,229874,229980,106
101,0,blank,0,331.3595,345.78695,230066,230242,176
101,0,blank,0,335.14265,353.397983333333,230242,230424,182
101,0,blank,0,317.34465,368.40645,230424,230606,182
101,0,blank,0,322.7189,367.6505,230606,230636,30
101,45,n1,327,208.7551,358.3557,230666,230846,180
101,0,blank,0,219.215233333333,374.257066666667,230846,231025,179
101,45,),328,227.417166666667,359.667433333333,231025,231204,179
101,47,[,358,211.784716666667,393.8899,231204,231385,181
101,47,[,358,182.1775,392.79155,231385,231448,63
101,49,multiply,365,192.782116666667,435.698733333333,231479,231661,182
101,0,blank,0,206.3333,491.0156,231661,231691,30
101,48,++,363,191.0931,426.238,231723,231899,176
101,49,multiply,365,229.04485,434.0574,231899,231958,59
101,0,blank,0,203.146883333333,333.50995,231989,232169,180
101,0,blank,0,221.5551,315.140266666667,232169,232353,184
101,0,blank,0,191.006883333333,326.566616666667,232353,232534,181
101,0,blank,0,172.3021,370.1544,232534,232565,31
101,0,blank,0,-323,-105,232677,232809,132
101,0,blank,0,206.869966666667,369.093583333333,232834,232998,164
101,41,<,312,161.422483333333,267.332516666667,233027,233210,183
101,41,<,312,158.84026,271.7902,233210,233360,150
101,0,blank,0,209.452583333333,322.4683,233390,233568,178
101,0,blank,0,212.263833333333,315.608683333333,233568,233749,181
101,0,blank,0,222.37374,323.54934,233749,233900,151
101,0,blank,0,-323,-105,233932,234114,182
101,0,blank,0,-323,-105,234114,234311,197
101,0,blank,0,-323,-105,234311,234489,178
101,0,blank,0,-323,-105,234489,234672,183
101,0,blank,0,-323,-105,234672,234742,70
101,0,blank,0,105.9396,307.755766666667,234778,234951,173
101,0,blank,0,123.165614285714,319.461185714286,234951,235150,199
101,0,blank,0,137.18415,314.15685,235150,235326,176
101,0,blank,0,133.31706,256.86086,235326,235473,147
101,0,blank,0,-323,-105,235502,235675,173
101,0,blank,0,134.973585714286,246.126728571429,235707,235902,195
101,0,blank,0,133.039233333333,282.668716666667,235902,236080,178
101,0,blank,0,134.1443,284.4668,236080,236110,30
101,0,blank,0,374.139333333333,378.739316666667,236139,236318,179
101,0,blank,0,254.692966666667,375.869016666667,236318,236493,175
101,0,blank,0,197.853266666667,376.012416666667,236493,236672,179
101,0,blank,0,167.14485,374.585083333333,236672,236851,179
101,0,blank,0,174.776233333333,377.170466666667,236851,237029,178
101,0,blank,0,142.853316666667,297.673816666667,237029,237207,178
101,41,(,310,130.953933333333,255.026916666667,237207,237384,177
101,39,return,305,139.95235,226.977716666667,237384,237560,176
101,0,blank,0,167.623625,240.82395,237560,237676,116
101,0,blank,0,-323,-105,237706,237810,104
101,0,blank,0,151.876371428571,272.828771428571,237898,238095,197
101,0,blank,0,150.284633333333,291.73345,238095,238272,177
101,43,n2,320,165.464666666667,303.255066666667,238272,238450,178
101,0,blank,0,105.783033333333,311.797716666667,238450,238632,182
101,0,blank,0,92.5803666666667,256.1914,238632,238719,87
101,0,blank,0,72.1841833333333,238.73185,238747,238934,187
101,0,blank,0,113.992883333333,235.3777,238934,239126,192
101,39,return,305,95.6886166666667,223.318516666667,239126,239313,187
101,0,blank,0,97.1749666666667,236.0845,239313,239508,195
101,41,(,310,132.71055,271.530083333333,239508,239689,181
101,0,blank,0,154.5436,328.1308,239689,239718,29
101,0,blank,0,155.0579,445.754316666667,239748,239925,177
101,0,blank,0,149.509733333333,447.611816666667,239925,240104,179
101,0,blank,0,162.244283333333,422.446833333333,240104,240282,178
101,48,k,362,164.63274,420.1468,240282,240433,151
101,0,blank,0,55.36695,602.260183333333,240463,240649,186
101,0,blank,0,57.7102833333333,624.358283333333,240649,240832,183
101,0,blank,0,23.66855,662.48245,240832,240954,122
101,32,print,231,60.8299,63.0635,241015,241195,180
101,32,print,231,59.4415833333333,62.2514333333333,241195,241373,178
101,0,blank,0,83.5674833333333,95.0628166666667,241373,241555,182
101,37,i,300,85.4793666666666,168.61735,241555,241734,179
101,0,blank,0,75.7504333333333,239.427033333333,241734,241914,180
101,39,return,305,86.9816833333334,227.448983333333,241914,242096,182
101,39,return,305,122.52566,222.30568,242096,242242,146
101,0,blank,0,-323,-105,242272,242440,168
101,0,blank,0,-323,-105,242440,242627,187
101,0,blank,0,-323,-105,242627,242789,162
101,0,blank,0,-323,-105,242789,242952,163
101,0,blank,0,-323,-105,242952,243009,57
101,0,blank,0,104.13835,287.6578,243088,243192,104
101,0,blank,0,-323,-105,243491,243656,165
101,0,blank,0,-323,-105,243656,243801,145
101,0,blank,0,-323,-105,243801,243933,132
101,0,blank,0,305.823566666667,347.3226,244572,244758,186
101,0,blank,0,318.1223,353.451066666667,244758,244843,85
101,0,blank,0,270.9122,364.5031,244843,245254,411
101,47,c,338,166.510333333333,395.73555,245254,245439,185
101,0,blank,0,167.603566666667,384.213566666667,245468,245561,93
101,0,blank,0,339.940666666667,360.913133333333,245595,245777,182
101,0,blank,0,331.401866666667,361.4985,245777,245870,93
101,0,blank,0,139.443866666667,466.380583333333,245900,246087,187
101,0,blank,0,159.601183333333,419.868966666667,246087,246272,185
101,47,[,358,175.005416666667,394.7573,246272,246458,186
101,0,blank,0,170.65815,368.1019,246458,246643,185
101,0,blank,0,176.6477,365.7656,246643,246675,32
101,0,blank,0,-323,-105,246705,246761,56
101,0,blank,0,271.1922,494.4159,246787,246813,26
101,0,blank,0,277.785133333333,362.385466666667,246866,246945,79
101,0,blank,0,97.3575,250.11165,246976,247161,185
101,0,blank,0,98.6599,251.990233333333,247161,247252,91
101,0,blank,0,253.4683,382.525316666667,247283,247467,184
101,0,blank,0,287.76995,358.983433333333,247467,247649,182
101,0,blank,0,283.5777,372.5919,247649,247679,30
101,0,blank,0,460.029316666667,107.455216666667,247709,247894,185
101,0,blank,0,187.378466666667,133.059216666667,247925,248109,184
101,34,int,274,261.97725,100.825,248109,248300,191
101,0,blank,0,105.322325,137.6905,248334,248461,127
101,0,blank,0,-323,-105,248525,248579,54
101,45,n1,327,213.2812,355.9906,248605,248631,26
101,0,blank,0,221.84415,316.2492,248683,248792,109
101,0,blank,0,335.243816666667,370.610516666667,248822,249007,185
101,0,blank,0,365.527783333333,373.481166666667,249007,249190,183
101,0,blank,0,466.696183333333,381.178866666667,249190,249374,184
101,0,blank,0,465.3443,383.2257,249374,249404,30
101,0,blank,0,-323,-105,249434,249566,132
101,47,i,348,298.56666,395.29696,249592,249730,138
101,47,[,358,205.470733333333,401.01895,249760,249940,180
101,0,blank,0,340.121833333333,406.473733333333,249940,250123,183
101,0,blank,0,348.3224,410.7839,250123,250248,125
101,0,blank,0,-323,-105,250278,250360,82
101,0,blank,0,223.1799,418.4252,250385,250413,28
101,0,blank,0,215.28974,425.87894,250497,250641,144
101,49,a,371,342.270033333333,436.168433333333,250671,250855,184
101,0,blank,0,346.3967,462.18305,250855,250914,59
101,0,blank,0,192.757366666667,463.302916666667,250944,251123,179
101,0,blank,0,179.311266666667,452.56075,251123,251296,173
101,0,blank,0,177.99635,501.046225,251296,251414,118
101,0,blank,0,253.530771428571,483.2938,251441,251640,199
101,0,blank,0,291.89635,494.155666666667,251640,251814,174
101,0,blank,0,334.607025,500.863725,251814,251925,111
101,0,blank,0,113.330975,506.5497,251953,252143,190
101,55,0,410,127.238066666667,563.1471,252143,252219,76
101,52,;,389,156.515666666667,513.369433333333,252248,252333,85
101,0,blank,0,-323,-105,252362,252416,54
101,0,blank,0,207.0174,565.7708,252441,252467,26
101,49,multiply,365,198.071157142857,429.3506,252518,252703,185
101,0,blank,0,205.12125,423.60625,252703,252816,113
101,0,blank,0,337.880257142857,420.579728571429,252844,253042,198
101,0,blank,0,336.392314285714,417.550385714286,253042,253239,197
101,0,blank,0,337.538075,412.35035,253239,253353,114
101,0,blank,0,215.020042857143,424.386285714286,253381,253580,199
101,0,blank,0,-323,-105,253609,253753,144
101,0,blank,0,171.096428571429,406.713757142857,253779,253970,191
101,48,++,363,175.7048,412.942966666667,253970,254143,173
101,0,blank,0,170.611416666667,384.33485,254143,254315,172
101,0,blank,0,165.687471428571,381.969028571429,254315,254512,197
101,48,++,363,179.012233333333,422.949466666667,254512,254685,173
101,45,if,323,131.1492,352.7603,254685,254856,171
101,0,blank,0,110.456871428571,331.959285714286,254856,255054,198
101,0,blank,0,121.869628571429,328.349771428571,255054,255251,197
101,0,blank,0,145.5867,324.29675,255251,255422,171
101,45,if,323,132.0007,358.5762,255422,255452,30
101,49,multiply,365,207.5363,449.753883333333,255478,255651,173
101,48,k,362,168.108528571429,423.8995,255651,255849,198
101,0,blank,0,156.8018,426.6523,255849,255878,29
101,0,blank,0,-323,-105,255906,256011,105
101,48,++,363,177.8073,411.7581,256043,256088,45
101,0,blank,0,267.901828571429,417.638485714286,256153,256342,189
101,49,m1,367,264.588216666667,437.4819,256342,256515,173
101,0,blank,0,258.8015,424.7179,256515,256544,29
101,0,blank,0,-323,-105,256629,256793,164
101,0,blank,0,321.263014285714,428.329657142857,256827,257013,186
101,0,blank,0,324.8901,423.6346,257013,257069,56
101,0,blank,0,152.781383333333,438.99335,257126,257300,174
101,0,blank,0,151.727442857143,440.187542857143,257300,257495,195
101,0,blank,0,159.477471428571,427.358671428571,257495,257690,195
101,0,blank,0,161.36015,425.833,257690,257862,172
101,48,k,362,165.3681,410.039825,257862,257975,113
101,0,blank,0,274.6666,411.3848,258004,258087,83
101,49,m1,367,262.8934,435.905857142857,258144,258341,197
101,0,blank,0,275.9301,422.592075,258341,258456,115
101,0,blank,0,276.5072,406.0239,258513,258572,59
101,0,blank,0,-323,-105,258632,258789,157
101,0,blank,0,-323,-105,258789,258901,112
101,49,(,366,252.292014285714,430.067471428571,258933,259126,193
101,47,c,338,278.104183333333,404.597383333333,259126,259309,183
101,0,blank,0,278.285133333333,416.831666666667,259309,259400,91
101,0,blank,0,-323,-105,259431,259594,163
101,0,blank,0,-323,-105,259594,259780,186
101,0,blank,0,-323,-105,259780,259952,172
101,0,blank,0,515.0884,360.2322,260545,260584,39
101,0,blank,0,-323,-105,260612,260798,186
101,0,blank,0,-323,-105,260798,260973,175
101,0,blank,0,-323,-105,260973,261165,192
101,0,blank,0,-323,-105,261165,261347,182
101,0,blank,0,-323,-105,261347,261487,140
101,0,blank,0,344.769,355.1959,261743,261796,53
101,0,blank,0,213.325633333333,369.739416666667,261827,262011,184
101,0,blank,0,216.316166666667,367.612966666667,262011,262194,183
101,0,blank,0,201.551433333333,368.1076,262194,262377,183
101,0,blank,0,310.944983333333,361.2733,262377,262560,183
101,0,blank,0,337.856483333333,360.832583333333,262560,262743,183
101,0,blank,0,-323,-105,262773,262879,106
101,0,blank,0,417.1811,346.3973,262907,262947,40
101,0,blank,0,417.126266666667,356.772333333333,263014,263097,83
101,0,blank,0,211.17335,366.650383333333,263127,263310,183
101,0,blank,0,213.6944,365.536816666667,263310,263493,183
101,0,blank,0,223.2544,374.7809,263493,263546,53
101,0,blank,0,268.3426,387.55565,263741,263898,157
101,0,blank,0,207.9496,368.03856,263898,264070,172
101,0,blank,0,207.906,370.00805,264070,264130,60
101,0,blank,0,-323,-105,264161,264242,81
101,0,blank,0,353.9915,467.0953,264268,264294,26
101,0,blank,0,319.157585714286,358.156885714286,264348,264547,199
101,0,blank,0,208.1423,367.126433333333,264547,264731,184
101,0,blank,0,216.928416666667,372.1498,264731,264914,183
101,0,blank,0,227.5813,379.342966666667,264914,265005,91
101,0,blank,0,-323,-105,265035,265203,168
101,0,blank,0,230.66,367.41115,265252,265428,176
101,0,blank,0,226.8383,372.10685,265428,265489,61
101,0,blank,0,348.694166666667,364.011366666667,265518,265701,183
101,0,blank,0,344.8338,371.6058,265701,265731,30
101,0,blank,0,203.1566,362.544116666667,265762,265942,180
101,0,blank,0,183.704633333333,331.921316666667,265942,266123,181
101,0,blank,0,153.181583333333,296.998766666667,266123,266306,183
101,0,blank,0,129.855616666667,243.468016666667,266306,266487,181
101,0,blank,0,161.40096,220.91894,266487,266640,153
101,0,blank,0,149.883425,255.48605,266671,266796,125
101,0,blank,0,-323,-105,266828,266910,82
101,0,blank,0,248.097966666667,332.46025,267023,267196,173
101,0,blank,0,217.962916666667,371.851016666667,267196,267380,184
101,0,blank,0,213.070766666667,370.969483333333,267380,267562,182
101,0,blank,0,209.53265,365.591916666667,267562,267747,185
101,0,blank,0,212.386033333333,366.290466666667,267747,267840,93
101,0,blank,0,-323,-105,267870,268003,133
101,0,blank,0,257.8925,367.929214285714,268035,268234,199
101,0,blank,0,351.0313,358.018533333333,268234,268420,186
101,0,blank,0,331.699216666667,362.170966666667,268420,268604,184
101,0,blank,0,331.838583333333,363.764816666667,268604,268785,181
101,0,blank,0,267.981383333333,355.156516666667,268785,268967,182
101,45,n1,327,212.69914,354.47616,268967,269119,152
101,0,blank,0,-323,-105,269149,269257,108
101,0,blank,0,218.512083333333,374.931,269398,269574,176
101,47,],360,227.33152,398.16694,269574,269731,157
101,0,blank,0,431.2845,370.22105,269761,269949,188
101,47,[,358,420.251233333333,395.766516666667,269949,270143,194
101,47,],360,435.768875,386.963825,270143,270266,123
101,0,blank,0,314.511583333333,341.794133333333,270297,270487,190
101,0,blank,0,-323,-105,270519,270600,81
101,0,blank,0,249.8926,316.7108,270626,270671,45
101,0,blank,0,-323,-105,270707,270870,163
101,0,blank,0,386.13375,350.3484,271072,271252,180
101,0,blank,0,310.414466666667,363.552516666667,271252,271437,185
101,0,blank,0,313.046266666667,359.21925,271437,271622,185
101,0,blank,0,311.7783,367.0417,271622,271653,31
101,0,blank,0,-323,-105,271684,271803,119
101,0,blank,0,249.604066666667,348.11975,271834,272008,174
101,0,blank,0,221.483416666667,364.85775,272008,272190,182
101,45,n1,327,222.71934,361.8897,272190,272342,152
101,0,blank,0,423.109516666667,352.3803,272373,272553,180
101,0,blank,0,431.4912,365.9966,272553,272584,31
101,0,blank,0,-323,-105,272614,272669,55
101,0,blank,0,455.785716666667,355.202916666667,272769,272939,170
101,0,blank,0,433.0581,360.538283333333,272939,273124,185
101,0,blank,0,511.312333333333,354.819983333333,273124,273306,182
101,0,blank,0,525.569583333333,371.472633333333,273306,273489,183
101,0,blank,0,526.97845,376.9932,273489,273548,59
101,0,blank,0,418.063016666667,354.384166666667,273578,273759,181
101,0,blank,0,468.858916666667,358.751083333333,273759,273941,182
101,0,blank,0,492.4756,362.053675,273941,274064,123
101,0,blank,0,-323,-105,274094,274150,56
101,0,blank,0,536.6088,417.6973,274175,274201,26
101,0,blank,0,518.8282,368.9187,274255,274365,110
101,0,blank,0,414.933866666667,358.108066666667,274396,274581,185
101,0,blank,0,412.153983333333,357.936266666667,274581,274765,184
101,0,blank,0,414.01345,359.3022,274765,274947,182
101,0,blank,0,416.991216666667,358.3107,274947,275128,181
101,0,blank,0,413.1954,350.528533333333,275128,275308,180
101,0,blank,0,-323,-105,275338,275471,133
101,0,blank,0,455.3953,363.9706,275512,275567,55
101,0,blank,0,458.545383333333,365.817816666667,275636,275812,176
101,0,blank,0,434.537,364.015966666667,275812,276000,188
101,0,blank,0,422.670083333333,366.647866666667,276000,276185,185
101,0,blank,0,428.972,379.831233333333,276185,276366,181
101,0,blank,0,435.531833333333,363.548216666667,276366,276548,182
101,0,blank,0,451.289316666667,362.519416666667,276548,276731,183
101,0,blank,0,495.139466666667,367.554866666667,276731,276910,179
101,0,blank,0,534.456083333333,364.186116666667,276910,277093,183
101,0,blank,0,524.661833333333,366.42665,277093,277278,185
101,0,blank,0,499.612666666667,367.669833333333,277278,277462,184
101,0,blank,0,434.59265,360.898116666667,277462,277645,183
101,0,blank,0,435.312133333333,360.477133333333,277645,277826,181
101,0,blank,0,440.72735,353.954816666667,277826,278011,185
101,0,blank,0,456.02175,354.4,278011,278194,183
101,0,blank,0,534.8269,367.886775,278194,278348,154
101,0,blank,0,-323,-105,278373,278524,151
101,45,n1,327,222.35455,351.167916666667,278559,278731,172
101,0,blank,0,241.742483333333,356.759633333333,278731,278915,184
101,0,blank,0,235.501466666667,354.733533333333,278915,279093,178
101,0,blank,0,218.346366666667,376.8171,279093,279188,95
101,0,blank,0,490.529366666667,411.658816666667,279250,279429,179
101,49,;,381,501.6233,449.3738,279429,279459,30
101,0,blank,0,413.61655,394.41485,279490,279670,180
101,47,i,348,399.91985,405.078916666667,279670,279848,178
101,0,blank,0,353.3061,408.40536,279848,280041,193
101,0,blank,0,389.442416666667,424.180833333333,280041,280213,172
101,0,blank,0,390.2232,417.32075,280213,280327,114
101,0,blank,0,-323,-105,280355,280436,81
101,0,blank,0,460.3906,377.7209,280462,280497,35
101,47,*,353,461.1763,395.175457142857,280557,280749,192
101,0,blank,0,451.75364,402.69578,280749,280900,151
101,0,blank,0,513.2185,377.12174,280900,281079,179
101,0,blank,0,504.50482,379.6587,281079,281264,185
101,0,blank,0,-323,-105,281294,281377,83
101,0,blank,0,519.9517,382.1213,281403,281456,53
101,0,blank,0,478.03375,377.927716666667,281532,281720,188
101,0,blank,0,466.154975,372.5322,281720,281848,128
101,0,blank,0,202.360166666667,423.986266666667,281881,282079,198
101,0,blank,0,240.1215,427.33314,282079,282248,169
101,0,blank,0,242.7197,414.7134,282248,282282,34
101,49,a,371,336.505016666667,430.359866666667,282315,282507,192
101,49,a,371,338.44495,432.0843,282507,282572,65
101,0,blank,0,-323,-105,282634,282666,32
101,0,blank,0,451.512,472.804,282692,282718,26
101,0,blank,0,493.703066666667,370.092966666667,282789,282971,182
101,0,blank,0,529.5143,381.469916666667,282971,283161,190
101,0,blank,0,533.459166666667,381.917933333333,283161,283255,94
101,0,blank,0,-323,-105,283286,283395,109
101,0,blank,0,513.9144,361.8161,283427,283468,41
101,0,blank,0,477.646633333333,362.6966,283533,283712,179
101,0,blank,0,427.33042,364.86968,283712,283865,153
101,0,blank,0,449.0227,379.1251,283865,283990,125
101,0,blank,0,462.0604,372.0575,283990,284091,101
101,0,blank,0,463.8715,382.4494,284091,284200,109
101,0,blank,0,254.2353,356.55305,284277,284463,186
101,0,blank,0,263.84495,362.4371,284463,284523,60
101,0,blank,0,156.4294,334.115683333333,284553,284732,179
101,0,blank,0,185.616466666667,326.7988,284732,284913,181
101,0,blank,0,187.179766666667,325.13745,284913,285095,182
101,0,blank,0,188.0021,319.2873,285095,285277,182
101,0,blank,0,156.252483333333,319.91865,285277,285461,184
101,0,blank,0,141.23205,318.58865,285461,285521,60
101,0,blank,0,174.48465,453.912516666667,285551,285735,184
101,0,blank,0,216.194316666667,413.44855,285735,285921,186
101,49,multiply,365,194.28895,438.1539,285921,286106,185
101,0,blank,0,182.215433333333,465.937783333333,286106,286289,183
101,0,blank,0,183.336566666667,465.33025,286289,286475,186
101,0,blank,0,167.596733333333,381.40745,286475,286660,185
101,0,blank,0,166.090516666667,328.867883333333,286660,286842,182
101,0,blank,0,207.687033333333,316.890466666667,286842,287027,185
101,0,blank,0,213.478416666667,317.856433333333,287027,287209,182
101,0,blank,0,211.5137,315.2446,287209,287241,32
101,0,blank,0,-323,-105,287272,287453,181
101,0,blank,0,196.4943,301.0856,287484,287516,32
101,0,blank,0,187.89155,450.77675,287574,287758,184
101,49,multiply,365,168.74425,443.96285,287758,287817,59
101,0,blank,0,-323,-105,287848,287955,107
101,49,multiply,365,174.8706,444.425,287981,288014,33
101,0,blank,0,161.402933333333,468.313316666667,288084,288259,175
101,0,blank,0,157.112816666667,488.14185,288259,288443,184
101,0,blank,0,163.886433333333,507.435833333333,288443,288627,184
101,0,blank,0,164.667033333333,505.381016666667,288627,288812,185
101,0,blank,0,220.221666666667,510.918333333333,288812,288998,186
101,0,blank,0,191.388416666667,502.832033333333,288998,289184,186
101,0,blank,0,173.300766666667,498.3297,289184,289368,184
101,0,blank,0,216.602816666667,513.98425,289368,289554,186
101,53,comma,403,240.7474,528.208083333333,289554,289742,188
101,0,blank,0,153.035283333333,540.631016666667,289742,289928,186
101,0,blank,0,139.873216666667,543.11085,289928,290111,183
101,0,blank,0,171.338616666667,504.85115,290111,290297,186
101,0,blank,0,185.62395,484.71605,290297,290480,183
101,51,0,385,172.7121,486.15575,290480,290601,121
101,0,blank,0,410.469016666667,370.425483333333,290663,290849,186
101,0,blank,0,388.96455,372.29115,290849,290972,123
101,0,blank,0,211.8928,363.0268,291002,291187,185
101,0,blank,0,216.7196,367.71095,291187,291249,62
101,51,0,385,167.752316666667,479.128566666667,291281,291468,187
101,0,blank,0,185.53082,466.44804,291468,291623,155
101,0,blank,0,-323,-105,291653,291785,132
101,0,blank,0,162.6371,298.652,291815,291859,44
101,43,n2,320,168.452733333333,308.236033333333,291948,292031,83
101,49,multiply,365,174.704016666667,448.749,292062,292245,183
101,51,;,386,175.019783333333,474.6338,292245,292429,184
101,51,0,385,164.48935,484.444833333333,292429,292613,184
101,51,0,385,164.972266666667,487.7526,292613,292704,91
101,0,blank,0,301.900333333333,513.7139,292736,292918,182
101,0,blank,0,291.998583333333,520.80925,292918,293105,187
101,0,blank,0,283.688766666667,503.883066666667,293105,293198,93
101,53,comma,403,421.1527,518.6012,293228,293413,185
101,0,blank,0,423.41405,519.27805,293413,293598,185
101,0,blank,0,411.1813,578.3158,293598,293629,31
101,0,blank,0,-323,-105,293662,293718,56
101,0,blank,0,367.567516666667,508.959716666667,293853,294029,176
101,0,blank,0,367.980933333333,509.117366666667,294029,294121,92
101,53,),405,446.622516666667,517.688316666667,294151,294335,184
101,0,blank,0,410.0361,504.0165,294335,294522,187
101,0,blank,0,402.16755,517.833616666667,294522,294706,184
101,0,blank,0,359.172,512.05345,294706,294890,184
101,0,blank,0,302.644816666667,513.52005,294890,295077,187
101,0,blank,0,286.647933333333,509.14355,295077,295257,180
101,53,m2,398,332.093233333333,518.731416666667,295257,295439,182
101,0,blank,0,321.07015,507.58545,295439,295498,59
101,53,(,391,205.051183333333,524.790766666667,295528,295713,185
101,0,blank,0,272.06415,513.177016666667,295713,295899,186
101,0,blank,0,198.857833333333,475.329766666667,295899,296082,183
101,0,blank,0,179.26325,466.75875,296082,296143,61
101,0,blank,0,-323,-105,296174,296310,136
101,37,),303,161.025583333333,174.52,296338,296513,175
101,34,int,274,174.560766666667,105.8222,296513,296695,182
101,34,(,243,151.79035,111.945183333333,296695,296876,181
101,0,blank,0,81.0202333333333,127.316316666667,296876,297058,182
101,36,static,284,92.9184833333333,148.152366666667,297058,297239,181
101,34,multiply,242,88.1343,111.787416666667,297239,297418,179
101,0,blank,0,62.4508,79.0124,297418,297584,166
101,0,blank,0,158.99345,87.45525,297584,297735,151
101,0,blank,0,151.9112,82.0404,297735,297785,50
101,0,blank,0,-323,-105,297937,298119,182
101,0,blank,0,-323,-105,298119,298307,188
101,0,blank,0,-323,-105,298307,298340,33
101,0,blank,0,404.9072,477.1094,298467,298492,25
101,34,int,274,177.9449,102.0716,298793,298866,73
101,0,blank,0,-323,-105,298941,299118,177
101,0,blank,0,-323,-105,299118,299169,51
101,0,blank,0,266.041266666667,493.069216666667,299194,299385,191
101,0,blank,0,259.931525,500.4042,299385,299571,186
101,53,n1,394,263.57885,535.33315,299571,299726,155
101,0,blank,0,240.039775,514.389925,299726,299910,184
101,0,blank,0,253.6989,508.5283,299910,299960,50
101,53,comma,403,385.059125,522.168675,300010,300139,129
101,0,blank,0,335.0654,491.91045,300139,300270,131
101,0,blank,0,-323,-105,300370,300546,176
101,0,blank,0,-323,-105,300546,300731,185
101,36,=,295,319.568233333333,154.0629,300947,301097,150
101,0,blank,0,329.2421,140.0641,301097,301147,50
101,53,comma,403,280.006466666667,523.349533333333,301272,301422,150
101,49,multiply,365,199.3115,436.086,301497,301522,25
101,0,blank,0,238.879833333333,503.744233333333,301647,301722,75
101,0,blank,0,223.1795,509.0673,301722,301898,176
101,0,blank,0,213.343,469.6189,301898,301924,26
101,0,blank,0,225.52765,545.95565,301924,302123,199
101,0,blank,0,211.5268,499.912666666667,302123,302298,175
101,0,blank,0,195.9211,515.9865,302298,302323,25
101,0,blank,0,271.5461,541.5293,302323,302498,175
101,53,n1,394,260.077175,523.2657,302498,302648,150
101,0,blank,0,222.892,197.916,302673,302727,54
101,0,blank,0,-323,-105,302980,303067,87
101,0,blank,0,-323,-105,303067,303441,374
101,0,blank,0,-323,-105,303441,303543,102
101,34,multiply,242,119.7131,101.762166666667,303631,303780,149
101,34,int,274,167.856375,117.13225,303847,303993,146
101,0,blank,0,205.521,120.10715,303993,304121,128
101,0,blank,0,127.3291,186.2359,304221,304296,75
101,0,blank,0,135.6508,95.3434,304483,304581,98
101,0,blank,0,-323,-105,304642,304806,164
101,0,blank,0,228.705466666667,600.320766666667,304831,304954,123
101,0,blank,0,324.828928571429,497.4043,305008,305205,197
101,0,blank,0,296.2023,462.5298,305205,305235,30
101,0,blank,0,375.589,459.2391,305235,305447,212
101,49,comma,378,317.7802,448.63515,305447,305539,92
101,39,return,305,118.0999,213.2677,305584,305756,172
101,36,int,285,133.131375,156.2729,305801,305984,183
101,0,blank,0,125.525366666667,166.536266666667,305984,306118,134
101,0,blank,0,249.62106,75.16198,306163,306334,171
101,34,int,274,258.354116666667,104.4548,306334,306517,183
101,0,blank,0,177.985783333333,455.8861,306579,306768,189
101,0,blank,0,138.06275,457.1723,306768,306956,188
101,49,multiply,365,165.527583333333,431.22975,306956,307146,190
101,47,[,358,208.732533333333,401.306566666667,307146,307238,92
101,0,blank,0,326.5657,411.83995,307268,307452,184
101,0,blank,0,326.576833333333,418.308433333333,307452,307545,93
101,0,blank,0,435.9691,372.6737,307575,307605,30
101,0,blank,0,422.31035,378.442516666667,307668,307857,189
101,0,blank,0,394.846,363.451133333333,307857,307949,92
101,0,blank,0,-323,-105,307979,308085,106
101,47,j,359,188.5288,402.9595,308111,308137,26
101,47,],360,194.981033333333,403.651233333333,308201,308373,172
101,0,blank,0,180.0878,406.973633333333,308373,308555,182
101,51,=,384,153.2634,486.2002,308555,308587,32
101,48,;,364,199.936666666667,420.605916666667,308617,308798,181
101,0,blank,0,149.361266666667,460.918216666667,308798,308978,180
101,51,=,384,143.679566666667,474.514466666667,308978,309160,182
101,0,blank,0,154.537016666667,459.00985,309160,309340,180
101,0,blank,0,147.176116666667,437.888583333333,309340,309521,181
101,0,blank,0,133.205733333333,411.282133333333,309521,309705,184
101,0,blank,0,142.401916666667,366.845966666667,309705,309893,188
101,0,blank,0,159.815033333333,375.203866666667,309893,310076,183
101,0,blank,0,152.932833333333,409.474333333333,310076,310260,184
101,0,blank,0,151.9234,426.0888,310260,310292,32
101,0,blank,0,-323,-105,310323,310380,57
101,51,=,384,153.4977,489.1027,310405,310431,26
101,0,blank,0,147.341133333333,358.055883333333,310482,310653,171
101,43,<,319,147.17215,316.73115,310653,310844,191
101,0,blank,0,173.891683333333,323.698316666667,310844,311029,185
101,0,blank,0,172.4856,334.163066666667,311029,311210,181
101,0,blank,0,-323,-105,311239,311269,30
101,0,blank,0,137.46618,479.86984,311319,311453,134
101,0,blank,0,-323,-105,311517,311707,190
101,0,blank,0,-323,-105,311707,311875,168
101,0,blank,0,-323,-105,311875,312054,179
101,0,blank,0,-323,-105,312054,312219,165
101,0,blank,0,-323,-105,312219,312362,143
101,0,blank,0,-323,-105,312362,312485,123
101,0,blank,0,-323,-105,312485,312654,169
101,0,blank,0,-323,-105,312654,312848,194
101,0,blank,0,-323,-105,312848,313037,189
101,0,blank,0,-323,-105,313037,313225,188
101,0,blank,0,-323,-105,313225,313424,199
101,0,blank,0,-323,-105,313424,313548,124
101,0,blank,0,-323,-105,313548,313724,176
101,0,blank,0,-323,-105,313724,313862,138
101,0,blank,0,-323,-105,313862,313974,112
101,0,blank,0,-323,-105,313974,314132,158
101,0,blank,0,-323,-105,314132,314316,184
101,0,blank,0,-323,-105,314316,314748,432
101,0,blank,0,-323,-105,314748,314936,188
101,0,blank,0,-323,-105,314936,315098,162
101,0,blank,0,-323,-105,315098,315248,150
101,0,blank,0,-323,-105,315248,315416,168
101,0,blank,0,-323,-105,315416,315593,177
101,0,blank,0,-323,-105,315593,315773,180
101,0,blank,0,-323,-105,315773,315845,72
101,0,blank,0,-323,-105,315845,316039,194
101,0,blank,0,-323,-105,316039,316236,197
101,0,blank,0,-323,-105,316236,316406,170
101,0,blank,0,-323,-105,316406,316570,164
101,0,blank,0,-323,-105,316570,316755,185
101,0,blank,0,-323,-105,316755,316937,182
101,0,blank,0,-323,-105,316937,317127,190
101,0,blank,0,-323,-105,317127,317321,194
101,0,blank,0,-323,-105,317321,317498,177
101,0,blank,0,-323,-105,317498,317689,191
101,0,blank,0,-323,-105,317689,317821,132
101,0,blank,0,-323,-105,317821,317995,174
101,0,blank,0,-323,-105,317995,318113,118
101,0,blank,0,-323,-105,318113,318325,212
101,0,blank,0,-323,-105,318325,318351,26
101,0,blank,0,-323,-105,318351,318875,524
101,0,blank,0,-323,-105,318875,319395,520
101,0,blank,0,-323,-105,319395,319578,183
101,0,blank,0,-323,-105,319578,319661,83
101,0,blank,0,-323,-105,319661,319855,194
101,0,blank,0,-323,-105,319855,319885,30
101,0,blank,0,-323,-105,319885,320086,201
101,0,blank,0,-323,-105,320086,320292,206
101,0,blank,0,-323,-105,320292,320364,72
101,0,blank,0,-323,-105,320364,320579,215
101,0,blank,0,-323,-105,320579,320799,220
101,0,blank,0,-323,-105,320799,321227,428
101,0,blank,0,-323,-105,321227,321299,72
101,0,blank,0,-323,-105,321299,321555,256
101,0,blank,0,-323,-105,321555,321809,254
101,0,blank,0,-323,-105,321809,322063,254
101,0,blank,0,-323,-105,322063,322256,193
101,0,blank,0,-323,-105,322256,322430,174
101,0,blank,0,-323,-105,322430,322627,197
101,0,blank,0,-323,-105,322627,322719,92
101,0,blank,0,-323,-105,322719,322845,126
101,0,blank,0,-323,-105,322845,322957,112
101,0,blank,0,-323,-105,322957,323180,223
101,0,blank,0,-323,-105,323180,323405,225
101,0,blank,0,-323,-105,323405,323594,189
101,0,blank,0,-323,-105,323594,323724,130
101,0,blank,0,-323,-105,323724,323918,194
101,0,blank,0,-323,-105,323918,324054,136
101,0,blank,0,-323,-105,324054,324260,206
101,0,blank,0,-323,-105,324260,324438,178
101,0,blank,0,-323,-105,324438,324617,179
101,0,blank,0,-323,-105,324617,324779,162
101,0,blank,0,-323,-105,324779,325297,518
101,0,blank,0,-323,-105,325297,325465,168
101,0,blank,0,-323,-105,325465,325659,194
101,0,blank,0,-323,-105,325659,325694,35
101,0,blank,0,-323,-105,325694,325910,216
101,0,blank,0,-323,-105,325910,325958,48
101,0,blank,0,-323,-105,325958,326444,486
101,37,m1,302,140.0605,172.6645,326820,327067,247
101,0,blank,0,49.8826,164.1906,327067,327115,48
101,0,blank,0,-323,-105,327275,327458,183
101,0,blank,0,-323,-105,327458,327636,178
101,0,blank,0,-323,-105,327636,327663,27
101,0,blank,0,130.50055,195.7792,327689,327860,171
101,0,blank,0,133.35115,193.091,327860,327957,97
101,0,blank,0,137.819166666667,131.682866666667,327997,328122,125
101,0,blank,0,-323,-105,328205,328391,186
101,0,blank,0,-323,-105,328391,328570,179
101,0,blank,0,-323,-105,328570,328759,189
101,0,blank,0,-323,-105,328759,328796,37
101,43,n2,320,179.92905,301.268725,328831,329007,176
101,0,blank,0,166.916666666667,287.713416666667,329007,329178,171
101,41,m1,313,193.089816666667,266.59665,329178,329352,174
101,0,blank,0,194.9118,234.292466666667,329352,329526,174
101,0,blank,0,189.3179,279.60275,329526,329703,177
101,0,blank,0,186.394566666667,338.018116666667,329703,329878,175
101,0,blank,0,196.419583333333,319.266683333333,329878,330055,177
101,0,blank,0,223.470016666667,328.157,330055,330231,176
101,45,n1,327,217.827583333333,344.443566666667,330231,330406,175
101,45,n1,327,219.46458,353.80146,330406,330552,146
101,0,blank,0,-323,-105,330582,330636,54
101,0,blank,0,227.519257142857,321.412914285714,330740,330930,190
101,45,n1,327,221.872733333333,348.730266666667,330930,331103,173
101,0,blank,0,211.416883333333,365.207083333333,331103,331281,178
101,45,n1,327,205.1493,351.660966666667,331281,331369,88
101,0,blank,0,-323,-105,331399,331591,192
101,0,blank,0,-323,-105,331591,331771,180
101,0,blank,0,-323,-105,331771,331960,189
101,0,blank,0,-323,-105,331960,332134,174
101,0,blank,0,-323,-105,332134,332310,176
101,0,blank,0,-323,-105,332310,332502,192
101,0,blank,0,-323,-105,332502,332681,179
101,0,blank,0,-323,-105,332681,332802,121
101,0,blank,0,-323,-105,332802,332898,96
101,0,blank,0,-323,-105,332898,333076,178
101,0,blank,0,-323,-105,333076,333253,177
101,0,blank,0,-323,-105,333253,333401,148
101,0,blank,0,-323,-105,333401,333561,160
101,0,blank,0,-323,-105,333561,333663,102
101,0,blank,0,-323,-105,333663,333852,189
101,0,blank,0,-323,-105,333852,333985,133
101,0,blank,0,-323,-105,333985,334308,323
101,0,blank,0,-323,-105,334308,334419,111
101,0,blank,0,-323,-105,334419,334591,172
101,0,blank,0,-323,-105,334591,334730,139
101,0,blank,0,-323,-105,334730,334894,164
101,0,blank,0,-323,-105,334894,335090,196
101,0,blank,0,-323,-105,335090,335213,123
101,0,blank,0,-323,-105,335213,335330,117
101,0,blank,0,-323,-105,335330,335571,241
101,0,blank,0,-323,-105,335571,335754,183
101,0,blank,0,-323,-105,335754,335935,181
101,0,blank,0,-323,-105,335935,336044,109
101,0,blank,0,-323,-105,336044,336303,259
101,0,blank,0,-323,-105,336303,336944,641
101,0,blank,0,-323,-105,336944,337187,243
101,0,blank,0,-323,-105,337187,337280,93
101,0,blank,0,465.04404,352.5827,337493,337692,199
101,0,blank,0,501.685966666667,352.997216666667,337692,337890,198
101,0,blank,0,501.312075,349.055875,337890,338063,173
101,0,blank,0,422.76004,359.41248,338063,338262,199
101,0,blank,0,407.1836,347.9007,338262,338380,118
101,0,blank,0,-323,-105,338461,338652,191
101,0,blank,0,-323,-105,338652,338843,191
101,0,blank,0,-323,-105,338843,339020,177
101,0,blank,0,-323,-105,339020,339199,179
101,0,blank,0,-323,-105,339199,339262,63
101,0,blank,0,-323,-105,339262,339523,261
101,0,blank,0,-323,-105,339523,339787,264
101,0,blank,0,-323,-105,339787,339980,193
101,0,blank,0,-323,-105,339980,340106,126
101,0,blank,0,-323,-105,340106,340340,234
101,0,blank,0,-323,-105,340340,340372,32
101,0,blank,0,-323,-105,340372,340647,275
101,0,blank,0,-323,-105,340647,340749,102
101,0,blank,0,-323,-105,340749,340865,116
101,0,blank,0,-323,-105,340865,340985,120
101,0,blank,0,-323,-105,340985,341077,92
101,0,blank,0,-323,-105,341077,341263,186
101,0,blank,0,-323,-105,341263,341444,181
101,0,blank,0,-323,-105,341444,341607,163
101,0,blank,0,-323,-105,341607,341795,188
101,0,blank,0,-323,-105,341795,342296,501
101,0,blank,0,-323,-105,342296,342789,493
101,0,blank,0,-323,-105,342789,342972,183
101,0,blank,0,-323,-105,342972,343071,99
101,0,blank,0,-323,-105,343071,343375,304
101,0,blank,0,-323,-105,343375,343714,339
101,0,blank,0,-323,-105,343714,343897,183
101,0,blank,0,-323,-105,343897,344111,214
101,0,blank,0,-323,-105,344111,344136,25
101,0,blank,0,-323,-105,344136,344519,383
101,0,blank,0,-323,-105,344519,344896,377
101,0,blank,0,-323,-105,344896,345042,146
101,0,blank,0,-323,-105,345379,345536,157
101,0,blank,0,-323,-105,345536,345583,47
101,0,blank,0,242.6647,396.9687,345738,345817,79
101,0,blank,0,-323,-105,345929,346072,143
101,0,blank,0,-323,-105,346201,346368,167
101,47,c,338,164.969366666667,386.110033333333,346587,346754,167
101,0,blank,0,157.167725,425.193075,346754,346917,163
101,0,blank,0,-323,-105,347062,347236,174
101,0,blank,0,-323,-105,347236,347415,179
101,0,blank,0,-323,-105,347415,347596,181
101,0,blank,0,-323,-105,347596,347738,142
101,0,blank,0,-323,-105,347738,347838,100
101,0,blank,0,-323,-105,347838,348377,539
101,0,blank,0,-323,-105,348377,348455,78
101,0,blank,0,144.950675,401.518175,348573,348736,163
101,0,blank,0,131.1539,439.412066666667,348736,348912,176
101,0,blank,0,134.7953,432.4413,348912,348940,28
101,0,blank,0,-323,-105,349116,349243,127
101,50,},382,124.550285714286,462.482242857143,349410,349607,197
101,50,},382,129.04105,458.08,349607,349784,177
101,50,},382,127.110416666667,455.143883333333,349784,349964,180
101,0,blank,0,122.808166666667,472.573183333333,349964,350143,179
101,50,},382,130.882983333333,460.06875,350143,350322,179
101,0,blank,0,138.1062,467.7522,350322,350500,178
101,50,},382,133.343033333333,460.675766666667,350500,350682,182
101,51,k,383,123.630933333333,478.71525,350682,350864,182
101,0,blank,0,143.100483333333,327.023383333333,350894,351074,180
101,0,blank,0,134.130266666667,324.611433333333,351074,351163,89
101,0,blank,0,-323,-105,351194,351325,131
101,0,blank,0,149.0499,285.516,351378,351442,64
101,0,blank,0,142.40105,307.1819,351509,351560,51
101,0,blank,0,116.74405,460.248416666667,351590,351772,182
101,0,blank,0,109.5143,476.4523,351772,351952,180
101,0,blank,0,139.905666666667,485.335516666667,351952,352132,180
101,0,blank,0,112.062783333333,543.523533333333,352132,352305,173
101,0,blank,0,92.6583714285714,584.149571428571,352305,352503,198
101,0,blank,0,95.8567857142857,565.000528571429,352503,352701,198
101,0,blank,0,94.3736857142857,571.8897,352701,352899,198
101,0,blank,0,104.528285714286,555.3447,352899,353098,199
101,0,blank,0,116.5006,515.996533333333,353098,353274,176
101,52,j,387,130.540666666667,515.572716666667,353274,353459,185
101,53,multiply,390,160.151966666667,520.59225,353459,353648,189
101,0,blank,0,163.96815,513.13385,353648,353708,60
101,0,blank,0,293.5705,504.583575,353739,353865,126
101,0,blank,0,-323,-105,353897,353953,56
101,52,++,388,140.1503,511.5703,353979,354005,26
101,0,blank,0,148.018833333333,458.884183333333,354063,354236,173
101,0,blank,0,137.658316666667,467.986733333333,354236,354419,183
101,0,blank,0,117.031133333333,477.349733333333,354419,354601,182
101,0,blank,0,117.527783333333,483.3693,354601,354782,181
101,0,blank,0,121.0131,488.40265,354782,354841,59
101,0,blank,0,146.843733333333,280.35005,354872,355053,181
101,0,blank,0,149.759283333333,150.37245,355084,355266,182
101,0,blank,0,194.761075,125.15805,355266,355387,121
101,0,blank,0,-323,-105,355414,355547,133
101,0,blank,0,164.523314285714,473.9429,355575,355774,199
101,51,k,383,133.1439,490.711933333333,355774,355957,183
101,0,blank,0,175.040966666667,516.009233333333,355957,356137,180
101,53,multiply,390,179.287325,520.034025,356137,356259,122
101,53,m2,398,337.0796,532.407516666667,356289,356472,183
101,53,m2,398,335.361766666667,536.359616666667,356472,356649,177
101,0,blank,0,316.867283333333,533.20885,356649,356824,175
101,0,blank,0,256.156733333333,541.89925,356824,356996,172
101,0,blank,0,281.597216666667,540.972383333333,356996,357169,173
101,0,blank,0,291.276157142857,528.411057142857,357169,357368,199
101,0,blank,0,-323,-105,357398,357503,105
101,0,blank,0,152.213,250.1276,357529,357554,25
101,0,blank,0,148.032285714286,244.6374,357607,357797,190
101,0,blank,0,198.293583333333,495.984016666667,357827,358006,179
101,0,blank,0,198.817366666667,505.741383333333,358006,358187,181
101,0,blank,0,260.820583333333,507.213933333333,358187,358367,180
101,53,n1,394,268.3967,526.0442,358367,358549,182
101,0,blank,0,245.126866666667,522.824783333333,358549,358733,184
101,0,blank,0,243.765183333333,523.714716666667,358733,358915,182
101,53,a,396,301.361183333333,518.908766666667,358915,359098,183
101,0,blank,0,313.681633333333,525.059516666667,359098,359280,182
101,0,blank,0,312.76028,523.74484,359280,359432,152
101,0,blank,0,-323,-105,359464,359570,106
101,0,blank,0,258.8386,495.8503,359596,359622,26
101,0,blank,0,207.858957142857,508.6623,359679,359877,198
101,53,n1,394,265.899983333333,525.7271,359877,360059,182
101,53,a,396,299.125483333333,534.142516666667,360059,360242,183
101,0,blank,0,320.69895,530.351983333333,360242,360423,181
101,0,blank,0,359.402533333333,522.221883333333,360423,360603,180
101,53,n2,400,378.025333333333,526.753366666667,360603,360693,90
101,51,=,384,148.1464,483.321075,360724,360844,120
101,36,static,284,92.4796,160.025866666667,360874,361053,179
101,0,blank,0,109.863166666667,137.775983333333,361053,361234,181
101,0,blank,0,121.5226,134.520783333333,361234,361413,179
101,0,blank,0,122.1657,142.788166666667,361413,361503,90
101,0,blank,0,300.857016666667,474.733516666667,361533,361714,181
101,0,blank,0,298.43885,513.717833333333,361714,361892,178
101,53,a,396,293.28455,525.7511,361892,361953,61
101,36,int,285,117.5121,162.921883333333,361983,362164,181
101,36,int,285,115.592316666667,146.423116666667,362164,362346,182
101,0,blank,0,118.425916666667,140.42465,362346,362527,181
101,0,blank,0,137.3474,140.68502,362527,362677,150
101,0,blank,0,307.183116666667,477.589883333333,362736,362919,183
101,0,blank,0,296.685866666667,513.357133333333,362919,363102,183
101,53,m1,392,221.406083333333,521.70445,363102,363285,183
101,0,blank,0,251.669416666667,519.841166666667,363285,363468,183
101,53,n1,394,257.8668,521.3875,363468,363499,31
101,0,blank,0,258.304316666667,420.023216666667,363528,363712,184
101,49,multiply,365,199.88735,436.4504,363712,363895,183
101,49,multiply,365,182.236483333333,435.886783333333,363895,364077,182
101,49,multiply,365,204.50225,432.502783333333,364077,364260,183
101,0,blank,0,130.289333333333,238.123016666667,364290,364475,185
101,0,blank,0,128.31636,251.8152,364475,364627,152
101,0,blank,0,-323,-105,364658,364845,187
101,0,blank,0,-323,-105,364845,364882,37
101,0,blank,0,183.330233333333,126.297233333333,364917,365102,185
101,53,comma,403,240.773866666667,517.12455,365127,365302,175
101,0,blank,0,278.51875,422.053875,365332,365452,120
101,0,blank,0,247.7363,459.19435,365621,365764,143
101,0,blank,0,251.72232,461.6572,365764,365962,198
101,0,blank,0,243.767085714286,470.030942857143,365962,366160,198
101,0,blank,0,309.7402,486.2989,366160,366332,172
101,0,blank,0,313.8038,503.329971428571,366332,366524,192
101,0,blank,0,272.6601,511.926783333333,366524,366688,164
101,0,blank,0,-323,-105,366716,366914,198
101,0,blank,0,-323,-105,366914,367107,193
101,0,blank,0,-323,-105,367107,367297,190
101,0,blank,0,-323,-105,367297,367477,180
101,0,blank,0,-323,-105,367477,367654,177
101,0,blank,0,-323,-105,367654,367828,174
101,0,blank,0,-323,-105,367828,368011,183
101,0,blank,0,-323,-105,368011,368190,179
101,0,blank,0,-323,-105,368190,368366,176
101,0,blank,0,-323,-105,368366,368546,180
101,0,blank,0,-323,-105,368546,368724,178
101,0,blank,0,-323,-105,368724,368903,179
101,0,blank,0,-323,-105,368903,369089,186
101,0,blank,0,-323,-105,369089,369270,181
101,0,blank,0,-323,-105,369270,369448,178
101,0,blank,0,-323,-105,369448,369632,184
101,0,blank,0,-323,-105,369632,369813,181
101,0,blank,0,-323,-105,369813,369991,178
101,0,blank,0,-323,-105,369991,370170,179
101,0,blank,0,-323,-105,370170,370348,178
101,0,blank,0,-323,-105,370348,370525,177
101,0,blank,0,-323,-105,370525,370700,175
101,0,blank,0,-323,-105,370700,370879,179
101,0,blank,0,-323,-105,370879,371067,188
101,0,blank,0,112.697833333333,241.894766666667,371093,371276,183
101,43,<,319,143.409633333333,297.263633333333,371276,371473,197
101,43,<,319,146.128983333333,302.210633333333,371473,371651,178
101,0,blank,0,149.0277,287.607283333333,371651,371837,186
101,43,<,319,143.5342,301.212166666667,371837,372019,182
101,0,blank,0,161.4817,329.64815,372019,372143,124
101,0,blank,0,-323,-105,372174,372323,149
101,0,blank,0,-323,-105,372323,372429,106
101,51,0,385,166.5832,492.08478,372503,372681,178
101,60,print,435,103.5976,688.2664,372716,372750,34
101,0,blank,0,-323,-105,372785,372970,185
101,0,blank,0,-323,-105,372970,374719,1749
101,0,blank,0,-323,-105,374719,374894,175
101,0,blank,0,96.58176,663.38998,374936,375129,193
101,0,blank,0,98.0637333333333,664.7512,375129,375240,111
101,0,blank,0,-323,-105,379039,379107,68
101,53,n1,394,273.015033333333,518.486366666667,379277,379459,182
101,53,n1,394,264.88775,528.549075,379459,379583,124
101,0,blank,0,393.826733333333,519.48425,379614,379799,185
101,0,blank,0,359.9223,518.586883333333,379799,379982,183
101,0,blank,0,314.985383333333,519.837716666667,379982,380165,183
101,53,n1,394,273.937675,525.51625,380165,380287,122
101,0,blank,0,-323,-105,380317,380400,83
101,53,m2,398,337.640628571429,530.022957142857,380480,380674,194
101,0,blank,0,315.002616666667,532.938766666667,380674,380851,177
101,0,blank,0,282.891266666667,529.701516666667,380851,381029,178
101,53,n1,394,255.124233333333,532.504566666667,381029,381117,88
101,0,blank,0,-323,-105,381146,381304,158
101,0,blank,0,-323,-105,381304,381346,42
101,53,n1,394,255.961157142857,530.714328571428,381371,381570,199
101,0,blank,0,319.404533333333,524.772033333333,381570,381749,179
101,53,m2,398,328.420483333333,525.050783333333,381749,381927,178
101,0,blank,0,355.37065,525.039433333333,381927,382104,177
101,53,n2,400,372.923616666667,526.978666666667,382104,382281,177
101,53,n2,400,376.022766666667,528.512716666667,382281,382456,175
101,53,b,402,406.364733333333,517.91445,382456,382633,177
101,53,comma,403,416.30766,519.34342,382633,382779,146
101,0,blank,0,-323,-105,382809,382890,81
101,0,blank,0,358.438,606.2142,382915,382940,25
101,0,blank,0,358.6607,470.5273,382991,383122,131
101,0,blank,0,121.974366666667,563.812516666667,383152,383331,179
101,0,blank,0,123.8366,555.719766666667,383331,383419,88
101,45,k,325,171.544583333333,348.67605,383449,383628,179
101,53,multiply,390,169.355,534.661433333333,383658,383857,199
101,0,blank,0,111.463416666667,536.605633333333,383857,384034,177
101,55,j,408,92.1462,580.515683333333,384034,384211,177
101,55,j,408,91.403225,578.084675,384211,384331,120
101,57,comma,428,308.7513,619.735666666667,384360,384538,178
101,0,blank,0,317.610133333333,608.1254,384538,384628,90
101,47,[,358,208.127716666667,401.998883333333,384658,384838,180
101,48,;,364,201.505233333333,414.7843,384838,384927,89
101,0,blank,0,-323,-105,384957,385012,55
101,49,n2,375,414.475933333333,434.289816666667,385145,385323,178
101,49,n2,375,412.5608,440.54275,385323,385382,59
101,53,multiply,390,201.3853,531.256933333333,385412,385590,178
101,49,n2,375,422.309233333333,438.886466666667,385620,385797,177
101,0,blank,0,434.567066666667,416.4352,385797,385910,113
101,49,multiply,365,203.49675,445.41755,386024,386210,186
101,0,blank,0,204.0338,455.4966,386210,386252,42
101,0,blank,0,-323,-105,386287,386396,109
101,53,multiply,390,164.3871,521.7368,386423,386456,33
101,53,multiply,390,175.126175,519.11895,386522,386633,111
101,0,blank,0,379.76556,516.78094,386664,386816,152
101,0,blank,0,119.670716666667,553.3608,386846,387029,183
101,52,;,389,159.0836,504.916916666667,387029,387208,179
101,0,blank,0,183.1948,470.077966666667,387208,387388,180
101,0,blank,0,268.512583333333,464.576116666667,387388,387569,181
101,49,comma,378,385.7463,445.8986,387569,387629,60
101,0,blank,0,-323,-105,387659,387740,81
101,0,blank,0,224.087,474.506,387766,387791,25
101,0,blank,0,230.132433333333,452.2363,387849,387926,77
101,53,n2,400,381.12365,517.971966666667,387956,388137,181
101,53,n2,400,383.959033333333,527.9541,388137,388321,184
101,0,blank,0,385.8753,515.7738,388321,388382,61
101,0,blank,0,119.828433333333,553.716866666667,388413,388596,183
101,0,blank,0,120.3153,554.31355,388596,388655,59
101,0,blank,0,318.594683333333,511.657083333333,388686,388869,183
101,53,m2,398,325.76115,522.949766666667,388869,389051,182
101,53,m2,398,326.933983333333,520.258733333333,389051,389232,181
101,53,m2,398,324.4403,522.37475,389232,389354,122
101,0,blank,0,-323,-105,389415,389493,78
101,0,blank,0,165.7074,498.4252,389519,389551,32
101,0,blank,0,165.799016666667,511.7045,389620,389791,171
101,0,blank,0,166.09655,507.835933333333,389791,389975,184
101,0,blank,0,172.0507,453.068216666667,389975,390158,183
101,48,++,363,183.532166666667,413.515,390158,390338,180
101,0,blank,0,243.181783333333,423.510133333333,390338,390521,183
101,0,blank,0,221.65875,423.69515,390521,390703,182
101,48,++,363,177.742416666667,417.26375,390703,390887,184
101,0,blank,0,175.0243,427.369366666667,390887,390977,90
101,0,blank,0,109.007733333333,334.906966666667,391008,391190,182
101,0,blank,0,110.20275,336.6614,391190,391373,183
101,47,j,359,188.213666666667,392.727383333333,391373,391555,182
101,0,blank,0,193.55625,400.8733,391555,391676,121
101,49,m2,373,377.71002,429.71586,391706,391858,152
101,0,blank,0,-323,-105,391888,391994,106
101,0,blank,0,221.2739,412.2156,392020,392055,35
101,0,blank,0,218.38315,417.112216666667,392121,392296,175
101,0,blank,0,203.4409,428.79,392296,392327,31
101,49,m2,373,367.722133333333,440.741583333333,392358,392542,184
101,49,n2,375,412.335966666667,439.285533333333,392542,392722,180
101,0,blank,0,418.502,450.125233333333,392722,392813,91
101,0,blank,0,403.10285,473.7407,392872,392930,58
101,51,=,384,150.473833333333,475.87775,392959,393131,172
101,52,++,388,148.6622,510.589271428571,393131,393329,198
101,0,blank,0,159.1953,483.9755,393329,393357,28
101,0,blank,0,-323,-105,393592,393675,83
101,0,blank,0,-323,-105,393675,393798,123
101,0,blank,0,201.4514,334.8194,393839,393911,72
101,50,},382,125.18235,460.12965,394033,394115,82
101,0,blank,0,108.894942857143,318.096642857143,394137,394325,188
101,0,blank,0,111.013516666667,319.36385,394325,394485,160
101,0,blank,0,121.979366666667,196.7821,394512,394707,195
101,0,blank,0,120.376428571429,187.910857142857,394707,394895,188
101,0,blank,0,119.7022,201.0503,394895,394949,54
101,0,blank,0,-323,-105,394977,395053,76
101,0,blank,0,312.7307,585.8165,395079,395104,25
101,0,blank,0,362.1465,421.382366666667,395161,395237,76
101,0,blank,0,398.601814285714,479.683257142857,395293,395492,199
101,0,blank,0,394.75675,481.367966666667,395492,395668,176
101,0,blank,0,381.98345,493.22825,395668,395725,57
101,0,blank,0,164.19136,460.8782,395810,395949,139
101,0,blank,0,83.5525,141.721828571429,395977,396165,188
101,0,blank,0,166.455085714286,151.6225,396165,396359,194
101,0,blank,0,257.874983333333,143.095016666667,396359,396524,165
101,0,blank,0,665.5799,128.414533333333,396579,396750,171
101,0,blank,0,676.20842,131.74866,396750,396891,141
101,34,comma,273,450.428983333333,100.894033333333,396920,397086,166
101,0,blank,0,797.6624,120.76766,397113,397250,137
101,0,blank,0,83.8790857142857,140.034728571429,397307,397503,196
101,0,blank,0,109.820833333333,150.282166666667,397503,397586,83
101,0,blank,0,769.115571428571,122.869171428571,397615,397812,197
101,0,blank,0,761.6288,127.57204,397812,397951,139
101,0,blank,0,-323,-105,397980,398059,79
101,0,blank,0,162.7765,278.8147,398084,398110,26
101,0,blank,0,149.6072,332.2764,398159,398185,26
101,0,blank,0,142.7138,666.938628571428,398261,398457,196
101,0,blank,0,88.5131571428572,651.467928571429,398457,398654,197
101,0,blank,0,81.6184666666667,624.7394,398654,398827,173
101,0,blank,0,71.0919333333333,646.425516666667,398827,398992,165
101,0,blank,0,0.615699999999996,658.541542857143,399021,399215,194
101,0,blank,0,-1.81389999999999,691.1007,399215,399242,27
101,0,blank,0,75.2413285714286,241.5696,399271,399466,195
101,37,if,298,62.7580428571429,182.965842857143,399466,399659,193
101,0,blank,0,51.0583142857143,119.641485714286,399659,399851,192
101,0,blank,0,54.0875666666667,122.758416666667,399851,400014,163
101,0,blank,0,236.949,130.145125,400040,400150,110
101,0,blank,0,52.3519428571429,89.2575428571429,400381,400572,191
101,36,static,284,48.67995,155.3855,400572,400628,56
101,0,blank,0,52.88325,128.9528,400655,400710,55
101,0,blank,0,-323,-105,400738,400815,77
101,37,m1,302,153.0996,180.1772,400840,400866,26
101,34,int,274,161.336257142857,118.966585714286,400916,401100,184
101,0,blank,0,166.07238,125.0659,401100,401239,139
101,0,blank,0,525.323542857143,130.546742857143,401267,401460,193
101,0,blank,0,514.778266666667,135.2666,401460,401542,82
101,0,blank,0,515.073,127.7848,401598,401626,28
101,0,blank,0,-323,-105,401733,401837,104
101,0,blank,0,95.8202714285714,197.1497,401993,402183,190
101,39,return,305,97.9848,214.184757142857,402183,402374,191
101,36,static,284,79.7888571428572,157.508357142857,402374,402567,193
101,0,blank,0,-323,-105,402705,402845,140
101,34,m1,245,199.465,103.79505,402890,402961,71
101,0,blank,0,183.494766666667,177.4767,403001,403118,117
101,0,blank,0,770.361428571429,151.827771428571,403755,403942,187
101,0,blank,0,717.313,180.6241,403942,403969,27
101,0,blank,0,-323,-105,403996,404100,104
101,0,blank,0,-323,-105,404194,404381,187
101,0,blank,0,-323,-105,404381,404556,175
101,0,blank,0,-323,-105,404556,404733,177
101,0,blank,0,-323,-105,404733,404900,167
101,0,blank,0,-323,-105,404900,405067,167
101,0,blank,0,117.2396,720.497,405085,405238,153
101,60,print,435,81.19555,680.07395,405238,405364,126
101,34,multiply,242,114.6271,111.6487,405739,405765,26
101,0,blank,0,91.9382,124.4718,405765,405989,224
101,0,blank,0,101.0884,122.322225,405989,406138,149
101,31,"OnmatrixmultiplicationofAandBtheresultis:\n",228,192.7858,42.492,406138,406409,271
101,32,m1,233,112.8472,71.5526,406409,406644,235
101,0,blank,0,-323,-105,406698,406824,126
101,31,"OnmatrixmultiplicationofAandBtheresultis:\n",228,180.4589,36.4604,406850,406875,25
101,0,blank,0,151.377466666667,-0.598800000000002,406923,407099,176
101,0,blank,0,116.9583,22.8511,407099,407123,24
101,31,"OnmatrixmultiplicationofAandBtheresultis:\n",228,168.9414,52.3538,407123,407299,176
101,31,"OnmatrixmultiplicationofAandBtheresultis:\n",228,168.9414,52.3538,407299,407324,25
101,0,blank,0,296.89715,5.87445,407650,407699,49
101,31,"OnmatrixmultiplicationofAandBtheresultis:\n",228,172.0269,38.6485,407750,407901,151
101,0,blank,0,253.5618,567.31155,408051,408175,124
101,60,m1,438,164.203,674.8643,408275,408301,26
101,0,blank,0,217.1624,628.6559,408301,408500,199
101,0,blank,0,208.1094,598.6263,408500,408550,50
101,0,blank,0,198.65165,364.636475,408625,408800,175
101,49,(,366,246.99295,443.70265,408800,408976,176
101,0,blank,0,237.1527,393.9066,408976,409001,25
101,0,blank,0,180.6198,694.116,409601,409626,25
101,0,blank,0,274.3341,665.5134,409626,409851,225
101,0,blank,0,264.975,665.9597,409851,409876,25
101,0,blank,0,-323,-105,409901,410079,178
101,0,blank,0,-323,-105,410079,410259,180
101,0,blank,0,-323,-105,410259,410440,181
101,0,blank,0,-323,-105,410440,410633,193
101,0,blank,0,-323,-105,410633,410744,111
101,0,blank,0,-323,-105,410744,410875,131
101,0,blank,0,-323,-105,410875,411013,138
101,0,blank,0,-323,-105,411013,411165,152
101,0,blank,0,-323,-105,411165,411280,115
101,0,blank,0,-323,-105,411280,411450,170
101,0,blank,0,-323,-105,411450,411618,168
101,0,blank,0,-323,-105,411618,411737,119
101,0,blank,0,-323,-105,411737,411968,231
101,0,blank,0,-323,-105,411968,411992,24
101,0,blank,0,-323,-105,411992,412284,292
101,0,blank,0,-323,-105,412284,412511,227
101,0,blank,0,-323,-105,412511,412699,188
101,0,blank,0,-323,-105,412699,412847,148
101,0,blank,0,-323,-105,412847,413139,292
101,0,blank,0,-323,-105,413139,413338,199
101,0,blank,0,-323,-105,413338,413524,186
101,0,blank,0,-323,-105,413524,413745,221
101,0,blank,0,-323,-105,413745,413914,169
101,0,blank,0,76.1336333333333,95.4603,414083,414230,147
101,34,(,243,151.39345,101.5898,414317,414402,85
101,32,print,231,45.940975,63.05915,414578,414746,168
101,31,"OnmatrixmultiplicationofAandBtheresultis:\n",228,591.297483333333,51.3187166666667,414808,414994,186
101,0,blank,0,569.672966666667,56.6939666666667,414994,415084,90
101,31,"OnmatrixmultiplicationofAandBtheresultis:\n",228,291.72145,53.6504333333333,415114,415298,184
101,32,),238,195.17015,57.6757,415298,415421,123
101,0,blank,0,-323,-105,415451,415635,184
101,0,blank,0,-323,-105,415635,415816,181
101,0,blank,0,-323,-105,415816,415993,177
101,0,blank,0,-323,-105,415993,416133,140
101,0,blank,0,-323,-105,416405,416473,68
101,0,blank,0,-323,-105,416473,416983,510
101,0,blank,0,-323,-105,416983,417377,394
101,0,blank,0,-323,-105,417377,417518,141
101,0,blank,0,-323,-105,417518,417597,79
101,0,blank,0,1024.67766666667,351.918766666667,417660,417841,181
101,0,blank,0,1009.54275,353.477725,417841,418026,185
101,0,blank,0,1016.70625,369.68305,418026,418212,186
101,0,blank,0,1015.504,471.0929,418258,418446,188
101,0,blank,0,1046.012,421.23412,418446,418639,193
101,0,blank,0,1049.05933333333,414.337866666667,418639,418833,194
101,0,blank,0,1049.705,418.912683333333,418833,419029,196
101,0,blank,0,1047.30416666667,307.202116666667,419029,419219,190
101,0,blank,0,1046.68,301.977916666667,419219,419408,189
101,0,blank,0,1053.541,302.7083,419408,419471,63
102,0,blank,0,101.21938,42.3747,420640,420791,151
102,0,blank,0,55.88905,43.75895,420836,421007,171
102,3,main,19,79.5926,51.4734333333333,421007,421139,132
102,0,blank,0,99.4108,483.7893,421227,421276,49
102,0,blank,0,170.834825,436.7624,421321,421497,176
102,0,blank,0,235.313166666667,436.126466666667,421497,421633,136
102,27,scanf,193,141.033066666667,595.549133333333,421681,421860,179
102,0,blank,0,-323,-105,421890,422023,133
102,0,blank,0,171.084916666667,472.856716666667,422073,422244,171
102,0,blank,0,169.8747,484.1437,422244,422275,31
102,0,blank,0,129.3494,615.661866666667,422306,422489,183
102,0,blank,0,136.288433333333,614.89275,422489,422670,181
102,29,m1,210,178.648233333333,634.820633333333,422670,422849,179
102,0,blank,0,296.836783333333,616.548933333333,422878,423059,181
102,29,;,224,417.8454,630.232966666667,423059,423150,91
102,0,blank,0,-323,-105,423181,423314,133
102,0,blank,0,181.0453,600.949,423340,423366,26
102,0,blank,0,175.3044,611.5627,423425,423451,26
102,27,scanf,193,131.74985,581.474383333333,423500,423680,180
102,0,blank,0,128.5085,482.5474,423680,423712,32
102,0,blank,0,153.2851,371.16265,423739,423920,181
102,17,"EnterelementsinMatrixA:\n",116,168.875616666667,361.392466666667,423920,424100,180
102,17,"EnterelementsinMatrixA:\n",116,207.024916666667,356.537516666667,424100,424280,180
102,0,blank,0,94.7337833333333,295.48695,424280,424459,179
102,0,blank,0,87.49945,313.66545,424459,424578,119
102,7,printf,67,97.5668,143.339566666667,424609,424788,179
102,8,"%d%d",74,110.614983333333,161.8106,424788,424970,182
102,10,"%d%d",90,110.60615,204.015316666667,424970,425153,183
102,0,blank,0,89.5357,68.1613833333333,425153,425327,174
102,1,Program,4,70.8284,6.9102,425327,425385,58
102,0,blank,0,-323,-105,425550,425734,184
102,0,blank,0,-323,-105,425734,425872,138
102,0,blank,0,-323,-105,425872,426071,199
102,0,blank,0,-323,-105,426071,426108,37
102,0,blank,0,76.637,78.901,426147,426160,13
102,0,blank,0,202.3586,774.4868,426544,426569,25
102,0,blank,0,293.7569,731.0814,426569,426833,264
102,0,blank,0,307.9578,730.3398,426833,426892,59
102,0,blank,0,245.0708,-103.9879,427136,427162,26
102,31,"OnmatrixmultiplicationofAandBtheresultis:\n",228,446.7017,664.5979,427487,427513,26
102,0,blank,0,306.5467,-103.9025,427711,427736,25
102,0,blank,0,205.1417,757.9992,427810,427835,25
102,0,blank,0,239.9293,-103.9915,428189,428214,25
102,0,blank,0,209.6203,759.85665,428562,428610,48
102,0,blank,0,-323,-105,428861,429038,177
102,0,blank,0,-323,-105,429038,429194,156
102,0,blank,0,-323,-105,429194,429280,86
102,0,blank,0,-323,-105,429280,429445,165
102,0,blank,0,-323,-105,429445,429516,71
102,0,blank,0,-323,-105,429516,429655,139
102,0,blank,0,-323,-105,429655,429899,244
102,0,blank,0,-323,-105,429899,429983,84
102,0,blank,0,-323,-105,429983,430141,158
102,0,blank,0,-323,-105,430141,430254,113
102,0,blank,0,-323,-105,430254,430477,223
102,0,blank,0,-323,-105,430477,430650,173
102,0,blank,0,332.2759,118.1354,430706,430904,198
102,5,10,45,334.44505,93.374825,430904,431086,182
102,0,blank,0,-323,-105,431118,431148,30
102,0,blank,0,397.26485,471.79005,431223,431273,50
102,0,blank,0,-323,-105,431364,431540,176
102,0,blank,0,-323,-105,431540,431719,179
102,0,blank,0,-323,-105,431719,431931,212
102,0,blank,0,-323,-105,431931,432089,158
102,0,blank,0,-323,-105,432089,432287,198
102,0,blank,0,-323,-105,432287,432429,142
102,0,blank,0,-323,-105,432429,432792,363
102,0,blank,0,-323,-105,432792,432973,181
102,0,blank,0,-323,-105,432973,433155,182
102,0,blank,0,434.59158,178.37882,433184,433360,176
102,7,"EnterrowsandcolumnsforMatrixArespectively:",69,458.458,149.890033333333,433360,433468,108
102,7,"EnterrowsandcolumnsforMatrixArespectively:",69,174.390933333333,152.857666666667,433610,433709,99
102,0,blank,0,-323,-105,433740,433844,104
102,0,blank,0,163.9926,134.697766666667,434136,434322,186
102,0,blank,0,195.2399,113.537,434322,434356,34
102,13,printf,106,108.328433333333,280.561283333333,434385,434564,179
102,10,"%d%d",90,107.59336,219.29266,434564,434714,150
102,0,blank,0,238.163183333333,248.6585,434745,434926,181
102,0,blank,0,239.993975,251.8259,434926,435047,121
102,0,blank,0,420.7179,246.618333333333,435077,435260,183
102,0,blank,0,399.177816666667,253.748416666667,435260,435443,183
102,0,blank,0,379.083,254.69595,435443,435502,59
102,0,blank,0,187.0445,245.191616666667,435531,435712,181
102,0,blank,0,351.545983333333,245.83355,435712,435894,182
102,0,blank,0,390.339116666667,249.7772,435894,436074,180
102,13,"Matrixmultiplicationnotpossible.\n",108,401.386766666667,271.7919,436074,436163,89
102,0,blank,0,131.507783333333,247.4572,436223,436417,194
102,0,blank,0,110.0725,258.4793,436417,436449,32
102,10,"%d%d",90,112.03665,203.997016666667,436512,436694,182
102,10,"%d%d",90,114.205183333333,209.402866666667,436694,436874,180
102,9,"EnterrowsandcolumnsforMatrixBrespectively:",85,132.354033333333,198.934183333333,436874,437062,188
102,10,"%d%d",90,135.2358,204.3844,437062,437127,65
102,0,blank,0,84.1956,335.29975,437158,437338,180
102,0,blank,0,68.3409,306.63708,437338,437486,148
102,0,blank,0,271.081516666667,332.67575,437516,437699,183
102,0,blank,0,220.160633333333,337.862033333333,437699,437788,89
102,0,blank,0,-323,-105,437818,437873,55
102,0,blank,0,208.596571428571,346.337542857143,437924,438116,192
102,0,blank,0,384.77864,341.49246,438146,438296,150
102,0,blank,0,217.86235,415.332,438325,438503,178
102,21,"%d",148,187.769933333333,444.440216666667,438503,438681,178
102,21,"%d",148,197.61245,447.14675,438681,438742,61
102,0,blank,0,359.371666666667,332.016183333333,438772,438949,177
102,0,blank,0,303.95285,340.113883333333,438949,439128,179
102,0,blank,0,378.2953,354.487883333333,439128,439309,181
102,0,blank,0,414.21155,344.529966666667,439309,439489,180
102,0,blank,0,-323,-105,439520,439551,31
102,19,;,141,184.764916666667,401.914566666667,439651,439821,170
102,19,j,142,135.558666666667,399.5315,439821,440002,181
102,19,=,135,157.720066666667,410.072833333333,440002,440199,197
102,21,"%d",148,211.531566666667,445.94825,440199,440380,181
102,21,scanf,146,172.859216666667,457.796583333333,440380,440562,182
102,21,scanf,146,161.6596,463.942,440562,440740,178
102,0,blank,0,174.15455,468.230016666667,440740,440920,180
102,0,blank,0,192.00125,465.3461,440920,440980,60
102,0,blank,0,-323,-105,441040,441178,138
102,0,blank,0,-323,-105,441178,441368,190
102,0,blank,0,-323,-105,441368,441521,153
102,0,blank,0,-323,-105,441521,441708,187
102,0,blank,0,-323,-105,441708,441893,185
102,0,blank,0,-323,-105,441893,442083,190
102,0,blank,0,-323,-105,442083,442260,177
102,0,blank,0,-323,-105,442260,442294,34
102,0,blank,0,111.41558,456.62534,442333,442495,162
102,0,blank,0,122.383971428571,244.260157142857,442523,442715,192
102,11,!=,102,132.7151,230.9161,442715,442770,55
102,0,blank,0,57.1099571428571,335.858742857143,442799,442996,197
102,0,blank,0,57.5158,362.4748,442996,443053,57
102,0,blank,0,86.5773857142857,718.730485714286,443079,443278,199
102,31,printf,226,90.5616166666667,677.148566666667,443278,443447,169
102,0,blank,0,354.20914,724.58718,443474,443614,140
102,0,blank,0,454.910857142857,715.351542857143,443672,443869,197
102,0,blank,0,478.6369,719.1454,443869,443896,27
102,32,m1,233,122.8423,693.830633333333,443924,444095,171
102,0,blank,0,126.3125,708.0847,444095,444267,172
102,0,blank,0,133.659433333333,724.704033333333,444267,444352,85
102,0,blank,0,-323,-105,444380,444461,81
102,31,printf,226,65.6047571428571,674.578114285714,444544,444739,195
102,32,print,231,72.07025,687.001675,444739,444855,116
102,0,blank,0,241.331583333333,710.7416,444884,445057,173
102,0,blank,0,154.282733333333,711.161583333333,445057,445228,171
102,0,blank,0,139.698633333333,722.346333333333,445228,445314,86
102,0,blank,0,376.754057142857,725.6217,445371,445569,198
102,0,blank,0,480.130466666667,716.79635,445569,445742,173
102,0,blank,0,497.550514285714,725.889371428572,445742,445941,199
102,0,blank,0,518.390242857143,726.278642857143,445941,446137,196
102,0,blank,0,555.539628571428,716.622328571429,446137,446336,199
102,0,blank,0,562.407,715.3529,446336,446365,29
102,0,blank,0,-323,-105,446394,446547,153
102,0,blank,0,221.897957142857,710.017828571428,446572,446759,187
102,0,blank,0,220.26245,735.63275,446759,446817,58
102,32,(,232,95.58095,701.0953,446845,447019,174
102,0,blank,0,96.1327,660.54335,447019,447132,113
102,13,printf,106,90.7069,278.4684,447234,447334,100
102,0,blank,0,153.386933333333,745.5221,447436,447608,172
102,0,blank,0,53.8142714285714,732.757442857143,447637,447836,199
102,0,blank,0,59.3288857142857,724.458071428571,447836,448035,199
102,0,blank,0,-188.9201,736.5143,448061,448260,199
102,0,blank,0,-192.369916666667,740.932016666667,448260,448433,173
102,0,blank,0,-179.2945,740.93415,448433,448490,57
102,24,0,170,180.553083333333,525.812033333333,448519,448692,173
102,24,;,175,186.603733333333,516.743283333333,448692,448864,172
102,0,blank,0,-167.6647,726.989383333333,448921,449092,171
102,0,blank,0,-226.743766666667,710.4448,449092,449265,173
102,0,blank,0,-205.665842857143,711.654914285714,449265,449464,199
102,0,blank,0,-148.2718,703.25845,449464,449518,54
102,0,blank,0,-323,-105,449546,449624,78
102,0,blank,0,-162.2391,-103.9142,449650,449675,25
102,0,blank,0,-193.909042857143,697.511314285714,449726,449910,184
102,0,blank,0,-182.656571428571,699.210614285714,449910,450107,197
102,0,blank,0,149.901916666667,509.83645,450136,450307,171
102,0,blank,0,146.922985714286,530.241071428571,450307,450506,199
102,0,blank,0,156.1484,561.726783333333,450506,450678,172
102,0,blank,0,149.07735,616.7833,450678,450850,172
102,29,multiply,208,145.378557142857,628.270814285714,450850,451049,199
102,29,multiply,208,151.771716666667,619.9143,451049,451221,172
102,0,blank,0,139.130083333333,685.345433333333,451221,451394,173
102,32,comma,236,130.274633333333,690.507833333333,451394,451566,172
102,0,blank,0,-323,-105,451596,451700,104
102,0,blank,0,182.8596,733.7851,451725,451751,26
102,0,blank,0,132.556571428571,696.542085714286,451801,451989,188
102,0,blank,0,86.57395,706.481916666667,451989,452162,173
102,32,print,231,59.60384,693.44054,452162,452308,146
102,0,blank,0,-323,-105,452366,452546,180
102,0,blank,0,-323,-105,452546,452739,193
102,0,blank,0,-323,-105,452739,452918,179
102,0,blank,0,-323,-105,452918,453110,192
102,0,blank,0,-323,-105,453110,453304,194
102,21,"%d",148,210.68285,452.07275,453672,453741,69
102,0,blank,0,-323,-105,453811,453842,31
102,0,blank,0,137.3243,311.8549,454078,454100,22
102,0,blank,0,223.59005,-46.4758,454138,454202,64
102,0,blank,0,186.03375,1.574425,454232,454360,128
102,0,blank,0,204.472175,329.159825,454394,454517,123
102,0,blank,0,-323,-105,454547,454654,107
102,10,comma,94,166.465385714286,220.560385714286,454679,454876,197
102,32,print,231,76.4301,692.447283333333,454906,455095,189
102,28,},207,84.7935,617.3934,455095,455126,31
102,7,"EnterrowsandcolumnsforMatrixArespectively:",69,184.4804,147.366683333333,455157,455342,185
102,8,&,79,188.5598,157.0595,455342,455372,30
102,0,blank,0,-323,-105,455433,455458,25
102,0,blank,0,367.7226,552.25585,455586,455704,118
102,0,blank,0,135.029283333333,714.6615,455735,455921,186
102,0,blank,0,-323,-105,456015,456198,183
102,0,blank,0,-323,-105,456198,456389,191
102,0,blank,0,-323,-105,456389,456587,198
102,0,blank,0,-323,-105,456587,456729,142
102,0,blank,0,150.0247,349.71245,456781,456857,76
102,0,blank,0,176.512416666667,616.530083333333,456889,457078,189
102,0,blank,0,136.942716666667,691.323416666667,457078,457264,186
102,0,blank,0,140.266666666667,696.218483333333,457264,457452,188
102,0,blank,0,248.321433333333,574.911166666667,457483,457575,92
102,0,blank,0,-323,-105,457638,457668,30
102,0,blank,0,288.193333333333,645.913483333333,457770,457943,173
102,31,"OnmatrixmultiplicationofAandBtheresultis:\n",228,305.6717,674.471433333333,457943,458036,93
102,31,"OnmatrixmultiplicationofAandBtheresultis:\n",228,573.64405,665.96565,458099,458289,190
102,0,blank,0,576.009,661.9563,458289,458321,32
102,0,blank,0,146.021333333333,646.632416666667,458352,458537,185
102,32,(,232,97.82515,697.50965,458537,458722,185
102,0,blank,0,117.361266666667,712.6268,458722,458908,186
102,0,blank,0,149.4989,745.2614,458908,458938,30
102,0,blank,0,-323,-105,458998,459135,137
102,0,blank,0,152.205933333333,510.9803,459167,459339,172
102,0,blank,0,151.141866666667,514.3843,459339,459526,187
102,0,blank,0,183.617083333333,461.682683333333,459526,459711,185
102,0,blank,0,180.3973,467.666933333333,459711,459803,92
102,0,blank,0,322.247316666667,471.274966666667,459834,460017,183
102,0,blank,0,337.3273,486.7881,460017,460048,31
102,0,blank,0,134.407983333333,711.6373,460079,460261,182
102,0,blank,0,135.383683333333,707.054166666667,460261,460447,186
102,0,blank,0,147.7405,724.7966,460447,460606,159
102,0,blank,0,-323,-105,460659,460842,183
102,0,blank,0,-323,-105,460842,461021,179
102,0,blank,0,-323,-105,461021,461157,136
102,0,blank,0,-323,-105,461157,461327,170
102,0,blank,0,-323,-105,461327,461469,142
102,0,blank,0,-323,-105,461469,461751,282
102,0,blank,0,-323,-105,461751,461864,113
102,0,blank,0,-323,-105,461864,462480,616
102,0,blank,0,-323,-105,462480,462647,167
102,0,blank,0,-323,-105,462647,462720,73
102,0,blank,0,1071.861,127.075,462747,462795,48
102,0,blank,0,1027.0395,186.3435,462849,462939,90
102,0,blank,0,1017.063,175.8539,463036,463223,187
102,0,blank,0,1023.7495,164.2433,463364,463456,92
102,0,blank,0,1046.391,141.12598,463549,463729,180
102,0,blank,0,1043.42983333333,141.12035,463729,463920,191
102,0,blank,0,1040.79016666667,144.1524,463920,464111,191
102,0,blank,0,1043.50633333333,70.6214,464111,464305,194
102,0,blank,0,1050.79783333333,-8.1569,464305,464503,198
102,0,blank,0,1048.94283333333,-26.3889,464503,464699,196
102,0,blank,0,1046.6445,-17.7373,464699,464765,66
103,32,;,239,204.28755,418.15865,466360,466421,61
103,0,blank,0,172.969483333333,153.499783333333,466482,466657,175
103,0,blank,0,-323,-105,466717,466822,105
103,31,"OnmatrixmultiplicationofAandBtheresultis:\n",228,176.5894,396.3185,466848,466881,33
103,31,"OnmatrixmultiplicationofAandBtheresultis:\n",228,180.138316666667,402.122633333333,466942,467117,175
103,31,"OnmatrixmultiplicationofAandBtheresultis:\n",228,187.73155,405.2057,467117,467177,60
103,0,blank,0,314.970333333333,503.878033333333,467207,467392,185
103,36,=,295,321.1924,508.9086,467392,467422,30
103,31,"OnmatrixmultiplicationofAandBtheresultis:\n",228,210.48185,408.5236,467477,467658,181
103,0,blank,0,-323,-105,467771,467936,165
103,31,"OnmatrixmultiplicationofAandBtheresultis:\n",228,139.91508,407.85706,467966,468101,135
103,31,"OnmatrixmultiplicationofAandBtheresultis:\n",228,319.086166666667,398.43585,468131,468309,178
103,31,"OnmatrixmultiplicationofAandBtheresultis:\n",228,177.68915,402.826783333333,468309,468491,182
103,0,blank,0,121.2447,391.923316666667,468491,468673,182
103,29,multiply,208,108.181,360.7442,468673,468703,30
103,0,blank,0,144.03395,223.715866666667,468734,468914,180
103,23,printf,161,138.8562,232.2968,468914,468945,31
103,18,=,122,153.1434,120.040225,468975,469096,121
103,0,blank,0,167.029066666667,387.660083333333,469127,469306,179
103,31,"OnmatrixmultiplicationofAandBtheresultis:\n",228,181.850016666667,405.11045,469306,469487,181
103,31,"OnmatrixmultiplicationofAandBtheresultis:\n",228,203.29255,410.665066666667,469487,469670,183
103,31,"OnmatrixmultiplicationofAandBtheresultis:\n",228,188.329275,394.5413,469670,469788,118
103,0,blank,0,215.346316666667,68.9863166666667,469818,470002,184
103,0,blank,0,216.1924,66.4551,470002,470094,92
103,0,blank,0,209.790633333333,303.587633333333,470123,470305,182
103,31,"OnmatrixmultiplicationofAandBtheresultis:\n",228,188.812666666667,394.68945,470337,470518,181
103,0,blank,0,186.801016666667,383.481816666667,470518,470701,183
103,0,blank,0,217.71505,338.818116666667,470701,470882,181
103,0,blank,0,240.739066666667,333.458333333333,470882,471063,181
103,0,blank,0,240.3102,331.1927,471063,471094,31
103,0,blank,0,369.4113,344.37338,471124,471275,151
103,0,blank,0,180.21815,347.600983333333,471305,471485,180
103,27,scanf,193,156.547183333333,319.6528,471485,471664,179
103,0,blank,0,150.64365,298.00145,471664,471724,60
103,0,blank,0,984.647,155.501633333333,471784,471964,180
103,0,blank,0,985.777833333333,155.53105,471964,472140,176
103,0,blank,0,974.745,162.7518,472140,472201,61
103,0,blank,0,589.5774,213.4347,472232,472383,151
103,0,blank,0,1053.21916666667,169.11665,472413,472597,184
103,0,blank,0,1053.927,169.179333333333,472597,472780,183
103,0,blank,0,1045.8115,228.70515,472780,472963,183
103,0,blank,0,1045.841,249.2376,472963,473146,183
103,0,blank,0,1049.88,261.92295,473146,473271,125
103,0,blank,0,238.78665,289.160566666667,473366,473554,188
103,0,blank,0,115.862166666667,309.584366666667,473554,473742,188
103,0,blank,0,160.745166666667,344.524516666667,473742,473930,188
103,29,m1,210,185.97818,369.13612,473930,474082,152
104,0,blank,0,375.5059,580.025,475022,475053,31
104,0,blank,0,140.003466666667,642.508666666667,475083,475264,181
104,29,multiply,208,125.8847,621.8693,475264,475294,30
104,2,<,13,93.5134333333333,21.3376666666667,475352,475536,184
104,2,<,13,93.36325,29.0641,475536,475720,184
104,2,include,12,79.1032,31.49015,475720,475781,61
104,0,blank,0,-323,-105,475842,475950,108
104,0,blank,0,-323,-105,475950,476052,102
104,29,comma,221,379.64632,615.74426,476146,476324,178
104,29,),223,407.88,627.347716666667,476324,476506,182
104,29,;,224,418.60655,626.2276,476506,476689,183
104,29,;,224,415.032333333333,627.37805,476689,476871,182
104,0,blank,0,413.779566666667,620.32805,476871,477055,184
104,0,blank,0,199.741175,253.0899,477115,477239,124
104,29,n2,218,328.008333333333,612.041933333333,477271,477453,182
104,0,blank,0,323.659133333333,609.4771,477453,477545,92
104,0,blank,0,-323,-105,477575,477685,110
104,8,"%d%d",74,145.7691,160.5844,477715,477754,39
104,6,n1,55,123.1897,122.8884,477850,477906,56
104,0,blank,0,87.9342666666666,7.82523333333333,477934,478124,190
104,2,<,13,95.37745,21.0997,478124,478187,63
104,0,blank,0,392.696983333333,31.7666666666667,478219,478408,189
104,0,blank,0,369.5722,45.37065,478408,478594,186
104,0,blank,0,313.120833333333,44.9437,478594,478688,94
104,0,blank,0,67.5889666666667,-4.37266666666667,478718,478904,186
104,0,blank,0,119.1382,35.33555,478904,479090,186
104,0,blank,0,122.255166666667,38.6777833333333,479090,479276,186
104,0,blank,0,117.8972,40.45315,479276,479461,185
104,0,blank,0,122.92815,44.06655,479461,479644,183
104,0,blank,0,144.592766666667,37.7504166666667,479644,479827,183
104,0,blank,0,171.594,49.4142,479827,479857,30
104,0,blank,0,426.830333333333,42.26815,479888,480072,184
104,0,blank,0,434.0598,45.8897166666667,480072,480256,184
104,0,blank,0,458.190975,64.1294,480256,480378,122
104,0,blank,0,-323,-105,480408,480438,30
104,7,"EnterrowsandcolumnsforMatrixArespectively:",69,344.4097,138.6327,480464,480489,25
104,0,blank,0,355.5707,38.79724,480540,480681,141
104,24,++,177,304.31135,519.6262,480711,480897,186
104,29,comma,221,380.39765,612.153533333333,480897,481083,186
104,29,),223,410.733633333333,620.695016666667,481083,481266,183
104,29,),223,408.969433333333,630.733066666667,481266,481447,181
104,29,),223,405.6923,626.5682,481447,481478,31
104,0,blank,0,-323,-105,481508,481590,82
104,0,blank,0,-323,-105,481678,481735,57
104,0,blank,0,988.334,162.8817,481964,482151,187
104,0,blank,0,1065.095,172.0061,482265,482322,57
104,0,blank,0,1034.905,174.614933333333,482454,482608,154
104,0,blank,0,1046.3156,148.37284,482699,482876,177
104,0,blank,0,1045.28383333333,143.867083333333,482876,483063,187
104,0,blank,0,1053.66233333333,140.51035,483063,483251,188
104,0,blank,0,1049.30266666667,142.346333333333,483251,483346,95
104,0,blank,0,430.828133333333,507.779266666667,483439,483630,191
104,31,"OnmatrixmultiplicationofAandBtheresultis:\n",228,222.473283333333,659.472416666667,483662,483853,191
104,0,blank,0,230.4032,652.102775,483853,483977,124
105,34,int,274,168.147233333333,30.4160666666667,485940,486122,182
105,0,blank,0,173.51785,35.58285,486122,486182,60
105,49,n1,369,312.69085,357.152016666667,486212,486396,184
105,0,blank,0,315.9922,364.239675,486396,486515,119
105,0,blank,0,440.562533333333,390.773266666667,486546,486731,185
105,0,blank,0,445.7393,396.3668,486731,486762,31
105,0,blank,0,-323,-105,486793,486913,120
105,0,blank,0,1007.0176,407.22644,486952,487104,152
105,0,blank,0,222.964283333333,252.0834,487166,487348,182
105,0,blank,0,238.31705,275.104366666667,487348,487534,186
105,0,blank,0,-323,-105,487596,487712,116
105,0,blank,0,269.302025,284.14745,487737,487876,139
105,0,blank,0,442.7596,273.8214,487993,488097,104
105,0,blank,0,227.158616666667,276.230166666667,488193,488381,188
105,0,blank,0,234.1863,284.682,488381,488411,30
105,0,blank,0,423.989833333333,328.889566666667,488442,488627,185
105,0,blank,0,-323,-105,488657,488741,84
105,0,blank,0,422.831,277.7093,488767,488793,26
105,47,k,356,425.270066666667,300.475133333333,488849,489026,177
105,47,],360,436.2286,312.5137,489026,489056,30
105,0,blank,0,312.16324,270.0984,489086,489240,154
105,0,blank,0,431.23905,278.7174,489271,489453,182
105,0,blank,0,432.68275,282.58625,489453,489574,121
105,0,blank,0,-323,-105,489604,489749,145
105,47,[,358,519.331283333333,302.688616666667,489775,489952,177
105,0,blank,0,526.353966666667,327.22395,489952,490136,184
105,0,blank,0,539.63125,337.57325,490136,490197,61
105,0,blank,0,-323,-105,490227,490412,185
105,0,blank,0,-323,-105,490412,490588,176
105,0,blank,0,-323,-105,490588,490756,168
105,0,blank,0,-323,-105,490756,490933,177
105,0,blank,0,-323,-105,490933,491116,183
105,0,blank,0,-323,-105,491116,491269,153
105,0,blank,0,-323,-105,491269,491404,135
105,0,blank,0,-323,-105,491404,491495,91
105,0,blank,0,-323,-105,491495,491707,212
105,0,blank,0,-323,-105,491707,491881,174
105,0,blank,0,-323,-105,491881,492065,184
105,0,blank,0,-323,-105,492065,492251,186
105,0,blank,0,-323,-105,492251,492295,44
105,0,blank,0,-323,-105,492295,492572,277
105,0,blank,0,-323,-105,492572,492853,281
105,0,blank,0,-323,-105,492853,493120,267
105,0,blank,0,-323,-105,493120,493295,175
105,0,blank,0,-323,-105,493295,493408,113
105,0,blank,0,-323,-105,493408,493495,87
105,0,blank,0,-323,-105,493495,493701,206
105,0,blank,0,-323,-105,493701,493870,169
105,0,blank,0,-323,-105,493870,494057,187
105,0,blank,0,-323,-105,494057,494190,133
105,0,blank,0,-323,-105,494190,494314,124
105,0,blank,0,-323,-105,494314,494458,144
105,0,blank,0,-323,-105,494458,494533,75
105,0,blank,0,-323,-105,494533,494719,186
105,0,blank,0,-323,-105,494719,494897,178
105,0,blank,0,-323,-105,494897,495046,149
105,0,blank,0,-323,-105,495046,495436,390
105,0,blank,0,-323,-105,495436,495818,382
105,0,blank,0,-323,-105,495818,496008,190
105,0,blank,0,-323,-105,496008,496058,50
105,0,blank,0,-323,-105,496058,496913,855
105,0,blank,0,-323,-105,496913,497093,180
105,0,blank,0,-323,-105,497093,497130,37
105,0,blank,0,524.6149,275.0979,497266,497309,43
105,0,blank,0,408.96035,271.050125,497390,497562,172
105,0,blank,0,462.27045,262.16495,497562,497646,84
105,0,blank,0,526.10782,275.8384,497688,497868,180
105,0,blank,0,501.76745,279.0016,497868,498052,184
105,0,blank,0,492.16512,281.9775,498052,498207,155
105,0,blank,0,337.964833333333,274.97685,498237,498423,186
105,0,blank,0,329.42645,273.322633333333,498423,498613,190
105,0,blank,0,317.17475,268.7143,498613,498677,64
105,0,blank,0,-323,-105,498709,498826,117
105,0,blank,0,272.871183333333,273.0764,498869,499044,175
105,0,blank,0,231.989433333333,282.8688,499044,499230,186
105,47,=,337,261.279816666667,306.80705,499230,499408,178
105,0,blank,0,266.14765,311.6924,499408,499469,61
105,0,blank,0,-323,-105,499498,499684,186
105,0,blank,0,-323,-105,499684,499743,59
105,47,[,358,318.3796,308.968175,499767,499929,162
105,0,blank,0,335.4651,323.1238,499929,500128,199
105,0,blank,0,251.576275,298.902075,500128,500315,187
105,47,=,337,256.395542857143,302.635014285714,500315,500495,180
105,0,blank,0,246.130514285714,299.4191,500495,500691,196
105,0,blank,0,264.9726,308.65785,500746,500796,50
105,47,+,345,364.8225,305.94965,500823,501014,191
105,0,blank,0,350.1093,276.9413,501014,501071,57
105,47,=,337,259.244633333333,302.831416666667,501097,501284,187
105,0,blank,0,263.531342857143,287.116242857143,501284,501475,191
105,0,blank,0,269.459985714286,305.014085714286,501475,501673,198
105,47,[,358,317.882666666667,301.438433333333,501673,501866,193
105,0,blank,0,365.412628571429,301.016942857143,501866,502064,198
105,0,blank,0,252.14428,332.20262,502093,502233,140
105,0,blank,0,-323,-105,502262,502315,53
105,0,blank,0,238.582257142857,307.859757142857,502425,502614,189
105,0,blank,0,246.098966666667,329.58795,502614,502785,171
105,0,blank,0,247.9049,324.3389,502785,502814,29
105,0,blank,0,-323,-105,502873,503039,166
105,0,blank,0,-323,-105,503039,503167,128
105,0,blank,0,-323,-105,503167,503354,187
105,0,blank,0,-323,-105,503354,503496,142
105,0,blank,0,-323,-105,503496,503657,161
105,0,blank,0,-323,-105,503657,503824,167
105,0,blank,0,-323,-105,503824,503963,139
105,0,blank,0,-323,-105,503963,504173,210
105,0,blank,0,-323,-105,504173,504368,195
105,0,blank,0,-323,-105,504368,504548,180
105,0,blank,0,-323,-105,504548,504760,212
105,0,blank,0,-323,-105,504760,504944,184
105,0,blank,0,-323,-105,504944,505126,182
105,0,blank,0,-323,-105,505126,505208,82
105,0,blank,0,-323,-105,505208,505407,199
105,0,blank,0,-323,-105,505407,505612,205
105,0,blank,0,-323,-105,505612,505934,322
105,0,blank,0,-323,-105,505934,506126,192
105,0,blank,0,-323,-105,506126,506267,141
105,0,blank,0,-323,-105,506267,506409,142
105,0,blank,0,-323,-105,506409,506488,79
105,0,blank,0,-323,-105,506488,506767,279
105,0,blank,0,-323,-105,506767,506944,177
105,0,blank,0,-323,-105,506944,507139,195
105,0,blank,0,-323,-105,507139,507251,112
105,0,blank,0,-323,-105,507251,507423,172
105,0,blank,0,-323,-105,507423,507469,46
105,0,blank,0,-323,-105,507469,507730,261
105,0,blank,0,-323,-105,507730,507893,163
105,0,blank,0,-323,-105,507893,508112,219
105,0,blank,0,-323,-105,508112,508141,29
105,0,blank,0,-323,-105,508141,508809,668
105,0,blank,0,-323,-105,508809,509195,386
105,0,blank,0,-323,-105,509195,509339,144
105,0,blank,0,-323,-105,509339,509430,91
105,0,blank,0,229.8408,364.0769,509510,509659,149
105,0,blank,0,-323,-105,510137,510240,103
105,0,blank,0,285.9046,325.6574,510867,511054,187
105,47,c,338,283.3054,307.9239,511054,511098,44
105,0,blank,0,-323,-105,511158,511238,80
105,0,blank,0,350.7078,305.7892,511264,511313,49
105,0,blank,0,324.285283333333,299.704866666667,511379,511552,173
105,0,blank,0,210.12915,299.385083333333,511552,511732,180
105,47,c,338,279.504733333333,303.298166666667,511732,511911,179
105,0,blank,0,181.306316666667,188.5824,511911,512091,180
105,0,blank,0,366.45025,318.7303,512122,512302,180
105,47,+,345,363.06738,318.50824,512302,512454,152
105,41,m1,313,192.071066666667,186.907533333333,512484,512668,184
105,0,blank,0,152.121266666667,153.559533333333,512668,512851,183
105,39,return,305,138.339925,131.4277,512851,512972,121
105,0,blank,0,367.456783333333,310.469633333333,513002,513184,182
105,0,blank,0,-323,-105,513215,513269,54
105,0,blank,0,309.7997,396.3638,513294,513320,26
105,47,c,338,273.089583333333,305.530683333333,513370,513540,170
105,47,],360,194.26302,316.92562,513540,513692,152
105,37,>=,301,112.16165,80.0444,513722,513901,179
105,0,blank,0,138.998833333333,41.5377166666667,513901,514084,183
105,34,int,274,165.186583333333,26.4848666666667,514084,514262,178
105,0,blank,0,174.842616666667,49.8768333333333,514262,514441,179
105,0,blank,0,151.612433333333,65.80065,514441,514614,173
105,0,blank,0,166.757366666667,63.5380333333333,514614,514787,173
105,0,blank,0,172.86775,67.9079,514787,514963,176
105,37,m1,302,144.361083333333,89.7518666666667,514963,515138,175
105,0,blank,0,131.272783333333,106.988883333333,515138,515313,175
105,37,m1,302,135.141,99.7417,515313,515427,114
105,0,blank,0,-323,-105,515458,515513,55
105,0,blank,0,178.2284,121.6239,515539,515565,26
105,34,m1,245,195.6678,13.35905,515616,515666,50
105,0,blank,0,119.848016666667,154.96,515692,515869,177
105,0,blank,0,160.129066666667,131.210216666667,515869,516052,183
105,0,blank,0,190.667066666667,135.280016666667,516052,516238,186
105,39,;,306,146.334366666667,131.609416666667,516238,516423,185
105,0,blank,0,126.295833333333,147.8686,516423,516603,180
105,0,blank,0,145.853583333333,172.5579,516603,516785,182
105,0,blank,0,138.342283333333,193.8653,516785,516967,182
105,41,i,311,143.09105,174.820516666667,516967,517151,184
105,34,multiply,242,123.667033333333,17.6143666666667,517151,517337,186
105,0,blank,0,143.99805,16.4711166666667,517337,517526,189
105,0,blank,0,198.2651,-4.78095,517526,517714,188
105,0,blank,0,202.7712,-0.591849999999997,517714,517837,123
105,0,blank,0,-323,-105,517869,517987,118
105,0,blank,0,166.463366666667,49.9837333333333,518013,518093,80
105,49,n1,369,303.582766666667,344.075133333333,518126,518311,185
105,0,blank,0,277.34615,320.855366666667,518311,518498,187
105,0,blank,0,234.072416666667,312.423066666667,518498,518682,184
105,0,blank,0,224.1796,278.0654,518682,518711,29
105,47,+,345,354.509033333333,313.2376,518742,518925,183
105,47,j,359,331.32222,314.63646,518925,519073,148
105,0,blank,0,-323,-105,519104,519160,56
105,0,blank,0,381.693,392.8973,519185,519211,26
105,0,blank,0,368.927942857143,306.067714285714,519264,519461,197
105,0,blank,0,371.38605,314.282083333333,519461,519642,181
105,47,j,359,325.4613,312.70425,519642,519824,182
105,0,blank,0,312.26055,314.483633333333,519824,520003,179
105,47,],360,335.399116666667,319.09355,520003,520182,179
105,0,blank,0,399.135533333333,322.147516666667,520182,520364,182
105,0,blank,0,420.176533333333,322.37175,520364,520543,179
105,0,blank,0,429.248416666667,325.597783333333,520543,520725,182
105,0,blank,0,418.2779,322.1999,520725,520786,61
105,0,blank,0,-323,-105,520816,520873,57
105,0,blank,0,354.7817,478.4261,520898,520924,26
105,47,k,356,429.4539,310.784,520975,521146,171
105,0,blank,0,464.570866666667,324.77125,521146,521333,187
105,0,blank,0,472.143933333333,332.203533333333,521333,521517,184
105,0,blank,0,473.2345,334.39145,521517,521579,62
105,0,blank,0,-323,-105,521609,521665,56
105,47,i,348,294.55925,317.219625,521770,521883,113
105,47,[,358,415.285266666667,314.119,521913,522095,182
105,47,[,358,387.677066666667,315.51,522095,522278,183
105,0,blank,0,372.62824,320.994,522278,522429,151
105,0,blank,0,256.2078,329.17925,522460,522644,184
105,47,],360,231.846975,317.6533,522644,522822,178
105,45,n1,327,208.679616666667,266.146666666667,522822,523004,182
105,45,n1,327,211.017783333333,270.481016666667,523004,523186,182
105,0,blank,0,393.72765,281.730233333333,523217,523401,184
105,0,blank,0,482.258883333333,280.439683333333,523401,523584,183
105,0,blank,0,497.728666666667,280.1966,523584,523676,92
105,0,blank,0,185.149,289.566066666667,523707,523890,183
105,0,blank,0,196.2821,283.038566666667,523890,524071,181
105,0,blank,0,211.050633333333,293.789133333333,524071,524251,180
105,47,[,358,206.8522,305.189,524251,524341,90
105,53,multiply,390,155.135316666667,441.932383333333,524371,524551,180
105,0,blank,0,151.8863,492.5353,524551,524580,29
105,47,],360,200.1141,314.336516666667,524613,524794,181
105,0,blank,0,204.488616666667,310.913883333333,524794,524977,183
105,0,blank,0,210.977066666667,299.888366666667,524977,525067,90
105,0,blank,0,-323,-105,525097,525127,30
105,0,blank,0,-323,-105,525203,525330,127
105,0,blank,0,183.500733333333,376.239866666667,525434,525610,176
105,0,blank,0,202.686366666667,332.217533333333,525610,525796,186
105,47,],360,224.110666666667,300.8592,525796,525978,182
105,47,j,359,190.50788,306.2017,525978,526128,150
105,0,blank,0,413.43045,317.576216666667,526158,526340,182
105,0,blank,0,371.0698,305.6915,526340,526370,30
105,0,blank,0,160.644,128.327033333333,526401,526583,182
105,0,blank,0,165.312183333333,160.494716666667,526583,526767,184
105,0,blank,0,186.104633333333,193.864683333333,526767,526950,183
105,0,blank,0,202.2839,213.36275,526950,527133,183
105,0,blank,0,230.65775,226.642616666667,527133,527316,183
105,0,blank,0,225.099733333333,219.208733333333,527316,527499,183
105,0,blank,0,237.051966666667,224.4217,527499,527590,91
105,0,blank,0,445.9914,310.806216666667,527621,527804,183
105,47,[,358,417.413883333333,319.311116666667,527804,527987,183
105,47,j,359,332.8297,310.8839,527987,528017,30
105,0,blank,0,187.59495,287.99065,528048,528230,182
105,0,blank,0,198.15445,291.538983333333,528230,528413,183
105,0,blank,0,211.046,291.0111,528413,528473,60
105,0,blank,0,-323,-105,528504,528563,59
105,0,blank,0,-323,-105,528563,528750,187
105,0,blank,0,202.114133333333,215.120266666667,528858,528988,130
105,0,blank,0,382.559833333333,272.753516666667,529019,529204,185
105,0,blank,0,283.09294,268.28804,529235,529390,155
105,0,blank,0,181.35825,201.189416666667,529422,529609,187
105,0,blank,0,184.2404,207.01294,529609,529769,160
105,0,blank,0,-323,-105,529832,529975,143
105,0,blank,0,373.07895,293.260033333333,530007,530181,174
105,47,[,358,417.699833333333,307.270783333333,530181,530363,182
105,47,*,353,459.75194,316.98512,530363,530559,196
105,0,blank,0,451.796525,321.922325,530559,530676,117
105,0,blank,0,167.528916666667,185.769766666667,530705,530898,193
105,0,blank,0,146.0784,162.6039,530898,530926,28
105,49,(,366,251.3439,363.9514,530955,531150,195
105,0,blank,0,234.43368,338.39216,531150,531338,188
105,0,blank,0,220.99936,321.10232,531338,531485,147
105,0,blank,0,-323,-105,531511,531658,147
105,0,blank,0,302.710671428571,323.625957142857,531684,531876,192
105,49,comma,378,460.553066666667,346.6518,531904,532077,173
105,49,comma,378,459.466925,358.8142,532077,532191,114
105,47,k,356,426.873216666667,312.73435,532220,532394,174
105,47,[,358,421.901925,312.132775,532394,532508,114
105,0,blank,0,-323,-105,532537,532618,81
105,0,blank,0,348.0306,424.1111,532643,532669,26
105,0,blank,0,404.372228571429,272.224585714286,532718,532907,189
105,0,blank,0,445.757966666667,298.740183333333,532907,533081,174
105,47,],360,439.309266666667,310.0148,533081,533252,171
105,47,],360,436.36495,304.0807,533252,533423,171
105,0,blank,0,440.042742857143,296.893342857143,533423,533621,198
105,0,blank,0,247.972985714286,321.6587,533650,533849,199
105,47,[,358,205.636733333333,306.981383333333,533849,534021,172
105,47,],360,229.40735,318.45525,534021,534079,58
105,0,blank,0,194.473733333333,234.80865,534108,534280,172
105,0,blank,0,202.119733333333,247.582716666667,534280,534452,172
105,0,blank,0,247.6872,238.7015,534452,534624,172
105,0,blank,0,221.9771,232.787233333333,534624,534795,171
105,0,blank,0,229.2671,239.0047,534795,534969,174
105,0,blank,0,225.236,229.7493,534969,535140,171
105,0,blank,0,223.490328571429,229.284871428571,535140,535339,199
105,41,m1,313,179.898757142857,182.4467,535339,535538,199
105,41,),314,200.3758,186.0499,535538,535596,58
105,0,blank,0,-323,-105,535624,535704,80
105,0,blank,0,231.13,233.3551,535729,535755,26
105,0,blank,0,242.4222,214.469675,535805,535905,100
105,0,blank,0,455.44395,283.513533333333,535934,536107,173
105,0,blank,0,422.66264,297.41324,536107,536249,142
105,0,blank,0,198.271014285714,188.940428571429,536278,536477,199
105,41,),314,195.014628571429,175.258442857143,536477,536676,199
105,0,blank,0,183.248671428571,161.715642857143,536676,536873,197
105,0,blank,0,174.58175,141.4629,536873,536929,56
105,0,blank,0,-323,-105,536958,537063,105
105,0,blank,0,138.7013,157.7391,537101,537150,49
105,0,blank,0,176.818371428571,154.975942857143,537212,537409,197
105,0,blank,0,184.774716666667,141.197733333333,537409,537591,182
105,0,blank,0,185.20175,138.823833333333,537591,537775,184
105,41,m1,313,183.567616666667,173.8452,537775,537961,186
105,41,m1,313,182.818433333333,179.904416666667,537961,538151,190
105,0,blank,0,175.77255,157.8446,538151,538213,62
105,0,blank,0,-323,-105,538276,538305,29
105,0,blank,0,211.791966666667,170.110633333333,538406,538578,172
105,0,blank,0,208.426766666667,173.178833333333,538578,538765,187
105,0,blank,0,173.463366666667,144.180833333333,538765,538953,188
105,0,blank,0,158.5692,130.4243,538953,538984,31
105,0,blank,0,-323,-105,539016,539209,193
105,0,blank,0,-323,-105,539209,539390,181
105,0,blank,0,-323,-105,539390,539541,151
105,0,blank,0,-323,-105,539541,539712,171
105,0,blank,0,-323,-105,539712,539894,182
105,0,blank,0,-323,-105,539894,540093,199
105,0,blank,0,-323,-105,540093,540280,187
105,0,blank,0,-323,-105,540280,540451,171
105,0,blank,0,-323,-105,540451,540559,108
105,0,blank,0,-323,-105,540559,540785,226
105,0,blank,0,-323,-105,540785,540916,131
105,0,blank,0,-323,-105,540916,541335,419
105,0,blank,0,-323,-105,541335,541463,128
105,0,blank,0,-323,-105,541463,541864,401
105,0,blank,0,-323,-105,541864,541985,121
105,0,blank,0,-323,-105,541985,542300,315
105,0,blank,0,-323,-105,542300,542481,181
105,0,blank,0,-323,-105,542481,542653,172
105,0,blank,0,-323,-105,542653,542938,285
105,0,blank,0,-323,-105,542938,544502,1564
105,0,blank,0,-323,-105,544502,544585,83
105,0,blank,0,-323,-105,544585,544782,197
105,0,blank,0,-323,-105,544782,544873,91
105,0,blank,0,-323,-105,544873,545005,132
105,0,blank,0,-323,-105,545005,545191,186
105,0,blank,0,-323,-105,545191,545361,170
105,0,blank,0,-323,-105,545361,545551,190
105,0,blank,0,-323,-105,545551,545731,180
105,0,blank,0,-323,-105,545731,545928,197
105,0,blank,0,-323,-105,545928,545968,40
105,0,blank,0,-323,-105,545968,546174,206
105,0,blank,0,-323,-105,546174,546283,109
105,0,blank,0,93.4954,52.1587333333333,546348,546456,108
105,0,blank,0,-323,-105,546493,546661,168
105,0,blank,0,-323,-105,546661,546697,36
105,0,blank,0,252.235566666667,377.795033333333,546807,546921,114
105,48,k,362,171.515,334.325025,546981,547092,111
105,0,blank,0,246.6777,311.2141,547092,547360,268
105,0,blank,0,463.546425,322.56695,547399,547504,105
105,0,blank,0,-323,-105,547532,547585,53
105,0,blank,0,381.0382,427.7601,547610,547636,26
105,0,blank,0,-323,-105,547661,547760,99
105,0,blank,0,376.9232,430.7617,547786,547811,25
105,0,blank,0,428.582,339.6767,547861,547886,25
105,47,[,358,415.12045,308.047816666667,547936,548103,167
105,0,blank,0,194.441171428571,222.440657142857,548131,548330,199
105,0,blank,0,156.447757142857,199.7603,548330,548527,197
105,0,blank,0,153.848742857143,203.767428571429,548527,548725,198
105,0,blank,0,148.8982,206.9133,548725,548753,28
105,0,blank,0,394.63805,346.680016666667,548809,549003,194
105,47,i,348,396.4035,315.25835,549003,549165,162
105,49,m2,373,375.68354,345.63522,549335,549486,151
105,49,(,366,247.410533333333,349.868766666667,549515,549687,172
105,0,blank,0,241.9867,364.1309,549687,549859,172
105,49,multiply,365,243.831533333333,348.105466666667,549859,549946,87
105,0,blank,0,-323,-105,549974,550081,107
105,49,comma,378,346.2473,352.4727,550107,550139,32
105,49,comma,378,348.047557142857,350.875071428572,550199,550390,191
105,0,blank,0,234.1328,331.100814285714,550390,550587,197
105,49,multiply,365,168.450228571429,346.988242857143,550587,550786,199
105,49,multiply,365,167.647071428571,345.924328571429,550786,550985,199
105,0,blank,0,140.5347,376.596528571429,550985,551181,196
105,51,k,383,133.673628571429,398.704371428571,551181,551380,199
105,52,j,387,124.468328571429,425.467457142857,551380,551579,199
105,0,blank,0,132.631533333333,413.3447,551579,551751,172
105,0,blank,0,164.909228571429,384.305385714286,551751,551950,199
105,0,blank,0,180.922771428571,365.767471428571,551950,552149,199
105,0,blank,0,134.587983333333,413.7038,552149,552323,174
105,0,blank,0,138.7574,413.67105,552323,552381,58
105,56,++,413,101.646285714286,514.203514285714,552409,552606,197
105,0,blank,0,-323,-105,552636,552814,178
105,0,blank,0,-323,-105,552814,552991,177
105,0,blank,0,-323,-105,552991,553190,199
105,0,blank,0,-323,-105,553190,553378,188
105,0,blank,0,-323,-105,553378,553454,76
105,0,blank,0,-323,-105,553454,553622,168
105,0,blank,0,-323,-105,553622,553810,188
105,0,blank,0,-323,-105,553810,553975,165
105,0,blank,0,-323,-105,553975,554158,183
105,0,blank,0,-323,-105,554158,554194,36
105,56,++,413,103.4116,509.84145,554229,554406,177
105,56,++,413,102.087383333333,504.122383333333,554406,554577,171
105,0,blank,0,108.000216666667,499.676566666667,554577,554750,173
105,0,blank,0,100.80015,498.98235,554750,554923,173
105,56,++,413,98.0853333333333,504.834433333333,554923,555100,177
105,0,blank,0,-323,-105,555158,555302,144
105,55,0,410,131.462228571429,487.906557142857,555332,555527,195
105,0,blank,0,92.4566166666667,496.859316666667,555527,555703,176
105,56,i,412,87.8516666666667,510.1335,555703,555877,174
105,0,blank,0,-323,-105,555964,556152,188
105,0,blank,0,-323,-105,556152,556313,161
105,0,blank,0,-323,-105,556313,556376,63
105,0,blank,0,-323,-105,556376,556518,142
105,0,blank,0,-323,-105,556518,556693,175
105,0,blank,0,-323,-105,556693,556832,139
105,0,blank,0,-323,-105,556832,557034,202
105,0,blank,0,-323,-105,557034,557119,85
105,0,blank,0,-323,-105,557119,557296,177
105,0,blank,0,-323,-105,557296,557463,167
105,0,blank,0,-323,-105,557463,557645,182
105,0,blank,0,-323,-105,557645,557831,186
105,0,blank,0,-323,-105,557831,558016,185
105,0,blank,0,-323,-105,558016,558082,66
105,0,blank,0,-323,-105,558082,558400,318
105,0,blank,0,-323,-105,558400,558599,199
105,0,blank,0,-323,-105,558599,558749,150
105,0,blank,0,355.8118,452.046,558786,558816,30
105,53,n1,394,271.7612,439.49744,558899,559062,163
105,53,m1,392,218.695433333333,432.3203,559062,559166,104
105,0,blank,0,306.6673,424.9492,559166,559436,270
105,53,m2,398,333.446333333333,443.6919,559436,559616,180
105,0,blank,0,312.409866666667,429.438633333333,559616,559788,172
105,53,m2,398,335.32415,439.2436,559788,559901,113
105,0,blank,0,-323,-105,559931,559986,55
105,0,blank,0,473.1553,613.563,560012,560037,25
105,0,blank,0,497.89785,434.6269,560086,560249,163
105,53,(,391,212.796766666667,451.497483333333,560279,560455,176
105,0,blank,0,192.4162,453.5057,560455,560485,30
105,34,int,274,182.267833333333,14.9455166666667,560542,560737,195
105,0,blank,0,188.8525,18.0906,560737,560766,29
105,0,blank,0,212.443816666667,519.954383333333,560823,560995,172
105,57,n1,419,221.940875,535.3303,560995,561110,115
105,0,blank,0,177.59884,459.0792,561206,561370,164
105,0,blank,0,-323,-105,561401,561584,183
105,0,blank,0,-323,-105,561584,561762,178
105,0,blank,0,-323,-105,561762,561948,186
105,0,blank,0,-323,-105,561948,562139,191
105,0,blank,0,-323,-105,562139,562185,46
105,0,blank,0,-323,-105,562185,562436,251
105,0,blank,0,-323,-105,562436,562723,287
105,0,blank,0,-323,-105,562723,563281,558
105,0,blank,0,-323,-105,563281,563454,173
105,0,blank,0,-323,-105,563454,563522,68
105,0,blank,0,-323,-105,563522,563730,208
105,0,blank,0,-323,-105,563730,564149,419
105,0,blank,0,-323,-105,564149,564569,420
105,0,blank,0,-323,-105,564569,564758,189
105,0,blank,0,-323,-105,564758,565002,244
105,0,blank,0,-323,-105,565002,565034,32
105,0,blank,0,-323,-105,565034,565382,348
105,0,blank,0,-323,-105,565382,565729,347
105,0,blank,0,-323,-105,565729,565908,179
105,0,blank,0,-323,-105,565908,566089,181
105,0,blank,0,-323,-105,566089,566356,267
105,0,blank,0,-323,-105,566356,566551,195
105,0,blank,0,-323,-105,566551,566745,194
105,0,blank,0,-323,-105,566745,566919,174
105,0,blank,0,-323,-105,566919,567066,147
105,0,blank,0,-323,-105,567066,567188,122
105,0,blank,0,-323,-105,567188,567557,369
105,0,blank,0,-323,-105,567557,567737,180
105,0,blank,0,-323,-105,567737,567882,145
105,0,blank,0,-323,-105,567882,568077,195
105,0,blank,0,-323,-105,568077,568114,37
105,0,blank,0,-323,-105,568114,568293,179
105,0,blank,0,-323,-105,568293,568486,193
105,0,blank,0,-323,-105,568486,568661,175
105,0,blank,0,-323,-105,568661,568849,188
105,0,blank,0,-323,-105,568849,569007,158
105,0,blank,0,-323,-105,569007,569189,182
105,0,blank,0,-323,-105,569189,569304,115
105,0,blank,0,-323,-105,569304,569414,110
105,0,blank,0,-323,-105,569414,569523,109
105,0,blank,0,-323,-105,569523,569668,145
105,51,=,384,145.32678,406.40582,569694,569872,178
105,0,blank,0,155.0126,400.1581,569872,569960,88
105,0,blank,0,102.765483333333,495.8978,569989,570170,181
105,55,j,408,90.00305,481.6217,570170,570348,178
105,0,blank,0,81.67616,474.10302,570348,570496,148
105,41,else,308,78.47014,168.17114,570554,570701,147
105,56,++,413,98.1274166666667,514.58325,570729,570904,175
105,0,blank,0,103.267133333333,496.426516666667,570904,571077,173
105,0,blank,0,102.94505,467.85835,571077,571251,174
105,0,blank,0,108.8764,437.9826,571251,571280,29
105,45,if,323,125.49195,263.441916666667,571309,571484,175
105,45,if,323,127.12105,262.6926,571484,571542,58
105,0,blank,0,-323,-105,571572,571626,54
105,0,blank,0,136.6392,378.227285714286,571731,571916,185
105,0,blank,0,158.2609,412.799783333333,571916,572089,173
105,52,++,388,152.942816666667,416.14855,572089,572260,171
105,0,blank,0,125.940366666667,412.02845,572260,572431,171
105,51,k,383,125.669933333333,401.873666666667,572431,572518,87
105,0,blank,0,207.129542857143,334.986685714286,572546,572743,197
105,48,++,363,183.162642857143,323.427657142857,572743,572941,198
105,0,blank,0,161.80665,307.710283333333,572941,573112,171
105,0,blank,0,153.450583333333,260.833783333333,573112,573284,172
105,47,c,338,169.623883333333,302.130616666667,573284,573457,173
105,47,c,338,163.2692,316.797685714286,573457,573656,199
105,0,blank,0,163.896333333333,322.842283333333,573656,573827,171
105,0,blank,0,153.363783333333,381.895866666667,573827,573999,172
105,49,multiply,365,189.1736,356.696133333333,573999,574172,173
105,0,blank,0,156.698916666667,383.021716666667,574172,574343,171
105,51,k,383,133.07185,397.7984,574343,574401,58
105,0,blank,0,-323,-105,574458,574534,76
105,52,++,388,143.737,426.5842,574559,574601,42
105,53,multiply,390,136.58552,433.26186,574665,574801,136
105,0,blank,0,141.880216666667,325.345633333333,574830,575003,173
105,45,if,323,133.9814,266.474028571429,575003,575201,198
105,45,if,323,137.526514285714,264.8531,575201,575397,196
105,45,if,323,132.19535,271.3564,575397,575453,56
105,53,multiply,390,144.857328571429,434.542271428571,575481,575678,197
105,52,++,388,139.0672,426.631871428571,575678,575877,199
105,53,multiply,390,191.080271428571,432.861471428571,575877,576076,199
105,53,n1,394,253.142916666667,434.416433333333,576076,576248,172
105,53,comma,403,311.653016666667,439.903366666667,576248,576419,171
105,53,m2,398,340.017433333333,445.996716666667,576419,576592,173
105,53,comma,403,346.9435,437.52128,576592,576734,142
105,0,blank,0,145.534171428571,408.800557142857,576763,576962,199
105,0,blank,0,-323,-105,576990,577044,54
105,0,blank,0,153.0511,361.5021,577070,577096,26
105,0,blank,0,139.568614285714,383.517285714286,577146,577333,187
105,52,j,387,127.243416666667,428.843066666667,577333,577507,174
105,0,blank,0,136.357916666667,406.16535,577507,577683,176
105,51,k,383,126.666566666667,397.3166,577683,577859,176
105,0,blank,0,108.6124,197.851383333333,577859,578030,171
105,0,blank,0,99.71062,204.72766,578030,578174,144
105,0,blank,0,-323,-105,578203,578338,135
105,0,blank,0,194.736766666667,219.532033333333,578366,578442,76
105,0,blank,0,-323,-105,578471,578579,108
105,0,blank,0,152.044285714286,257.8646,578688,578885,197
105,0,blank,0,169.936216666667,382.313416666667,578885,579067,182
105,0,blank,0,195.739133333333,425.248383333333,579067,579254,187
105,0,blank,0,258.2552,430.855066666667,579254,579441,187
105,0,blank,0,333.799283333333,426.553816666667,579441,579629,188
105,0,blank,0,382.2015,424.31738,579629,579784,155
105,0,blank,0,-323,-105,579815,579897,82
105,0,blank,0,156.5169,201.5016,579923,579954,31
105,43,n2,320,169.362283333333,219.16365,580021,580194,173
105,50,},382,132.450633333333,382.4297,580225,580410,185
105,0,blank,0,223.615566666667,341.775266666667,580410,580594,184
105,49,multiply,365,167.267066666667,362.710833333333,580594,580777,183
105,0,blank,0,137.5357,383.654116666667,580777,580959,182
105,0,blank,0,139.38996,381.41756,580959,581113,154
105,0,blank,0,254.17985,415.412716666667,581144,581327,183
105,0,blank,0,328.8206,420.885766666667,581327,581511,184
105,0,blank,0,339.80095,419.489116666667,581511,581697,186
105,0,blank,0,309.720333333333,413.578966666667,581697,581790,93
105,0,blank,0,-323,-105,581820,581877,57
105,49,n1,369,300.453433333333,363.418766666667,581982,582158,176
105,0,blank,0,244.333183333333,320.615466666667,582158,582341,183
105,48,++,363,187.220966666667,334.3558,582341,582524,183
105,48,++,363,175.717133333333,340.136533333333,582524,582707,183
105,49,multiply,365,176.7971,354.3958,582707,582736,29
105,0,blank,0,-323,-105,582767,582913,146
105,0,blank,0,175.68055,296.780875,582940,583049,109
105,0,blank,0,348.634,301.447,583079,583143,64
105,47,+,345,355.79675,317.938133333333,583207,583402,195
105,0,blank,0,341.4842,327.146866666667,583402,583593,191
105,47,+,345,358.5924,317.091,583593,583627,34
105,0,blank,0,-323,-105,583659,583717,58
105,47,=,337,261.2769,310.723916666667,583821,583997,176
105,48,k,362,171.68854,340.11942,583997,584148,151
105,0,blank,0,-323,-105,584209,584237,28
105,51,0,385,168.325242857143,393.793671428571,584288,584483,195
105,51,0,385,170.0651,392.412125,584483,584604,121
105,0,blank,0,-323,-105,584635,584691,56
105,63,++,469,264.1883,659.9026,584717,584743,26
105,0,blank,0,191.630228571429,427.4329,584806,585002,196
105,0,blank,0,191.3931,456.3351,585002,585030,28
105,0,blank,0,197.7747,482.244585714286,585058,585253,195
105,0,blank,0,272.36515,511.3883,585309,585365,56
105,0,blank,0,265.6888,553.1254,585365,585578,213
105,0,blank,0,324.5977,489.152771428571,585578,585774,196
105,53,n2,400,368.8354,450.318233333333,585774,585859,85
105,0,blank,0,-323,-105,585886,586067,181
105,0,blank,0,138.878671428571,473.967185714286,586093,586285,192
105,0,blank,0,111.65575,442.446,586285,586459,174
105,0,blank,0,109.9977,461.026933333333,586459,586632,173
105,0,blank,0,128.558266666667,455.271083333333,586632,586807,175
105,53,multiply,390,145.011933333333,442.5006,586807,586891,84
105,0,blank,0,120.5832,316.623016666667,586920,587092,172
105,0,blank,0,-323,-105,587120,587259,139
105,0,blank,0,265.233857142857,314.988557142857,587288,587481,193
105,0,blank,0,219.8084,330.303433333333,587481,587568,87
105,56,;,414,116.939366666667,514.64225,587597,587771,174
105,0,blank,0,119.7692,492.765733333333,587771,587944,173
105,0,blank,0,126.650916666667,468.969533333333,587944,588117,173
105,55,j,408,88.5369166666667,489.523416666667,588117,588289,172
105,0,blank,0,87.3086166666667,501.49625,588289,588462,173
105,0,blank,0,70.9961,479.44375,588462,588521,59
105,0,blank,0,78.9649833333333,320.308216666667,588550,588728,178
105,43,if,316,85.1582166666667,231.580533333333,588728,588902,174
105,0,blank,0,96.8628857142857,198.301614285714,588902,589101,199
105,0,blank,0,105.318833333333,192.833333333333,589101,589187,86
105,48,k,362,169.94085,328.99415,589215,589386,171
105,47,c,338,172.867083333333,319.930883333333,589386,589558,172
105,0,blank,0,158.326533333333,292.868183333333,589558,589732,174
105,0,blank,0,143.7958,282.8037,589732,589879,147
105,0,blank,0,153.9891,308.0891,589879,589945,66
105,0,blank,0,128.540385714286,242.769728571429,590123,590315,192
105,0,blank,0,123.286483333333,239.184816666667,590315,590489,174
105,45,if,323,130.4896,256.15635,590489,590607,118
105,0,blank,0,-323,-105,590666,590846,180
105,0,blank,0,-323,-105,590846,591032,186
105,0,blank,0,-323,-105,591032,591211,179
105,0,blank,0,-323,-105,591211,591241,30
105,0,blank,0,194.8334,418.1798,591279,591314,35
105,47,j,359,190.134066666667,313.136383333333,591390,591577,187
105,47,j,359,189.09335,312.04625,591577,591639,62
105,47,i,348,399.6193,315.891925,591670,591800,130
105,0,blank,0,-323,-105,591832,591916,84
105,47,[,358,415.1287,319.6996,591948,591978,30
105,0,blank,0,386.501,322.0927,592058,592083,25
105,0,blank,0,136.529583333333,430.52555,592110,592299,189
105,53,multiply,390,132.587233333333,445.990416666667,592299,592484,185
105,53,m1,392,217.07974,432.04342,592484,592640,156
105,0,blank,0,-323,-105,592671,592778,107
105,0,blank,0,238.3792,402.7223,592804,592853,49
105,52,j,387,130.62715,414.578683333333,592921,593096,175
105,0,blank,0,138.410633333333,406.2257,593096,593282,186
105,51,=,384,145.816683333333,393.307066666667,593282,593467,185
105,51,k,383,129.363233333333,396.50375,593467,593651,184
105,0,blank,0,134.90895,399.0038,593651,593711,60
105,0,blank,0,316.361266666667,412.205366666667,593742,593924,182
105,0,blank,0,308.982166666667,414.997283333333,593924,594109,185
105,0,blank,0,297.699516666667,416.555266666667,594109,594296,187
105,0,blank,0,153.157575,411.4981,594326,594451,125
105,0,blank,0,-323,-105,594514,594544,30
105,0,blank,0,180.561133333333,407.298433333333,594620,594793,173
105,0,blank,0,230.1146,419.610933333333,594793,594985,192
105,0,blank,0,296.709483333333,414.033283333333,594985,595174,189
105,0,blank,0,351.720033333333,413.680366666667,595174,595361,187
105,0,blank,0,347.100066666667,418.723,595361,595549,188
105,0,blank,0,351.8293,417.3295,595549,595581,32
105,53,m1,392,220.483883333333,435.5475,595612,595802,190
105,53,(,391,212.0209,450.7463,595802,595833,31
105,0,blank,0,-323,-105,595864,595896,32
105,0,blank,0,161.4288,540.15,595921,595946,25
105,52,++,388,138.7289,416.100116666667,596000,596177,177
105,52,++,388,136.083525,416.4912,596177,596304,127
105,0,blank,0,139.065783333333,313.247683333333,596335,596523,188
105,47,[,358,177.201316666667,310.466016666667,596523,596705,182
105,47,j,359,192.796133333333,311.015566666667,596705,596890,185
105,47,j,359,191.6161,306.8059,596890,596921,31
105,0,blank,0,118.947183333333,409.285583333333,596952,597140,188
105,0,blank,0,122.0906,410.4984,597140,597170,30
105,0,blank,0,-323,-105,597201,597366,165
105,45,if,323,137.44576,268.65346,597398,597540,142
105,51,k,383,129.685383333333,396.05865,597571,597758,187
105,0,blank,0,123.696283333333,406.995833333333,597758,597946,188
105,0,blank,0,121.83675,409.389083333333,597946,598131,185
105,47,c,338,170.976266666667,306.5655,598162,598344,182
105,47,c,338,170.402766666667,306.963,598344,598527,183
105,0,blank,0,117.237283333333,430.646033333333,598558,598745,187
105,0,blank,0,138.822833333333,402.374866666667,598745,598931,186
105,0,blank,0,198.273383333333,284.767216666667,598931,599116,185
105,0,blank,0,197.562166666667,295.37655,599116,599301,185
105,0,blank,0,201.0521,295.6134,599301,599332,31
105,0,blank,0,384.47885,329.0795,599363,599554,191
105,0,blank,0,141.344575,376.084275,599671,599777,106
105,0,blank,0,-323,-105,599808,599942,134
105,45,k,325,163.3394,273.8074,599972,600014,42
105,0,blank,0,164.613133333333,282.415566666667,600086,600258,172
105,47,c,338,167.03345,309.289916666667,600258,600443,185
105,0,blank,0,170.325283333333,320.0795,600443,600626,183
105,0,blank,0,174.494233333333,317.752383333333,600626,600808,182
105,48,++,363,187.868733333333,330.221483333333,600808,600997,189
105,48,;,364,195.58305,328.594266666667,600997,601181,184
105,48,;,364,198.383,326.281666666667,601181,601363,182
105,47,],360,195.05345,313.97595,601363,601549,186
105,47,],360,201.988866666667,309.5148,601549,601733,184
105,47,j,359,191.033483333333,303.563033333333,601733,601918,185
105,48,++,363,187.49445,334.29,601918,601981,63
105,0,blank,0,-323,-105,602012,602068,56
105,57,comma,428,196.3456,539.8872,602093,602119,26
105,0,blank,0,198.4981,379.935583333333,602171,602345,174
105,53,multiply,390,148.357283333333,449.441383333333,602376,602565,189
105,0,blank,0,129.449483333333,472.559016666667,602565,602750,185
105,0,blank,0,101.508733333333,501.27925,602750,602932,182
105,56,++,413,95.285,502.988333333333,602932,603114,182
105,0,blank,0,103.889133333333,452.350816666667,603114,603297,183
105,0,blank,0,115.748416666667,394.932583333333,603297,603481,184
105,47,j,359,187.47995,310.9499,603512,603697,185
105,0,blank,0,240.585833333333,324.710783333333,603697,603881,184
105,47,=,337,253.5032,317.0417,603881,603912,31
105,0,blank,0,-323,-105,603942,604048,106
105,0,blank,0,148.3874,357.1544,604078,604121,43
105,0,blank,0,154.9622,401.73895,604188,604363,175
105,52,;,389,155.82098,420.01976,604363,604517,154
105,45,if,323,135.4713,262.9124,604548,604670,122
105,36,static,284,93.4431,72.3521,604700,604883,183
105,39,return,305,102.37075,126.340883333333,604883,605066,183
105,0,blank,0,97.2504,123.8575,605066,605156,90
105,0,blank,0,95.4557833333333,5.21588333333333,605186,605371,185
105,0,blank,0,107.392866666667,-51.5398,605371,605556,185
105,0,blank,0,107.987466666667,-32.5147333333333,605556,605741,185
105,0,blank,0,-323,-105,605772,605930,158
105,0,blank,0,235.186383333333,420.3045,605958,606135,177
105,52,++,388,151.27305,415.230083333333,606135,606323,188
105,52,++,388,139.9044,414.823366666667,606323,606512,189
105,52,++,388,141.531316666667,421.267966666667,606512,606696,184
105,52,j,387,129.7841,425.7746,606696,606726,30
105,48,;,364,198.894116666667,334.253983333333,606755,606931,176
105,48,++,363,192.4427,334.313366666667,606931,607105,174
105,48,k,362,169.629516666667,322.0885,607105,607279,174
105,0,blank,0,213.49435,336.5828,607279,607338,59
105,47,[,358,420.868425,304.221325,607368,607481,113
105,0,blank,0,-323,-105,607510,607650,140
105,47,i,348,216.304914285714,317.975271428571,607677,607873,196
105,0,blank,0,342.172116666667,299.24655,607873,608052,179
105,0,blank,0,337.012525,298.114825,608052,608172,120
105,47,[,358,176.0209,315.036033333333,608202,608382,180
105,47,[,358,176.0484,318.06305,608382,608442,60
105,0,blank,0,-323,-105,608472,608579,107
105,0,blank,0,229.8862,278.8099,608636,608706,70
105,0,blank,0,260.9295,266.4069,608771,608798,27
105,0,blank,0,369.067533333333,280.43615,608823,609002,179
105,0,blank,0,377.774883333333,292.4499,609002,609184,182
105,0,blank,0,-323,-105,609213,609319,106
105,47,i,348,402.559,302.0284,609345,609370,25
105,0,blank,0,420.488133333333,333.101083333333,609436,609607,171
105,0,blank,0,386.97875,320.2471,609607,609787,180
105,0,blank,0,246.332666666667,338.674116666667,609787,609964,177
105,0,blank,0,248.583566666667,338.5089,609964,610053,89
105,0,blank,0,419.194833333333,289.312966666667,610083,610231,148
105,47,],360,411.8808,314.4284,610231,610335,104
105,0,blank,0,472.5277,312.2752,610335,610516,181
105,0,blank,0,479.3879,272.8766,610516,610549,33
105,0,blank,0,-323,-105,610580,610661,81
105,47,],360,225.3318,309.5977,610686,610716,30
105,47,],360,231.419083333333,313.805666666667,610780,610951,171
105,0,blank,0,179.172416666667,320.575066666667,610951,611134,183
105,0,blank,0,171.357366666667,321.7142,611134,611312,178
105,0,blank,0,158.23735,319.59265,611312,611372,60
105,0,blank,0,-323,-105,611432,611483,51
105,60,comma,442,261.1746,588.3326,611509,611534,25
105,47,],360,311.123557142857,302.237671428571,611591,611788,197
105,47,],360,306.1851,300.24855,611788,611848,60
105,0,blank,0,209.180283333333,326.975283333333,611877,612054,177
105,48,++,363,190.668716666667,332.601066666667,612054,612234,180
105,49,multiply,365,195.8781,347.752866666667,612234,612411,177
105,47,],360,308.7861,307.698733333333,612411,612589,178
105,47,[,358,319.291883333333,314.855516666667,612589,612766,177
105,47,j,359,327.549,308.76595,612766,612825,59
105,0,blank,0,469.6451,309.468133333333,612855,613033,178
105,47,b,354,475.29615,302.611683333333,613033,613210,177
105,0,blank,0,475.025025,297.637475,613210,613329,119
105,0,blank,0,-323,-105,613359,613414,55
105,47,[,358,182.486633333333,319.296516666667,613533,613702,169
105,0,blank,0,153.82655,302.914383333333,613702,613885,183
105,47,c,338,171.566966666667,312.521916666667,613885,614067,182
105,0,blank,0,159.06825,346.309483333333,614067,614244,177
105,0,blank,0,124.01825,386.311166666667,614244,614426,182
105,51,k,383,126.8237,393.68048,614426,614576,150
105,0,blank,0,175.730066666667,239.2423,614606,614788,182
105,0,blank,0,174.726533333333,247.713066666667,614788,614966,178
105,0,blank,0,180.803,272.217716666667,614966,615147,181
105,47,j,359,191.973166666667,314.117983333333,615147,615329,182
105,47,c,338,170.288966666667,315.38745,615329,615509,180
105,47,c,338,166.641166666667,317.836266666667,615509,615600,91
105,0,blank,0,-323,-105,615630,615686,56
105,0,blank,0,156.118657142857,303.0295,615737,615929,192
105,47,c,338,164.063366666667,309.978733333333,615929,616113,184
105,48,++,363,180.200016666667,327.385883333333,616113,616296,183
105,0,blank,0,169.378516666667,341.494883333333,616296,616477,181
105,0,blank,0,-323,-105,616508,616563,55
105,0,blank,0,163.263,278.1388,616588,616613,25
105,0,blank,0,153.936271428571,220.943871428571,616664,616859,195
105,0,blank,0,156.88294,217.74784,616859,617013,154
105,0,blank,0,113.65046,377.64388,617044,617196,152
105,41,<,312,153.94365,177.99935,617227,617409,182
105,0,blank,0,170.40912,186.12886,617409,617558,149
105,0,blank,0,-323,-105,617589,617695,106
105,0,blank,0,157.457,234.7854,617720,617746,26
105,0,blank,0,168.545716666667,246.2326,617811,617983,172
105,0,blank,0,198.837466666667,238.10235,617983,618167,184
105,0,blank,0,205.84344,239.42254,618167,618319,152
105,0,blank,0,-323,-105,618349,618485,136
105,0,blank,0,164.806383333333,298.342333333333,618512,618684,172
105,0,blank,0,144.052966666667,332.43735,618684,618867,183
105,50,},382,126.2615,376.3821,618867,618958,91
105,0,blank,0,141.671916666667,234.690216666667,618989,619172,183
105,43,n2,320,180.735916666667,224.2451,619172,619355,183
105,43,n2,320,180.21645,225.10925,619355,619416,61
105,0,blank,0,-323,-105,619447,619577,130
105,48,k,362,171.083842857143,322.467228571429,619607,619805,198
105,48,++,363,191.4258,339.1508,619805,619835,30
105,47,i,348,394.198333333333,315.190866666667,619865,620048,183
105,47,],360,406.279633333333,312.6121,620048,620231,183
105,0,blank,0,467.618975,278.7775,620231,620351,120
105,0,blank,0,-323,-105,620411,620515,104
105,0,blank,0,194.008828571429,218.760585714286,620543,620741,198
105,43,),321,186.05066,226.8214,620741,620893,152
105,47,k,356,427.911416666667,306.8932,620923,621107,184
105,0,blank,0,430.92425,299.2512,621107,621167,60
105,0,blank,0,-323,-105,621198,621303,105
105,0,blank,0,211.598857142857,237.2487,621328,621523,195
105,0,blank,0,-323,-105,621553,621658,105
105,47,k,356,428.386833333333,318.407933333333,621842,622024,182
105,0,blank,0,424.468566666667,326.628716666667,622024,622209,185
105,47,j,359,323.55885,302.262883333333,622209,622388,179
105,49,n1,369,303.04476,354.064,622388,622535,147
105,48,++,363,178.9042,333.988966666667,622564,622739,175
105,49,multiply,365,176.2193,359.58665,622739,622796,57
105,0,blank,0,-323,-105,622824,622877,53
105,0,blank,0,114.6343,454.1904,622986,623067,81
105,0,blank,0,294.045528571429,364.719214285714,623097,623281,184
105,0,blank,0,-323,-105,623875,624064,189
105,0,blank,0,202.25304,316.67756,624106,624298,192
105,0,blank,0,158.116866666667,335.671566666667,624298,624414,116
105,0,blank,0,-323,-105,625851,626027,176
105,0,blank,0,-323,-105,626027,626377,350
105,0,blank,0,-323,-105,626377,626559,182
105,0,blank,0,-323,-105,626559,626758,199
105,0,blank,0,-323,-105,626758,626934,176
105,0,blank,0,-323,-105,626934,627120,186
105,0,blank,0,-323,-105,627120,627302,182
105,0,blank,0,-323,-105,627302,627479,177
105,0,blank,0,-323,-105,627479,627660,181
105,0,blank,0,-323,-105,627660,627837,177
105,0,blank,0,-323,-105,627837,628014,177
105,0,blank,0,-323,-105,628014,628194,180
105,0,blank,0,-323,-105,628194,628371,177
105,0,blank,0,-323,-105,628371,628558,187
105,0,blank,0,-323,-105,628558,628726,168
105,0,blank,0,-323,-105,628726,628915,189
105,0,blank,0,-323,-105,628915,629112,197
105,0,blank,0,-323,-105,629112,629304,192
105,0,blank,0,-323,-105,629304,629446,142
105,0,blank,0,-323,-105,629446,629504,58
105,0,blank,0,-323,-105,629504,629832,328
105,0,blank,0,-323,-105,629832,630086,254
105,0,blank,0,-323,-105,630086,630340,254
105,0,blank,0,-323,-105,630340,630443,103
105,0,blank,0,-323,-105,630443,630964,521
105,0,blank,0,-323,-105,630964,631062,98
105,0,blank,0,195.20485,295.9842,631092,631147,55
105,0,blank,0,-323,-105,631178,631263,85
105,0,blank,0,167.7759,375.8304,631302,631351,49
105,0,blank,0,153.652075,384.49615,631483,631609,126
105,56,;,414,116.588716666667,510.173666666667,631642,631832,190
105,56,;,414,115.8719,514.5137,631832,631863,31
105,0,blank,0,224.49575,282.450125,631894,632019,125
105,0,blank,0,-323,-105,632081,632165,84
105,0,blank,0,317.512,291.499,632191,632218,27
105,0,blank,0,308.408966666667,299.805266666667,632281,632453,172
105,0,blank,0,290.70995,286.6985,632453,632635,182
105,0,blank,0,285.5936,290.9103,632635,632666,31
105,0,blank,0,-323,-105,632695,632832,137
105,0,blank,0,239.372366666667,291.540583333333,632857,633027,170
105,47,[,358,388.537266666667,318.615816666667,633058,633242,184
105,0,blank,0,-323,-105,633272,633415,143
105,0,blank,0,232.746442857143,301.653485714286,633440,633639,199
105,0,blank,0,186.832566666667,294.922133333333,633639,633822,183
105,47,c,338,171.206725,303.554075,633822,633945,123
105,0,blank,0,-323,-105,633976,634107,131
105,0,blank,0,173.9636,294.1343,634150,634205,55
105,0,blank,0,170.882266666667,293.2894,634269,634442,173
105,0,blank,0,172.950583333333,293.832916666667,634442,634627,185
105,45,if,323,143.594783333333,269.694783333333,634627,634813,186
105,46,{,329,130.714233333333,279.9284,634813,634910,97
105,0,blank,0,104.7301,149.1171,634941,635004,63
105,0,blank,0,-323,-105,635094,635199,105
105,0,blank,0,144.071425,477.273925,635411,635595,184
105,0,blank,0,97.02795,469.72845,635595,635776,181
105,0,blank,0,-323,-105,635820,635999,179
105,0,blank,0,-323,-105,635999,636177,178
105,0,blank,0,-323,-105,636177,636363,186
105,0,blank,0,-323,-105,636363,636468,105
105,0,blank,0,106.0638,408.6754,636502,636534,32
105,57,multiply,415,89.1236,532.792766666667,636581,636746,165
105,0,blank,0,83.1801,501.67326,636828,637022,194
105,55,0,410,124.001633333333,495.71365,637022,637204,182
105,57,m1,417,177.505916666667,521.625283333333,637204,637387,183
105,0,blank,0,99.20955,479.649966666667,637417,637601,184
105,0,blank,0,-323,-105,637630,637686,56
105,0,blank,0,111.175,556.9799,637711,637737,26
105,0,blank,0,101.638216666667,445.736283333333,637787,637955,168
105,0,blank,0,99.6529666666667,448.353283333333,637955,638139,184
105,55,=,409,105.778283333333,486.523516666667,638139,638320,181
105,55,=,409,103.434283333333,487.410883333333,638320,638500,180
105,0,blank,0,98.3177,468.9352,638500,638531,31
105,43,<,319,150.180066666667,220.312116666667,638560,638739,179
105,43,<,319,148.787783333333,225.493216666667,638739,638918,179
105,0,blank,0,119.240866666667,189.59765,638918,639098,180
105,0,blank,0,117.218,182.81625,639098,639157,59
105,51,0,385,168.695683333333,406.885616666667,639188,639370,182
105,52,++,388,135.960183333333,421.1722,639370,639551,181
105,0,blank,0,71.8052333333333,620.170516666667,639581,639763,182
105,60,print,435,81.5714333333333,586.064533333333,639763,639946,183
105,60,print,435,84.0823833333333,596.6634,639946,640129,183
105,62,j,456,120.999916666667,638.80565,640129,640312,183
105,62,;,457,125.6774,637.3148,640312,640342,30
105,0,blank,0,-323,-105,640372,640477,105
105,0,blank,0,105.7559,268.3987,640503,640528,25
105,0,blank,0,113.11235,270.79895,640585,640635,50
105,0,blank,0,215.646166666667,324.379616666667,640661,640842,181
105,0,blank,0,214.1803,333.951833333333,640842,640933,91
105,0,blank,0,380.403566666667,338.57025,640963,641145,182
105,0,blank,0,206.809533333333,336.962516666667,641174,641354,180
105,0,blank,0,185.95505,341.3674,641354,641413,59
105,0,blank,0,127.1592,410.2359,641442,641619,177
105,0,blank,0,128.2411,412.054633333333,641619,641794,175
105,0,blank,0,112.709283333333,411.219816666667,641794,641988,194
105,0,blank,0,147.676257142857,409.952457142857,641988,642183,195
105,0,blank,0,172.5445,381.4599,642183,642211,28
105,0,blank,0,-323,-105,642267,642370,103
105,0,blank,0,284.203271428571,390.798514285714,642394,642573,179
105,0,blank,0,274.497,388.2147,642573,642600,27
105,0,blank,0,436.326442857143,358.3453,642629,642817,188
105,0,blank,0,437.917557142857,363.130471428571,642817,643006,189
105,49,b,377,449.80645,347.81105,643006,643167,161
105,0,blank,0,-323,-105,643499,643672,173
105,52,++,388,145.0695,425.698,644215,644379,164
105,0,blank,0,-323,-105,644406,644433,27
105,0,blank,0,200.5936,567.6669,644483,644508,25
105,0,blank,0,266.543942857143,370.296628571429,644533,644723,190
105,0,blank,0,282.88125,344.71015,644723,644902,179
105,0,blank,0,276.028016666667,333.0458,644902,645085,183
105,49,m1,367,273.949375,358.18305,645085,645206,121
105,0,blank,0,-323,-105,645236,645321,85
105,0,blank,0,162.77405,289.633333333333,645464,645645,181
105,0,blank,0,122.912766666667,386.7216,645676,645863,187
105,50,},382,129.166616666667,384.257166666667,645863,646047,184
105,0,blank,0,142.999583333333,387.614816666667,646047,646230,183
105,0,blank,0,143.0466,296.921383333333,646230,646412,182
105,0,blank,0,148.640066666667,287.747666666667,646412,646504,92
105,0,blank,0,-323,-105,646538,646624,86
105,43,<,319,149.5492,224.8885,646650,646685,35
105,0,blank,0,151.82925,239.065466666667,646755,646937,182
105,0,blank,0,166.9143,242.295833333333,646937,647126,189
105,0,blank,0,183.916233333333,243.755466666667,647126,647312,186
105,45,k,325,165.148016666667,271.275766666667,647312,647497,185
105,0,blank,0,138.613166666667,318.83425,647497,647676,179
105,0,blank,0,104.3209,378.0145,647676,647860,184
105,0,blank,0,109.3198,380.981033333333,647860,647951,91
105,0,blank,0,123.1183,185.439283333333,647982,648166,184
105,0,blank,0,121.745116666667,186.575783333333,648166,648351,185
105,0,blank,0,169.488433333333,242.266733333333,648351,648535,184
105,0,blank,0,146.7167,366.541566666667,648535,648722,187
105,0,blank,0,137.468825,387.35305,648722,648846,124
105,0,blank,0,-323,-105,648877,648933,56
105,0,blank,0,162.203,462.5536,648959,648985,26
105,0,blank,0,172.49315,285.854666666667,649040,649210,170
105,0,blank,0,160.648,236.540633333333,649210,649394,184
105,0,blank,0,199.004466666667,234.34185,649394,649577,183
105,0,blank,0,193.447416666667,250.569183333333,649577,649771,194
105,0,blank,0,201.9767,244.1501,649771,649869,98
105,0,blank,0,-323,-105,649903,650010,107
105,0,blank,0,157.0127,389.3875,650036,650062,26
105,51,=,384,144.12265,395.534266666667,650116,650289,173
105,0,blank,0,122.815716666667,406.0308,650289,650476,187
105,0,blank,0,124.773666666667,409.241916666667,650476,650661,185
105,52,;,389,156.617316666667,418.975283333333,650661,650846,185
105,0,blank,0,173.342333333333,412.0851,650846,650970,124
105,51,k,383,124.5611,405.6474,650970,651148,178
105,0,blank,0,133.0859,408.7845,651148,651346,198
105,0,blank,0,-323,-105,651377,651484,107
105,0,blank,0,138.3374,367.8242,651510,651536,26
105,0,blank,0,149.25315,370.74325,651592,651765,173
105,0,blank,0,155.355416666667,379.518016666667,651765,651952,187
105,0,blank,0,153.74965,386.444366666667,651952,652137,185
105,0,blank,0,136.295933333333,404.978033333333,652137,652323,186
105,0,blank,0,137.76665,400.78025,652323,652383,60
105,0,blank,0,288.384233333333,414.601833333333,652414,652601,187
105,51,=,384,149.25,389.032825,652631,652757,126
105,0,blank,0,-323,-105,652789,652896,107
105,51,=,384,146.0862,403.0316,652933,652982,49
105,51,=,384,147.197916666667,402.86265,653055,653231,176
105,52,++,388,135.985416666667,414.192116666667,653231,653415,184
105,52,j,387,131.294433333333,414.41375,653415,653599,184
105,52,j,387,128.076933333333,418.6888,653599,653783,184
105,51,k,383,125.419283333333,406.281166666667,653783,653966,183
105,51,k,383,125.44478,406.74022,653966,654121,155
105,53,comma,403,276.8847,441.985966666667,654151,654340,189
105,0,blank,0,-323,-105,654402,654510,108
105,0,blank,0,115.6486,403.8407,654541,654585,44
105,39,return,305,129.5426,142.631275,654653,654768,115
105,0,blank,0,173.881633333333,128.446566666667,654799,654988,189
105,0,blank,0,150.8803,161.28755,654988,655186,198
105,41,<,312,153.101166666667,181.454466666667,655186,655283,97
105,0,blank,0,-323,-105,655314,655453,139
105,0,blank,0,155.533033333333,299.860383333333,655480,655650,170
105,0,blank,0,160.77645,301.610933333333,655650,655833,183
105,0,blank,0,174.664083333333,304.979733333333,655833,656016,183
105,47,[,358,175.1476,316.924583333333,656016,656198,182
105,47,c,338,172.908283333333,312.642483333333,656198,656376,178
105,47,[,358,180.38365,302.1352,656376,656436,60
105,0,blank,0,-323,-105,656465,656652,187
105,0,blank,0,-323,-105,656652,656763,111
105,0,blank,0,245.521133333333,436.640233333333,657350,657539,189
105,0,blank,0,246.2341,439.035466666667,657539,657632,93
105,0,blank,0,157.152933333333,359.07165,657663,657849,186
105,0,blank,0,141.22355,370.724675,657849,657974,125
105,0,blank,0,-323,-105,658035,658063,28
105,0,blank,0,146.26295,368.31665,658139,658311,172
105,51,k,383,133.04125,392.907833333333,658311,658500,189
105,51,k,383,132.585933333333,400.3403,658500,658594,94
105,0,blank,0,282.180983333333,439.412066666667,658624,658809,185
105,0,blank,0,280.562833333333,452.9987,658809,658901,92
105,0,blank,0,149.983675,408.4345,658933,659055,122
105,0,blank,0,-323,-105,659116,659168,52
105,0,blank,0,188.3232,571.2681,659194,659219,25
105,0,blank,0,183.2442,384.5388,659271,659297,26
105,0,blank,0,292.759416666667,420.352033333333,659321,659502,181
105,0,blank,0,291.353375,430.779925,659502,659624,122
105,0,blank,0,113.962066666667,403.105566666667,659655,659839,184
105,52,++,388,146.9606,422.8502,659839,660023,184
105,0,blank,0,140.121916666667,407.3901,660023,660207,184
105,0,blank,0,140.419316666667,386.845,660207,660389,182
105,0,blank,0,-323,-105,660450,660502,52
105,0,blank,0,167.5417,583.2135,660528,660553,25
105,0,blank,0,163.079057142857,412.795357142857,660603,660801,198
105,51,k,383,130.921683333333,406.334366666667,660801,660984,183
105,0,blank,0,127.678016666667,410.729,660984,661167,183
105,50,},382,129.327233333333,381.708066666667,661167,661257,90
105,0,blank,0,153.320316666667,212.855583333333,661288,661469,181
105,0,blank,0,244.166416666667,316.169666666667,661500,661682,182
105,0,blank,0,236.95518,327.34056,661682,661833,151
105,52,j,387,128.5347,422.451925,661863,661988,125
105,0,blank,0,-323,-105,662019,662075,56
105,0,blank,0,192.0277,390.5377,662152,662293,141
105,0,blank,0,394.621716666667,332.208583333333,662324,662510,186
105,0,blank,0,391.873783333333,335.47275,662510,662693,183
105,0,blank,0,396.8643,339.453283333333,662693,662873,180
105,49,n1,369,303.4739,358.5361,662873,662903,30
105,51,=,384,147.557283333333,396.5206,662933,663114,181
105,51,=,384,144.842933333333,404.1721,663114,663292,178
105,51,=,384,143.396133333333,405.449333333333,663292,663383,91
105,0,blank,0,-323,-105,663412,663442,30
105,0,blank,0,185.070785714286,415.183557142857,663492,663682,190
105,0,blank,0,185.605033333333,410.9302,663682,663862,180
105,0,blank,0,189.176833333333,411.916033333333,663862,663952,90
105,0,blank,0,-323,-105,663982,664115,133
105,0,blank,0,256.3984,291.104,664153,664204,51
105,0,blank,0,266.9062,294.3723,664270,664352,82
105,0,blank,0,412.2199,319.1673,664382,664562,180
105,0,blank,0,414.1356,313.6305,664562,664591,29
105,0,blank,0,211.046583333333,329.996333333333,664620,664798,178
105,0,blank,0,208.129966666667,332.81705,664798,664978,180
105,0,blank,0,205.37128,335.8178,664978,665128,150
105,0,blank,0,-323,-105,665187,665292,105
105,0,blank,0,136.368,354.2243,665324,665368,44
105,50,},382,129.124685714286,377.678328571429,665430,665629,199
105,0,blank,0,127.187166666667,413.717716666667,665629,665809,180
105,0,blank,0,122.83045,413.549816666667,665809,665987,178
105,0,blank,0,119.566783333333,417.843583333333,665987,666167,180
105,0,blank,0,108.268316666667,419.346033333333,666167,666347,180
105,0,blank,0,110.730766666667,435.721233333333,666347,666525,178
105,0,blank,0,99.6829666666667,478.389483333333,666525,666704,179
105,55,=,409,104.529066666667,481.980733333333,666704,666886,182
105,0,blank,0,79.8627833333333,478.291,666886,667065,179
105,55,j,408,86.6943666666667,478.877883333333,667065,667244,179
105,0,blank,0,95.3392666666667,490.891516666667,667244,667425,181
105,55,j,408,92.4437,491.691466666667,667425,667515,90
105,57,m1,417,191.66345,519.840683333333,667546,667728,182
105,57,multiply,415,100.494666666667,531.183366666667,667728,667911,183
105,0,blank,0,96.0531,547.5912,667911,667940,29
105,0,blank,0,-323,-105,667971,668027,56
105,0,blank,0,197.8723,754.9642,668053,668078,25
105,57,n1,419,221.1377,525.81585,668127,668177,50
105,0,blank,0,46.8485666666667,582.93645,668204,668388,184
105,60,print,435,60.4471,595.647216666667,668388,668571,183
105,60,print,435,83.5575833333333,599.0487,668571,668751,180
105,60,print,435,83.8476833333333,594.65865,668751,668931,180
105,60,print,435,81.1505,597.08125,668931,668990,59
105,0,blank,0,231.770133333333,620.223683333333,669022,669200,178
105,0,blank,0,230.5101,615.8661,669200,669230,30
105,0,blank,0,-323,-105,669260,669342,82
105,57,multiply,415,155.6942,538.4561,669368,669393,25
105,0,blank,0,163.010466666667,471.949166666667,669446,669522,76
105,0,blank,0,54.4542833333333,616.858916666667,669552,669735,183
105,60,print,435,77.2017,594.56615,669735,669919,184
105,0,blank,0,94.6532166666667,583.36795,669919,670101,182
105,60,print,435,89.9826333333333,590.555033333333,670101,670284,183
105,60,print,435,87.670225,594.4548,670284,670407,123
105,0,blank,0,912.932333333333,469.065883333333,670467,670653,186
105,0,blank,0,929.5625,438.19105,670653,670715,62
105,0,blank,0,-323,-105,670775,670856,81
105,0,blank,0,168.644614285714,373.075485714286,670939,671135,196
105,51,;,386,180.6478,402.8553,671135,671288,153
105,0,blank,0,241.51145,459.82045,671463,671611,148
105,0,blank,0,-323,-105,671866,672063,197
105,0,blank,0,-323,-105,672063,672243,180
105,0,blank,0,-323,-105,672243,672424,181
105,0,blank,0,-323,-105,672424,672621,197
105,0,blank,0,-323,-105,672621,672810,189
105,0,blank,0,-323,-105,672810,673001,191
105,0,blank,0,-323,-105,673001,673190,189
105,0,blank,0,-323,-105,673190,673357,167
105,0,blank,0,-323,-105,673357,673549,192
105,0,blank,0,-323,-105,673549,673575,26
105,0,blank,0,-323,-105,673575,673763,188
105,0,blank,0,-323,-105,673763,673958,195
105,0,blank,0,-323,-105,673958,674482,524
105,0,blank,0,-323,-105,674482,674660,178
105,0,blank,0,-323,-105,674660,674840,180
105,0,blank,0,-323,-105,674840,674926,86
105,0,blank,0,-323,-105,674926,675108,182
105,0,blank,0,-323,-105,675108,675569,461
105,0,blank,0,-323,-105,675569,676119,550
105,0,blank,0,-323,-105,676119,676291,172
105,0,blank,0,-323,-105,676291,676350,59
105,0,blank,0,-323,-105,676350,676727,377
105,0,blank,0,-323,-105,676727,677110,383
105,0,blank,0,-323,-105,677110,677284,174
105,0,blank,0,-323,-105,677284,677474,190
105,0,blank,0,-323,-105,677474,677613,139
105,0,blank,0,-323,-105,677613,677834,221
105,0,blank,0,-323,-105,677834,677869,35
105,0,blank,0,-323,-105,677869,678090,221
105,0,blank,0,-323,-105,678090,678258,168
105,0,blank,0,-323,-105,678258,678375,117
105,0,blank,0,-323,-105,678375,678565,190
105,0,blank,0,-323,-105,678565,678732,167
105,0,blank,0,-323,-105,678732,678889,157
105,0,blank,0,-323,-105,678889,679054,165
105,0,blank,0,-323,-105,679054,679250,196
105,0,blank,0,-323,-105,679250,679424,174
105,0,blank,0,-323,-105,679424,679607,183
105,0,blank,0,-323,-105,679607,679644,37
105,0,blank,0,-323,-105,679644,679832,188
105,0,blank,0,-323,-105,679832,680012,180
105,0,blank,0,-323,-105,680012,680109,97
105,0,blank,0,-323,-105,680109,680277,168
105,0,blank,0,-323,-105,680277,680421,144
105,0,blank,0,-323,-105,680421,680562,141
105,0,blank,0,-323,-105,680562,680736,174
105,0,blank,0,-323,-105,680736,680865,129
105,0,blank,0,-323,-105,680865,680963,98
105,0,blank,0,-323,-105,680963,681210,247
105,0,blank,0,-323,-105,681210,681460,250
105,0,blank,0,-323,-105,681460,681688,228
105,0,blank,0,-323,-105,681688,681854,166
105,0,blank,0,-323,-105,681854,681981,127
105,0,blank,0,-323,-105,681981,682163,182
105,0,blank,0,-323,-105,682163,682351,188
105,0,blank,0,-323,-105,682351,682518,167
105,0,blank,0,-323,-105,682518,682637,119
105,0,blank,0,-323,-105,682637,682966,329
105,0,blank,0,-323,-105,682966,683497,531
105,0,blank,0,-323,-105,683729,683917,188
105,0,blank,0,-323,-105,683917,684107,190
105,0,blank,0,91.7052,337.8388,684169,684377,208
105,0,blank,0,196.212975,264.69435,684419,684602,183
105,45,n1,327,207.6596,266.3783,684602,684687,85
105,0,blank,0,-323,-105,684740,684936,196
105,0,blank,0,-323,-105,684936,685115,179
105,0,blank,0,-323,-105,685115,685201,86
105,0,blank,0,-323,-105,685777,685976,199
105,0,blank,0,166.141675,239.407575,686011,686204,193
105,0,blank,0,145.121316666667,205.518883333333,686204,686381,177
105,41,<,312,158.071266666667,171.414933333333,686381,686557,176
105,0,blank,0,161.8378,166.96155,686557,686617,60
105,0,blank,0,-323,-105,686647,686755,108
105,41,<,312,155.8393,168.4494,686805,686868,63
105,43,),321,185.0823,225.149885714286,686934,687132,198
105,0,blank,0,183.62605,239.17675,687132,687311,179
105,0,blank,0,-323,-105,687340,687512,172
105,0,blank,0,-323,-105,687512,687696,184
105,0,blank,0,-323,-105,687696,687875,179
105,0,blank,0,-323,-105,687875,688071,196
105,0,blank,0,-323,-105,688071,688265,194
105,0,blank,0,-323,-105,688265,688294,29
105,0,blank,0,-323,-105,688294,688579,285
105,0,blank,0,-323,-105,688579,688861,282
105,0,blank,0,-323,-105,688861,689035,174
105,0,blank,0,-323,-105,689035,689066,31
105,0,blank,0,-323,-105,689066,689764,698
105,0,blank,0,-323,-105,689764,690457,693
105,0,blank,0,-323,-105,690457,690597,140
105,0,blank,0,-323,-105,690597,691404,807
105,0,blank,0,-323,-105,691404,691584,180
105,0,blank,0,-323,-105,691584,691621,37
105,0,blank,0,158.0709,294.5316,691657,691763,106
105,0,blank,0,-323,-105,691881,692043,162
105,0,blank,0,-323,-105,692043,692098,55
105,0,blank,0,214.9115,282.6061,692166,692247,81
105,0,blank,0,450.092425,269.54495,692479,692646,167
105,0,blank,0,438.5843,283.07105,692646,692820,174
105,0,blank,0,399.808133333333,276.85115,692820,693001,181
105,0,blank,0,339.249633333333,277.539716666667,693001,693179,178
105,0,blank,0,307.287616666667,280.202883333333,693179,693358,179
105,0,blank,0,287.580933333333,274.246233333333,693358,693536,178
105,0,blank,0,305.090433333333,271.0308,693536,693712,176
105,0,blank,0,271.044616666667,271.681983333333,693712,693889,177
105,0,blank,0,237.5725,261.7561,693889,694009,120
105,0,blank,0,182.9358,279.182575,694009,694195,186
105,0,blank,0,274.4954,274.5389,694195,694225,30
105,0,blank,0,439.2105,280.31578,694256,694407,151
105,0,blank,0,-323,-105,694438,694493,55
105,0,blank,0,440.2156,352.4483,694518,694544,26
105,0,blank,0,433.979233333333,288.956983333333,694596,694763,167
105,47,[,358,175.943175,317.03795,694794,694916,122
105,0,blank,0,-323,-105,694976,695138,162
105,0,blank,0,-323,-105,695138,695297,159
105,0,blank,0,-323,-105,695297,695462,165
105,0,blank,0,-323,-105,695462,695633,171
105,0,blank,0,-323,-105,695633,695821,188
105,0,blank,0,-323,-105,695821,696018,197
105,0,blank,0,-323,-105,696018,696113,95
105,0,blank,0,-323,-105,696113,696304,191
105,0,blank,0,-323,-105,696304,696479,175
105,0,blank,0,-323,-105,696479,696656,177
105,0,blank,0,-323,-105,696656,696791,135
105,0,blank,0,-323,-105,696791,696921,130
105,0,blank,0,-323,-105,696921,696994,73
105,0,blank,0,-323,-105,696994,697193,199
105,0,blank,0,-323,-105,697193,697390,197
105,0,blank,0,142.3989,381.7277,697609,697813,204
105,53,comma,403,308.5627,432.3372,697846,698040,194
105,0,blank,0,313.359083333333,428.323,698040,698229,189
105,0,blank,0,315.863883333333,435.353233333333,698229,698422,193
105,0,blank,0,-323,-105,698455,698640,185
105,0,blank,0,-323,-105,698640,698837,197
105,0,blank,0,-323,-105,698837,699026,189
105,0,blank,0,-323,-105,699026,699197,171
105,0,blank,0,-323,-105,699197,699228,31
105,0,blank,0,-323,-105,699228,699398,170
105,0,blank,0,-323,-105,699398,699560,162
105,0,blank,0,-323,-105,699560,699732,172
105,0,blank,0,-323,-105,699732,699903,171
105,0,blank,0,-323,-105,699903,700069,166
105,0,blank,0,-323,-105,700069,700242,173
105,0,blank,0,-323,-105,700242,700389,147
105,0,blank,0,-323,-105,700389,700637,248
105,48,++,363,194.686133333333,326.743016666667,701022,701211,189
105,0,blank,0,183.1108,367.19145,701211,701398,187
105,51,0,385,163.206433333333,388.773133333333,701398,701579,181
105,51,0,385,163.694433333333,392.207183333333,701579,701761,182
105,51,0,385,168.2101,398.780833333333,701761,701940,179
105,0,blank,0,-323,-105,701971,702155,184
105,0,blank,0,-323,-105,702155,702334,179
105,0,blank,0,-323,-105,702334,702506,172
105,0,blank,0,-323,-105,702506,702688,182
105,0,blank,0,-323,-105,702688,702843,155
105,0,blank,0,-323,-105,702843,702963,120
105,0,blank,0,-323,-105,702963,703159,196
105,0,blank,0,-323,-105,703159,703305,146
105,0,blank,0,-323,-105,703305,703544,239
105,0,blank,0,-323,-105,703544,703652,108
105,0,blank,0,-323,-105,703825,704010,185
105,0,blank,0,-323,-105,704010,704185,175
105,0,blank,0,156.02445,358.4561,704228,704418,190
105,0,blank,0,172.172183333333,373.531166666667,704418,704607,189
105,0,blank,0,154.168216666667,375.325283333333,704672,704852,180
105,0,blank,0,109.219633333333,360.3834,704852,704949,97
105,0,blank,0,96.4005,327.7593,704995,705038,43
105,0,blank,0,-323,-105,705132,705312,180
105,0,blank,0,-323,-105,705312,705487,175
105,0,blank,0,-323,-105,705487,705674,187
105,0,blank,0,-323,-105,705674,705781,107
105,45,k,325,165.8552,257.2515,705816,705895,79
105,0,blank,0,221.683425,340.579375,706009,706174,165
105,47,j,359,187.97185,309.896325,706174,706338,164
105,0,blank,0,163.7798,298.27978,706338,706527,189
105,0,blank,0,169.1087,297.144883333333,706527,706708,181
105,47,i,348,218.398366666667,313.130283333333,706708,706889,181
105,47,i,348,222.166183333333,319.463683333333,706889,707071,182
105,0,blank,0,207.804383333333,330.837166666667,707071,707253,182
105,0,blank,0,146.31385,372.31885,707253,707437,184
105,0,blank,0,147.019366666667,376.162166666667,707437,707529,92
105,0,blank,0,-323,-105,707560,707668,108
105,0,blank,0,121.0275,366.7053,707696,707734,38
105,0,blank,0,143.512966666667,383.342533333333,707800,707976,176
105,51,=,384,147.747616666667,393.87375,707976,708160,184
105,53,multiply,390,147.1292,443.8971,708160,708189,29
105,0,blank,0,-323,-105,708219,708352,133
105,0,blank,0,141.3045,377.464,708405,708468,63
105,51,k,383,130.2648,394.5013,708533,708703,170
105,0,blank,0,124.827816666667,411.911766666667,708703,708885,182
105,0,blank,0,118.738216666667,410.596383333333,708885,709064,179
105,0,blank,0,115.54094,404.39982,709064,709217,153
105,0,blank,0,-323,-105,709248,709429,181
105,51,k,383,129.7143,394.579133333333,709475,709559,84
105,0,blank,0,114.8016,206.95932,709592,709762,170
105,0,blank,0,141.421166666667,232.769783333333,709762,709958,196
105,0,blank,0,150.378416666667,247.207533333333,709958,710152,194
105,0,blank,0,152.58274,243.71054,710152,710318,166
105,0,blank,0,-323,-105,710350,710522,172
105,0,blank,0,145.989385714286,335.421842857143,710548,710744,196
105,0,blank,0,151.8427,360.60525,710744,710861,117
105,0,blank,0,-323,-105,710890,710998,108
105,0,blank,0,246.919742857143,416.1052,711113,711305,192
105,0,blank,0,314.02688,399.56572,711305,711446,141
105,0,blank,0,310.355571428571,400.737171428571,711502,711700,198
105,0,blank,0,275.8188,400.1969,711700,711726,26
105,52,++,388,143.6481,423.9792,711753,711781,28
105,51,=,384,144.2157,399.509685714286,711808,711996,188
105,0,blank,0,153.057425,358.5531,711996,712189,193
105,51,=,384,150.5506,395.6081,712189,712285,96
105,51,=,384,153.9152,393.3991,712285,712390,105
105,60,int,443,296.9937,585.6587,712486,712512,26
105,0,blank,0,322.452685714286,364.191057142857,712535,712724,189
105,49,comma,378,391.243442857143,356.666242857143,712724,712921,197
105,0,blank,0,378.33225,379.242866666667,712921,713090,169
105,0,blank,0,144.466885714286,312.625871428571,713119,713312,193
105,45,k,325,165.773,265.5469,713312,713340,28
105,0,blank,0,-323,-105,713367,713445,78
105,0,blank,0,330.757671428571,355.783671428571,713521,713701,180
105,49,a,371,336.82302,352.41788,713701,713842,141
105,0,blank,0,277.7858,381.5436,713870,713896,26
105,0,blank,0,252.05998,429.20254,713951,714094,143
105,0,blank,0,253.637428571429,394.016657142857,714121,714314,193
105,0,blank,0,255.04404,415.46302,714314,714447,133
105,0,blank,0,360.4135,375.5973,714554,714582,28
105,0,blank,0,-323,-105,714663,714716,53
105,0,blank,0,338.4298,493.6614,714742,714767,25
105,0,blank,0,367.7531,377.4034,714824,714976,152
105,0,blank,0,380.230385714286,338.366657142857,715030,715220,190
105,0,blank,0,387.932275,326.977825,715220,715331,111
105,53,multiply,390,186.907814285714,435.687585714286,715359,715550,191
105,0,blank,0,189.702516666667,419.83545,715550,715708,158
105,0,blank,0,-323,-105,715735,715887,152
105,51,;,386,181.4225,403.623428571429,715915,716093,178
105,0,blank,0,180.980075,418.5299,716093,716202,109
105,0,blank,0,342.790333333333,393.860633333333,716255,716338,83
105,0,blank,0,319.5654,421.0154,716338,716538,200
105,0,blank,0,330.38285,402.38805,716538,716594,56
105,0,blank,0,173.570085714286,415.207871428571,716620,716812,192
105,53,multiply,390,159.5917,432.203,716812,716839,27
105,0,blank,0,-323,-105,716867,716919,52
105,56,++,413,112.752842857143,505.781371428571,717019,717202,183
105,0,blank,0,170.31035,453.979216666667,717202,717377,175
105,53,m1,392,219.789733333333,451.4742,717377,717559,182
105,0,blank,0,172.97355,413.287066666667,717559,717744,185
105,51,k,383,128.8393,391.47025,717744,717804,60
105,0,blank,0,-323,-105,717836,717992,156
105,0,blank,0,-323,-105,717992,718115,123
105,0,blank,0,251.3154,305.5958,718152,718211,59
105,0,blank,0,392.749183333333,334.6189,718244,718434,190
105,0,blank,0,389.514316666667,333.13985,718434,718624,190
105,0,blank,0,323.077166666667,412.364483333333,718624,718809,185
105,0,blank,0,312.728416666667,428.84025,718809,718996,187
105,0,blank,0,363.79768,408.72806,718996,719153,157
105,0,blank,0,-323,-105,719217,719247,30
105,0,blank,0,129.697,459.9559,719273,719299,26
105,51,k,383,128.35815,402.187933333333,719352,719522,170
105,51,k,383,131.668125,393.617425,719522,719647,125
105,0,blank,0,-323,-105,719709,719762,53
105,63,i,468,171.5912,666.2349,719788,719814,26
105,0,blank,0,200.19325,414.826766666667,719869,720040,171
105,52,++,388,149.06265,418.459666666667,720040,720222,182
105,0,blank,0,119.4637,411.05385,720222,720405,183
105,52,j,387,124.173133333333,416.935383333333,720405,720586,181
105,0,blank,0,-323,-105,720617,720725,108
105,51,k,383,131.815666666667,390.27585,720776,720958,182
105,51,k,383,124.922283333333,388.001266666667,720958,721141,183
105,0,blank,0,121.80715,397.60765,721141,721202,61
105,0,blank,0,130.521183333333,244.830416666667,721233,721417,184
105,0,blank,0,122.559333333333,260.882833333333,721417,721596,179
105,0,blank,0,120.934733333333,245.043133333333,721596,721686,90
105,0,blank,0,121.847866666667,411.887666666667,721717,721900,183
105,0,blank,0,121.4007,411.162333333333,721900,722083,183
105,0,blank,0,136.138033333333,384.065683333333,722083,722267,184
105,0,blank,0,140.114133333333,380.590366666667,722267,722449,182
105,0,blank,0,139.54694,381.61028,722449,722603,154
105,0,blank,0,-323,-105,722633,722717,84
105,0,blank,0,367.2075,303.1557,722833,722913,80
105,48,++,363,192.895533333333,326.412033333333,722943,723036,93
105,0,blank,0,-323,-105,723067,723174,107
105,0,blank,0,223.3435,341.6595,723202,723239,37
105,0,blank,0,224.698616666667,327.800683333333,723302,723475,173
105,0,blank,0,228.736766666667,333.5256,723475,723566,91
105,0,blank,0,378.009333333333,321.979266666667,723595,723777,182
105,0,blank,0,384.39008,320.92104,723777,723926,149
105,0,blank,0,144.403933333333,312.796,723956,724135,179
105,0,blank,0,-323,-105,724164,724271,107
105,0,blank,0,269.9212,309.0409,724297,724322,25
105,47,=,337,256.981866666667,315.896183333333,724372,724539,167
105,0,blank,0,158.369025,332.861325,724570,724693,123
105,0,blank,0,-323,-105,724723,724808,85
105,53,n1,394,253.699,440.7123,724834,724861,27
105,0,blank,0,219.2537,320.59225,724922,725095,173
105,0,blank,0,348.590283333333,335.058533333333,725095,725276,181
105,49,comma,378,387.3632,345.7059,725276,725307,31
105,0,blank,0,-323,-105,725367,725392,25
105,0,blank,0,247.403042857143,319.494771428571,725468,725661,193
105,47,c,338,164.07245,306.460216666667,725661,725840,179
105,0,blank,0,157.847433333333,319.0752,725840,726019,179
105,0,blank,0,117.531533333333,369.1503,726019,726200,181
105,0,blank,0,112.537575,376.2666,726200,726319,119
105,0,blank,0,-323,-105,726380,726409,29
105,0,blank,0,213.8107,610.1258,726435,726461,26
105,51,0,385,165.151766666667,389.371433333333,726510,726585,75
105,0,blank,0,328.582733333333,347.183516666667,726614,726792,178
105,0,blank,0,338.0726,337.051433333333,726792,726881,89
105,0,blank,0,-323,-105,726911,726966,55
105,53,multiply,390,197.8134,434.5937,726991,727016,25
105,0,blank,0,201.5559,366.824728571429,727066,727262,196
105,0,blank,0,123.986616666667,384.745883333333,727262,727443,181
105,0,blank,0,114.7143,387.026616666667,727443,727625,182
105,0,blank,0,141.6391,381.180483333333,727625,727808,183
105,0,blank,0,139.969316666667,380.495466666667,727808,727992,184
105,0,blank,0,143.1266,374.7708,727992,728023,31
105,0,blank,0,-323,-105,728053,728198,145
105,0,blank,0,155.394666666667,397.2767,728228,728403,175
105,0,blank,0,116.37405,389.258525,728403,728526,123
105,0,blank,0,-323,-105,728557,728664,107
105,0,blank,0,135.8746,756.4286,728690,728716,26
105,0,blank,0,114.423816666667,387.733266666667,728792,728966,174
105,0,blank,0,113.804066666667,388.599733333333,728966,729152,186
105,0,blank,0,113.40105,386.8232,729152,729214,62
105,0,blank,0,-323,-105,729245,729416,171
105,0,blank,0,208.585383333333,411.998033333333,729445,729620,175
105,51,k,383,124.499333333333,395.034566666667,729620,729804,184
105,0,blank,0,162.094083333333,414.895266666667,729804,729986,182
105,0,blank,0,280.3092,455.2894,729986,730168,182
105,53,n1,394,265.077716666667,436.96905,730168,730352,184
105,53,n1,394,263.3735,442.097066666667,730352,730443,91
105,51,k,383,126.21285,402.873766666667,730473,730659,186
105,0,blank,0,-323,-105,730689,730746,57
105,0,blank,0,281.205233333333,366.425316666667,730822,730994,172
105,0,blank,0,323.257166666667,421.285633333333,730994,731180,186
105,0,blank,0,330.70575,419.2925,731180,731303,123
105,0,blank,0,159.66028,366.94956,731334,731489,155
105,0,blank,0,-323,-105,731520,731652,132
105,0,blank,0,182.288016666667,379.383633333333,731746,731920,174
105,0,blank,0,214.422066666667,417.798933333333,731920,732103,183
105,0,blank,0,141.075433333333,405.696766666667,732103,732286,183
105,0,blank,0,130.489483333333,407.298366666667,732286,732473,187
105,52,j,387,125.4385,418.5165,732473,732527,54
105,0,blank,0,259.1541,455.6051,732639,732751,112
105,0,blank,0,245.606275,477.88995,732751,732941,190
105,0,blank,0,218.62624,487.7717,732941,733084,143
105,0,blank,0,-323,-105,733635,733741,106
105,0,blank,0,167.6846,376.4617,733779,733811,32
105,0,blank,0,140.1324,547.9919,733888,733920,32
105,0,blank,0,120.66185,376.81315,733960,734039,79
105,0,blank,0,-323,-105,734425,734531,106
105,0,blank,0,-323,-105,734531,735287,756
105,0,blank,0,-323,-105,735287,735456,169
105,0,blank,0,-323,-105,735456,735646,190
105,0,blank,0,-323,-105,735646,735822,176
105,0,blank,0,-323,-105,735822,735999,177
105,0,blank,0,-323,-105,735999,736181,182
105,0,blank,0,-323,-105,736181,736356,175
105,0,blank,0,-323,-105,736356,736531,175
105,0,blank,0,-323,-105,736531,736707,176
105,0,blank,0,-323,-105,736707,736906,199
105,0,blank,0,-323,-105,736906,737082,176
105,0,blank,0,-323,-105,737082,737257,175
105,0,blank,0,-323,-105,737257,737433,176
105,0,blank,0,-323,-105,737433,737607,174
105,0,blank,0,-323,-105,737607,737784,177
105,0,blank,0,-323,-105,737784,737960,176
105,0,blank,0,-323,-105,737960,738135,175
105,0,blank,0,-323,-105,738135,738311,176
105,0,blank,0,-323,-105,738311,738487,176
105,0,blank,0,-323,-105,738487,738672,185
105,0,blank,0,-323,-105,738672,738852,180
105,0,blank,0,-323,-105,738852,739042,190
105,0,blank,0,-323,-105,739042,739146,104
105,0,blank,0,-323,-105,739146,739331,185
105,0,blank,0,-323,-105,739331,739527,196
105,0,blank,0,-323,-105,739527,739708,181
105,0,blank,0,-323,-105,739708,739811,103
105,0,blank,0,-323,-105,739811,740004,193
105,0,blank,0,-323,-105,740004,740091,87
105,0,blank,0,-323,-105,740091,740307,216
105,0,blank,0,-323,-105,740307,740468,161
105,0,blank,0,-323,-105,740468,740589,121
105,0,blank,0,995.634,472.428325,740630,740750,120
105,0,blank,0,1040.91433333333,475.0279,740867,740945,78
105,0,blank,0,1024.63433333333,491.5211,741082,741160,78
105,0,blank,0,1039.53966666667,514.101133333333,741397,741579,182
105,0,blank,0,1042.516,502.298825,741579,741772,193
105,0,blank,0,1019.954,534.271,741772,741907,135
105,0,blank,0,1019.046,540.8897,741990,742015,25
106,67,"%d",488,226.4282,609.78625,742624,742724,100
106,0,blank,0,-323,-105,742749,742874,125
106,0,blank,0,295.143,588.3676,742900,742925,25
106,0,blank,0,235.344,588.4298,743643,743668,25
106,0,blank,0,-323,-105,743691,743866,175
106,0,blank,0,-323,-105,743866,744051,185
106,0,blank,0,-323,-105,744051,744103,52
106,0,blank,0,141.615,580.9929,744228,744253,25
106,0,blank,0,264.6061,543.27955,744378,744453,75
106,0,blank,0,266.9146,610.3285,744678,744703,25
106,0,blank,0,218.4818,651.5126,745078,745103,25
106,0,blank,0,-323,-105,745378,745480,102
106,0,blank,0,241.9951,268.8563,745506,745531,25
106,0,blank,0,-323,-105,745583,745760,177
106,0,blank,0,-323,-105,745760,745913,153
106,0,blank,0,558.0106,327.8007,745969,745999,30
106,0,blank,0,1039.23875,484.208425,746411,746576,165
106,0,blank,0,1012.7365,577.71335,746576,746762,186
106,0,blank,0,1001.926,591.3807,746762,746843,81
106,0,blank,0,-323,-105,746868,746961,93
106,0,blank,0,-321.9961,532.0223,747116,747196,80
106,0,blank,0,1102.034,539.8367,747262,747288,26
106,0,blank,0,1079.012,602.0804,747528,747553,25
106,0,blank,0,1031.536,528.5517,747819,747844,25
106,0,blank,0,1028.46475,429.9033,748047,748226,179
106,0,blank,0,1023.895,434.35295,748226,748310,84
106,0,blank,0,1045.539,391.5919,748310,748489,179
106,0,blank,0,1037.519,422.5106,748489,748514,25
107,0,blank,0,-323,-105,749590,749767,177
107,0,blank,0,-323,-105,749767,749929,162
107,0,blank,0,-323,-105,749929,750195,266
107,0,blank,0,-323,-105,750195,750287,92
107,0,blank,0,-323,-105,750287,750554,267
107,0,blank,0,-323,-105,750554,750731,177
107,0,blank,0,-323,-105,750731,750767,36
107,0,blank,0,-323,-105,750767,751006,239
107,0,blank,0,-323,-105,751006,751198,192
107,0,blank,0,-323,-105,751198,751378,180
107,0,blank,0,-323,-105,751378,751561,183
107,0,blank,0,-323,-105,751561,751719,158
107,0,blank,0,156.8681,526.855566666667,751760,751932,172
107,0,blank,0,-323,-105,752090,752286,196
107,0,blank,0,-323,-105,752286,752365,79
107,0,blank,0,-323,-105,752365,752740,375
107,0,blank,0,-323,-105,752740,752860,120
107,0,blank,0,-323,-105,752860,752951,91
107,0,blank,0,-323,-105,752951,753095,144
107,0,blank,0,-323,-105,753095,753279,184
107,0,blank,0,-323,-105,753279,753473,194
107,0,blank,0,-323,-105,753473,753617,144
107,0,blank,0,-323,-105,753617,753815,198
107,0,blank,0,-323,-105,753815,753960,145
107,0,blank,0,-323,-105,753960,754133,173
107,0,blank,0,-323,-105,754133,754282,149
107,0,blank,0,-323,-105,754282,754389,107
107,0,blank,0,-323,-105,754389,754544,155
107,0,blank,0,-323,-105,754544,754740,196
107,0,blank,0,-323,-105,754740,754845,105
107,0,blank,0,-323,-105,754845,755012,167
107,0,blank,0,-323,-105,755012,755198,186
107,0,blank,0,-323,-105,755198,755374,176
107,0,blank,0,-323,-105,755374,755538,164
107,0,blank,0,-323,-105,755538,755721,183
107,0,blank,0,-323,-105,755721,755803,82
107,0,blank,0,-323,-105,755803,755958,155
107,0,blank,0,-323,-105,755958,756177,219
107,0,blank,0,-323,-105,756177,756541,364
107,0,blank,0,-323,-105,756541,757063,522
107,0,blank,0,-323,-105,757063,757237,174
107,0,blank,0,-323,-105,757237,757365,128
107,0,blank,0,-323,-105,757365,757552,187
107,0,blank,0,-323,-105,757552,757801,249
107,0,blank,0,-323,-105,757801,757867,66
107,0,blank,0,-323,-105,757867,758130,263
107,0,blank,0,-323,-105,758130,758309,179
107,0,blank,0,-323,-105,758309,758378,69
107,0,blank,0,-323,-105,758378,758509,131
107,0,blank,0,-323,-105,758509,758722,213
107,0,blank,0,-323,-105,758722,758829,107
107,0,blank,0,-323,-105,758829,758989,160
107,0,blank,0,-323,-105,758989,759049,60
107,0,blank,0,-323,-105,759049,759223,174
107,0,blank,0,-323,-105,759223,759409,186
107,0,blank,0,-323,-105,759409,759526,117
107,0,blank,0,-323,-105,759526,759685,159
107,0,blank,0,-323,-105,759685,759740,55
107,0,blank,0,-323,-105,759740,759887,147
107,0,blank,0,-323,-105,759887,759942,55
107,0,blank,0,-323,-105,759942,760223,281
107,0,blank,0,-323,-105,760223,760376,153
107,0,blank,0,-323,-105,760376,760702,326
107,0,blank,0,-323,-105,760702,760970,268
107,0,blank,0,-323,-105,760970,761134,164
107,0,blank,0,-323,-105,761134,761384,250
107,0,blank,0,-323,-105,761384,761415,31
107,0,blank,0,-323,-105,761415,761761,346
107,0,blank,0,-323,-105,761761,762109,348
107,0,blank,0,-323,-105,762109,762250,141
107,0,blank,0,-323,-105,762397,762718,321
107,0,blank,0,-323,-105,762718,763398,680
107,0,blank,0,-323,-105,763398,763622,224
107,0,blank,0,-323,-105,763622,763663,41
107,0,blank,0,-323,-105,763663,764238,575
107,0,blank,0,-323,-105,764238,764811,573
107,0,blank,0,-323,-105,764811,764926,115
107,0,blank,0,-323,-105,765677,765761,84
107,0,blank,0,-323,-105,765761,766054,293
107,0,blank,0,-323,-105,766054,766303,249
107,0,blank,0,-323,-105,766303,766645,342
107,0,blank,0,-323,-105,766645,766831,186
107,0,blank,0,-323,-105,766831,766873,42
107,0,blank,0,259.9104,465.6833,767001,767242,241
107,41,i,311,136.88295,252.15205,767301,767495,194
107,0,blank,0,-323,-105,767538,767717,179
107,0,blank,0,-323,-105,767717,767897,180
107,0,blank,0,-323,-105,767897,768084,187
107,0,blank,0,-323,-105,768084,768233,149
107,0,blank,0,-323,-105,768233,768290,57
107,0,blank,0,-323,-105,768290,769108,818
107,0,blank,0,-323,-105,769108,769299,191
107,0,blank,0,-323,-105,769299,769371,72
107,0,blank,0,-323,-105,769487,769529,42
107,0,blank,0,189.3703,231.4655,769810,769865,55
107,0,blank,0,-323,-105,769917,770024,107
107,0,blank,0,356.371133333333,339.159366666667,770161,770336,175
107,0,blank,0,255.228266666667,344.087333333333,770336,770522,186
107,0,blank,0,225.267683333333,360.4203,770522,770708,186
107,0,blank,0,222.067466666667,354.7997,770708,770799,91
107,0,blank,0,164.802233333333,529.1108,770830,771016,186
107,53,multiply,390,169.360816666667,496.3569,771016,771199,183
107,0,blank,0,181.8066,524.9567,771199,771230,31
107,0,blank,0,-323,-105,771261,771344,83
107,0,blank,0,132.2772,622.6125,771369,771395,26
107,53,multiply,390,160.586083333333,505.1712,771450,771620,170
107,0,blank,0,146.269,568.06585,771620,771803,183
107,55,;,411,138.617066666667,557.5603,771803,771896,93
107,0,blank,0,-323,-105,771926,772007,81
107,0,blank,0,239.8149,630.3173,772033,772059,26
107,0,blank,0,212.990116666667,453.59325,772113,772282,169
107,0,blank,0,213.821966666667,453.325666666667,772282,772465,183
107,0,blank,0,219.664733333333,460.7874,772465,772558,93
107,0,blank,0,-323,-105,772589,772698,109
107,0,blank,0,226.7803,458.8575,772729,772771,42
107,0,blank,0,217.99085,458.570533333333,772843,773019,176
107,0,blank,0,224.602116666667,474.642016666667,773019,773205,186
107,0,blank,0,222.502966666667,455.380666666667,773205,773319,114
107,0,blank,0,-323,-105,773397,773485,88
107,0,blank,0,255.6401,335.6215,773522,773617,95
107,0,blank,0,137.656083333333,274.046783333333,773722,773897,175
107,0,blank,0,135.666975,285.229525,773897,774019,122
107,0,blank,0,253.813616666667,394.790183333333,774049,774232,183
107,0,blank,0,238.382433333333,391.482966666667,774232,774412,180
107,47,],360,197.163233333333,380.875433333333,774412,774594,182
107,0,blank,0,202.7052,400.489733333333,774594,774685,91
107,0,blank,0,-323,-105,774716,774797,81
107,47,+,345,362.46105,383.306116666667,774904,775079,175
107,0,blank,0,364.640133333333,389.537166666667,775079,775171,92
107,47,[,358,208.909966666667,378.138566666667,775202,775385,183
107,0,blank,0,215.452983333333,387.06495,775385,775570,185
107,0,blank,0,214.4715,394.528016666667,775570,775752,182
107,47,i,348,219.361966666667,366.168383333333,775752,775933,181
107,0,blank,0,244.159266666667,311.237816666667,775933,776116,183
107,0,blank,0,246.435883333333,319.12605,776116,776299,183
107,0,blank,0,231.245183333333,307.8532,776299,776485,186
107,0,blank,0,207.340733333333,286.924833333333,776485,776670,185
107,41,m1,313,191.096666666667,248.829433333333,776670,776857,187
107,0,blank,0,174.311966666667,217.650316666667,776857,777044,187
107,0,blank,0,-323,-105,777076,777160,84
107,0,blank,0,212.7342,230.3854,777185,777230,45
107,0,blank,0,-323,-105,777266,777398,132
107,47,[,358,205.4059,370.1538,777624,777800,176
107,0,blank,0,216.834383333333,390.4325,777800,777987,187
107,0,blank,0,173.702,436.8235,777987,778170,183
107,0,blank,0,165.13495,435.23955,778170,778232,62
107,0,blank,0,-323,-105,778262,778370,108
107,0,blank,0,193.6874,475.9167,778407,778455,48
107,0,blank,0,179.66045,448.922816666667,778517,778694,177
107,0,blank,0,186.3519,454.984575,778694,778816,122
107,45,n1,327,216.7822,322.054833333333,778845,778939,94
107,0,blank,0,-323,-105,778967,779142,175
107,0,blank,0,-323,-105,779142,779210,68
107,41,m1,313,179.50385,252.974633333333,779243,779417,174
107,0,blank,0,170.896066666667,242.976066666667,779417,779598,181
107,0,blank,0,178.2216,254.6916,779598,779629,31
107,0,blank,0,-323,-105,779719,779771,52
107,53,multiply,390,164.3206,503.2546,779796,779822,26
107,0,blank,0,189.886266666667,442.247283333333,779874,780048,174
107,0,blank,0,182.17502,472.46036,780048,780219,171
107,0,blank,0,-323,-105,780520,780697,177
107,0,blank,0,-323,-105,780697,780884,187
107,0,blank,0,-323,-105,780884,781056,172
107,0,blank,0,-323,-105,781056,781236,180
107,0,blank,0,-323,-105,781236,781384,148
107,0,blank,0,-323,-105,781384,781534,150
107,0,blank,0,-323,-105,781534,781695,161
107,0,blank,0,-323,-105,781695,781873,178
107,0,blank,0,-323,-105,781873,782070,197
107,0,blank,0,-323,-105,782070,782111,41
107,0,blank,0,81.64565,567.16965,782137,782185,48
107,0,blank,0,-323,-105,782440,782584,144
107,0,blank,0,286.45892,432.0591,782629,782828,199
107,47,],360,308.25715,382.0479,782828,782910,82
107,0,blank,0,-323,-105,782992,783096,104
107,0,blank,0,-323,-105,783096,783207,111
107,45,k,325,168.177733333333,331.8554,783283,783401,118
107,0,blank,0,160.1428,452.658,783441,783481,40
107,0,blank,0,240.1519,231.3882,783521,783561,40
107,0,blank,0,-323,-105,783599,783792,193
107,0,blank,0,-323,-105,783792,783967,175
107,0,blank,0,-323,-105,783967,784157,190
107,0,blank,0,-323,-105,784157,784335,178
107,0,blank,0,-323,-105,784335,784508,173
107,0,blank,0,-323,-105,784508,784700,192
107,0,blank,0,-323,-105,784700,784877,177
107,0,blank,0,-323,-105,784877,785062,185
107,0,blank,0,-323,-105,785062,785210,148
107,0,blank,0,-323,-105,785210,785492,282
107,0,blank,0,-323,-105,785492,785673,181
107,0,blank,0,-323,-105,785673,785840,167
107,0,blank,0,-323,-105,785840,786012,172
107,0,blank,0,-323,-105,786012,786180,168
107,0,blank,0,-323,-105,786180,786372,192
107,0,blank,0,-323,-105,786372,786507,135
107,0,blank,0,-323,-105,786507,786663,156
107,0,blank,0,-323,-105,786663,786774,111
107,0,blank,0,-323,-105,786774,786966,192
107,0,blank,0,-323,-105,786966,787150,184
107,0,blank,0,-323,-105,787150,787256,106
107,0,blank,0,-323,-105,787551,787637,86
107,0,blank,0,334.7636,326.4377,787663,787702,39
107,0,blank,0,332.072166666667,336.009733333333,787779,787976,197
107,0,blank,0,406.87615,344.7377,787976,788160,184
107,0,blank,0,329.377325,333.488,788160,788339,179
107,0,blank,0,308.70945,353.4514,788339,788429,90
107,0,blank,0,-323,-105,788474,788671,197
107,0,blank,0,-323,-105,788671,788852,181
107,0,blank,0,-323,-105,788852,789040,188
107,0,blank,0,-323,-105,789040,789216,176
107,0,blank,0,-323,-105,789216,789404,188
107,0,blank,0,-323,-105,789404,789490,86
107,0,blank,0,-323,-105,789490,789627,137
107,0,blank,0,-323,-105,789627,789775,148
107,0,blank,0,-323,-105,789775,789974,199
107,0,blank,0,-323,-105,789974,790610,636
107,0,blank,0,-323,-105,790610,790794,184
107,0,blank,0,-323,-105,791756,791934,178
107,0,blank,0,-323,-105,791934,792037,103
107,0,blank,0,-323,-105,792037,792293,256
107,0,blank,0,-323,-105,792293,792547,254
107,0,blank,0,-323,-105,792547,792801,254
107,0,blank,0,-323,-105,792801,792979,178
107,0,blank,0,-323,-105,792979,793101,122
107,0,blank,0,-323,-105,793101,793270,169
107,0,blank,0,-323,-105,793270,793580,310
107,0,blank,0,-323,-105,793580,794058,478
107,0,blank,0,-323,-105,794058,794236,178
107,0,blank,0,-323,-105,794540,794647,107
107,0,blank,0,-323,-105,794647,794783,136
107,0,blank,0,-323,-105,794783,794936,153
107,0,blank,0,-323,-105,794936,795174,238
107,0,blank,0,-323,-105,795174,795361,187
107,0,blank,0,-323,-105,795361,795533,172
107,0,blank,0,-323,-105,795533,795684,151
107,0,blank,0,-323,-105,795684,795894,210
107,0,blank,0,-323,-105,795894,795997,103
107,0,blank,0,-323,-105,795997,796380,383
107,0,blank,0,-323,-105,796380,796570,190
107,0,blank,0,-323,-105,796570,796673,103
107,0,blank,0,390.2352,319.5122,796752,796810,58
107,0,blank,0,-323,-105,796899,797095,196
107,0,blank,0,-323,-105,797095,797275,180
107,0,blank,0,-323,-105,797275,797464,189
107,0,blank,0,-323,-105,797464,797567,103
107,0,blank,0,-323,-105,798181,798277,96
107,0,blank,0,-323,-105,798277,798568,291
107,0,blank,0,-323,-105,798568,798754,186
107,0,blank,0,-323,-105,798754,798976,222
107,0,blank,0,-323,-105,798976,799193,217
107,0,blank,0,-323,-105,799193,799333,140
107,0,blank,0,-323,-105,799333,799531,198
107,0,blank,0,-323,-105,799531,799721,190
107,0,blank,0,-323,-105,799721,799834,113
107,0,blank,0,-323,-105,799834,800011,177
107,0,blank,0,-323,-105,800011,800141,130
107,0,blank,0,-323,-105,800141,800228,87
107,0,blank,0,-323,-105,800228,800432,204
107,0,blank,0,172.96688,385.4496,800654,800834,180
107,0,blank,0,-323,-105,800871,801003,132
107,0,blank,0,159.028985714286,446.1848,801147,801343,196
107,0,blank,0,160.691285714286,445.598128571429,801343,801541,198
107,49,multiply,365,165.3333,422.48665,801541,801597,56
107,0,blank,0,-323,-105,801625,801653,28
107,48,;,364,195.353171428571,388.571428571429,801703,801883,180
107,49,multiply,365,171.0215,425.073,801883,801966,83
107,0,blank,0,-323,-105,802021,802124,103
107,47,=,337,261.9297,380.827,802155,802198,43
107,0,blank,0,251.894428571429,404.119785714286,802259,802448,189
107,49,n1,369,295.271414285714,417.155814285714,802448,802646,198
107,49,n1,369,313.992633333333,419.399233333333,802646,802818,172
107,49,m2,373,382.64865,410.94065,802818,802874,56
107,49,comma,378,391.7241,427.8864,802929,802986,57
107,0,blank,0,-323,-105,803014,803068,54
107,0,blank,0,374.9315,548.5982,803094,803120,26
107,0,blank,0,446.8317,377.0714,803168,803193,25
107,0,blank,0,464.0547,352.4288,803243,803268,25
107,49,multiply,365,178.463985714286,422.6916,803294,803491,197
107,0,blank,0,175.195233333333,430.98135,803491,803661,170
107,0,blank,0,394.31665,393.80555,803745,803800,55
107,0,blank,0,-323,-105,803828,803933,105
107,47,k,356,433.351,365.0842,803980,804037,57
107,47,],360,440.7013,367.7101,804097,804123,26
107,52,++,388,148.3362,490.892014285714,804149,804347,198
107,52,++,388,147.505857142857,493.775871428571,804347,804544,197
107,0,blank,0,174.76338,445.52518,804544,804684,140
107,0,blank,0,-323,-105,804712,804790,78
107,0,blank,0,168.5949,385.0335,804816,804841,25
107,48,++,363,181.315557142857,392.646771428571,804890,805073,183
107,48,++,363,176.2004,401.33835,805073,805184,111
107,0,blank,0,-323,-105,805212,805374,162
107,0,blank,0,369.5633,397.1892,805400,805572,172
107,0,blank,0,458.033328571429,391.846057142857,805600,805797,197
107,49,multiply,365,169.475814285714,411.454985714286,805826,806020,194
107,48,k,362,166.0935,397.7259,806020,806046,26
107,53,multiply,390,131.833428571429,509.035128571429,806073,806271,198
107,0,blank,0,125.959733333333,517.823633333333,806271,806439,168
107,0,blank,0,82.9592,614.6474,806467,806580,113
107,0,blank,0,-323,-105,806608,806736,128
107,0,blank,0,135.941728571429,435.9853,806810,806993,183
107,0,blank,0,141.509142857143,446.707571428571,806993,807190,197
107,0,blank,0,135.410966666667,364.97645,807190,807361,171
107,0,blank,0,-323,-105,807388,807492,104
107,52,;,389,161.3363,484.3662,807518,807543,25
107,43,j,318,126.193666666667,292.515266666667,807603,807680,77
107,0,blank,0,113.094257142857,620.641328571429,807708,807901,193
107,57,multiply,415,101.849014285714,601.310128571429,807901,808097,196
107,57,multiply,415,94.8020285714286,592.452628571428,808097,808289,192
107,57,multiply,415,92.54905,593.6568,808289,808399,110
107,0,blank,0,-323,-105,808427,808504,77
107,56,++,413,98.1835714285714,573.539571428571,808529,808707,178
107,56,++,413,106.793585714286,575.879585714286,808707,808904,197
107,0,blank,0,95.9215428571429,606.013571428571,808904,809096,192
107,56,++,413,100.792725,581.6667,809096,809206,110
107,0,blank,0,271.701257142857,649.7844,809233,809425,192
107,0,blank,0,281.285442857143,623.4292,809425,809616,191
107,0,blank,0,295.620142857143,611.282242857143,809616,809806,190
107,0,blank,0,320.867071428571,631.395714285714,809806,810000,194
107,0,blank,0,327.427828571429,632.774014285714,810000,810195,195
107,56,++,413,100.676742857143,578.967642857143,810223,810419,196
107,0,blank,0,86.9352,626.9386,810419,810447,28
107,0,blank,0,-323,-105,810476,810528,52
107,0,blank,0,164.0082,-103.9187,810554,810579,25
107,0,blank,0,178.048585714286,614.749028571429,810643,810834,191
107,57,m1,417,180.398666666667,593.132833333333,810834,810918,84
107,57,multiply,415,110.482428571429,592.564557142857,810947,811145,198
107,0,blank,0,89.1931285714286,641.619,811145,811343,198
107,0,blank,0,-323,-105,811371,811511,140
107,0,blank,0,88.5322142857143,610.380728571429,811538,811723,185
107,57,multiply,415,88.14466,594.41166,811723,811866,143
107,0,blank,0,-323,-105,811895,812024,129
107,0,blank,0,58.2404,184.4592,812050,812076,26
107,0,blank,0,55.9124714285714,193.970371428571,812136,812323,187
107,0,blank,0,251.167271428571,403.479485714286,812351,812547,196
107,56,i,412,90.7652,569.0037,812576,812773,197
107,0,blank,0,81.4722285714286,602.999514285714,812773,812972,199
107,57,multiply,415,86.2479714285714,589.913585714286,812972,813168,196
107,0,blank,0,-323,-105,813196,813274,78
107,0,blank,0,26.9548,739.2186,813299,813325,26
107,0,blank,0,70.7171142857143,613.270685714286,813380,813565,185
107,58,},432,45.9377285714286,612.830257142857,813565,813763,198
107,0,blank,0,25.0572,632.588114285714,813763,813962,199
107,0,blank,0,48.7783,590.0904,813962,813990,28
107,0,blank,0,-323,-105,814021,814121,100
107,57,multiply,415,127.2813,584.0762,814145,814194,49
107,57,multiply,415,108.342425,602.6745,814364,814512,148
107,0,blank,0,-323,-105,814539,814618,79
107,0,blank,0,50.688,645.9605,814644,814669,25
107,0,blank,0,82.1959571428571,579.554414285714,814718,814902,184
107,56,i,412,85.9517428571429,578.143028571429,814902,815100,198
107,0,blank,0,108.6213,611.653414285714,815100,815296,196
107,0,blank,0,151.48194,645.1535,815296,815436,140
107,0,blank,0,301.163842857143,579.989814285714,815464,815657,193
107,0,blank,0,216.616142857143,551.691971428571,815657,815854,197
107,0,blank,0,163.872257142857,533.035285714286,815854,816048,194
107,0,blank,0,118.310871428571,540.303485714286,816048,816239,191
107,0,blank,0,122.219525,511.530925,816239,816352,113
107,0,blank,0,-323,-105,816380,816483,103
107,56,i,412,93.9335,577.9734,816508,816533,25
107,0,blank,0,98.87572,555.84482,816589,816715,126
107,0,blank,0,409.2434,714.294675,816772,816885,113
107,60,void,434,19.7023,654.292033333333,816913,817085,172
107,0,blank,0,57.1888428571429,671.055742857143,817085,817281,196
107,0,blank,0,119.328,671.795633333333,817281,817365,84
107,0,blank,0,-323,-105,817393,817521,128
107,60,print,435,85.7877714285714,650.492857142857,817596,817778,182
107,0,blank,0,29.2670142857143,689.240228571428,817778,817972,194
107,0,blank,0,86.4422857142857,686.381757142857,817972,818162,190
107,0,blank,0,88.57608,672.35096,818162,818304,142
107,0,blank,0,157.9512,535.6425,818386,818464,78
107,0,blank,0,-323,-105,818491,818570,79
107,0,blank,0,485.2838,-103.9807,818595,818621,26
107,0,blank,0,100.659857142857,530.141271428571,818770,818962,192
107,0,blank,0,130.783642857143,571.867357142857,818962,819159,197
107,0,blank,0,157.764728571429,577.822485714286,819159,819355,196
107,56,++,413,113.3471,580.6754,819355,819521,166
107,0,blank,0,-323,-105,819549,819627,78
107,0,blank,0,138.0836,632.6813,819652,819677,25
107,0,blank,0,159.375657142857,532.436471428572,819726,819908,182
107,0,blank,0,150.523228571429,545.151171428571,819908,820104,196
107,57,multiply,415,139.2748,603.0707,820104,820133,29
107,0,blank,0,-323,-105,820161,820334,173
107,0,blank,0,-323,-105,820334,820426,92
107,0,blank,0,-99.1356,654.157033333333,820576,820730,154
107,0,blank,0,-174.661042857143,741.016642857143,820758,820955,197
107,0,blank,0,-181.480385714286,728.257,820955,821153,198
107,0,blank,0,-185.627742857143,715.862571428571,821153,821346,193
107,0,blank,0,-323,-105,821403,821533,130
107,0,blank,0,-218.5915,698.9633,821559,821585,26
107,0,blank,0,-257.8308,671.7964,821636,821661,25
107,0,blank,0,216.382742857143,461.8681,821711,821905,194
107,53,multiply,390,141.704057142857,514.384957142857,821905,822104,199
107,0,blank,0,108.5638,539.609833333333,822104,822188,84
107,0,blank,0,-323,-105,822215,822291,76
107,57,m1,417,184.339871428571,589.174785714286,822472,822668,196
107,0,blank,0,176.93766,607.60086,822668,822809,141
107,0,blank,0,925.1756,385.95672,822865,823007,142
107,0,blank,0,-323,-105,823035,823219,184
107,0,blank,0,-323,-105,823219,823398,179
107,0,blank,0,-323,-105,823398,823582,184
107,0,blank,0,-323,-105,823582,823701,119
107,0,blank,0,213.2377,437.740085714286,823732,823928,196
107,0,blank,0,229.8467,441.2491,823928,823958,30
107,0,blank,0,512.035225,394.485575,823987,824132,145
107,0,blank,0,1035.542,380.4806,824162,824221,59
107,0,blank,0,995.402,392.6354,824330,824355,25
107,0,blank,0,-323,-105,824430,824556,126
107,0,blank,0,309.298,455.4786,824583,824608,25
107,0,blank,0,174.73752,573.80796,824808,824968,160
107,0,blank,0,-323,-105,825019,825207,188
107,0,blank,0,-323,-105,825207,825257,50
107,60,int,443,134.81465,662.9748,825437,825559,122
107,0,blank,0,-323,-105,825590,825661,71
107,0,blank,0,361.5284,697.3156,825686,825711,25
107,0,blank,0,345.63065,453.77335,825837,825912,75
107,0,blank,0,962.946,402.48685,826116,826191,75
107,53,m1,392,228.60725,513.38665,826297,826347,50
107,0,blank,0,-323,-105,826404,826504,100
107,0,blank,0,195.2772,527.4167,826545,826597,52
107,0,blank,0,188.7739,489.7244,826784,826809,25
107,0,blank,0,-20.3866,731.6249,826859,826934,75
107,0,blank,0,-323,-105,827009,827160,151
107,0,blank,0,272.6376,482.6771,827186,827211,25
107,0,blank,0,271.8929,517.2545,827286,827386,100
107,0,blank,0,242.688,475.356,827386,827540,154
107,0,blank,0,-323,-105,827665,827740,75
107,53,n1,394,272.6967,507.6334,827766,827791,25
107,0,blank,0,-323,-105,827815,827965,150
107,0,blank,0,955.1,428.371,827990,828016,26
107,0,blank,0,267.30985,545.2611,828315,828365,50
107,0,blank,0,-323,-105,828517,828695,178
107,0,blank,0,-323,-105,828695,828797,102
107,0,blank,0,-323,-105,829103,829300,197
107,0,blank,0,-323,-105,829300,829461,161
107,0,blank,0,-323,-105,829461,829633,172
107,0,blank,0,-323,-105,829633,829796,163
107,0,blank,0,-323,-105,829796,829958,162
107,0,blank,0,-323,-105,829958,830116,158
107,0,blank,0,-323,-105,830116,830248,132
107,0,blank,0,-323,-105,830248,830437,189
107,0,blank,0,-323,-105,830437,830564,127
107,0,blank,0,-323,-105,830564,830731,167
107,0,blank,0,-323,-105,830731,830913,182
107,0,blank,0,-323,-105,830913,831109,196
107,0,blank,0,-323,-105,831109,831272,163
107,0,blank,0,-323,-105,831272,831448,176
107,0,blank,0,-323,-105,831448,831583,135
107,0,blank,0,-323,-105,831583,831754,171
107,0,blank,0,-323,-105,831754,832301,547
107,0,blank,0,-323,-105,832301,832452,151
107,0,blank,0,-323,-105,832452,832686,234
107,0,blank,0,-323,-105,832686,832711,25
107,0,blank,0,-323,-105,832711,833042,331
107,0,blank,0,-323,-105,833042,833443,401
107,0,blank,0,-323,-105,833443,833626,183
107,0,blank,0,-323,-105,833626,833806,180
107,0,blank,0,-323,-105,833806,833885,79
107,0,blank,0,-323,-105,833885,834294,409
107,0,blank,0,-323,-105,834294,834373,79
107,0,blank,0,-323,-105,834373,834977,604
107,0,blank,0,-323,-105,834977,835154,177
107,0,blank,0,-323,-105,835154,835335,181
107,0,blank,0,-323,-105,835335,835590,255
107,0,blank,0,-323,-105,835590,835844,254
107,0,blank,0,-323,-105,835844,836098,254
107,0,blank,0,-323,-105,836098,836275,177
107,0,blank,0,-323,-105,836275,836311,36
107,0,blank,0,-323,-105,836311,836567,256
107,0,blank,0,-323,-105,836567,836821,254
107,0,blank,0,-323,-105,836821,836882,61
107,0,blank,0,-323,-105,836882,837225,343
107,0,blank,0,-323,-105,837225,837569,344
107,0,blank,0,-323,-105,837569,837716,147
107,0,blank,0,-323,-105,837716,837911,195
107,0,blank,0,-323,-105,837911,838153,242
107,0,blank,0,-323,-105,838153,838413,260
107,0,blank,0,-323,-105,838413,838823,410
107,0,blank,0,-323,-105,838823,839001,178
107,0,blank,0,-323,-105,839001,839195,194
107,0,blank,0,-323,-105,839195,839220,25
107,0,blank,0,-323,-105,839220,839443,223
107,0,blank,0,-323,-105,839443,839468,25
107,0,blank,0,-323,-105,839468,840027,559
107,0,blank,0,-323,-105,840027,840588,561
107,0,blank,0,-323,-105,840588,840765,177
107,0,blank,0,-323,-105,840765,840962,197
107,0,blank,0,-323,-105,840962,840987,25
107,0,blank,0,-323,-105,840987,841225,238
107,0,blank,0,-323,-105,841225,841249,24
107,0,blank,0,-323,-105,841249,841469,220
107,0,blank,0,-323,-105,841469,841614,145
107,0,blank,0,-323,-105,841614,841728,114
107,0,blank,0,-323,-105,841728,841843,115
107,0,blank,0,-323,-105,841843,841972,129
107,0,blank,0,-323,-105,841972,842090,118
107,0,blank,0,-323,-105,842090,842242,152
107,0,blank,0,-323,-105,842242,842414,172
107,0,blank,0,-323,-105,842414,842585,171
107,0,blank,0,-323,-105,842585,842745,160
107,0,blank,0,-323,-105,842745,842925,180
107,0,blank,0,-323,-105,842925,843060,135
107,0,blank,0,-323,-105,843060,843239,179
107,0,blank,0,-323,-105,843239,843413,174
107,0,blank,0,-323,-105,843413,843563,150
107,0,blank,0,-323,-105,843563,843789,226
107,0,blank,0,-323,-105,843789,843975,186
107,0,blank,0,-323,-105,843975,844164,189
107,0,blank,0,-323,-105,844164,844409,245
107,0,blank,0,-323,-105,844409,844439,30
107,0,blank,0,-323,-105,844439,844732,293
107,0,blank,0,-323,-105,844732,844768,36
107,0,blank,0,-323,-105,844768,844987,219
107,0,blank,0,-323,-105,844987,845168,181
107,0,blank,0,-323,-105,845168,845330,162
107,0,blank,0,-323,-105,845330,845519,189
107,0,blank,0,-323,-105,845519,845682,163
107,0,blank,0,-323,-105,845682,845933,251
107,0,blank,0,-323,-105,845933,846115,182
107,0,blank,0,-323,-105,846115,846265,150
107,0,blank,0,-323,-105,846265,846387,122
107,0,blank,0,-323,-105,846387,846591,204
107,0,blank,0,-323,-105,846591,846678,87
107,0,blank,0,-323,-105,846678,846965,287
107,0,blank,0,-323,-105,846965,847067,102
107,0,blank,0,-323,-105,847067,847177,110
108,0,blank,0,-323,-105,847766,847943,177
108,0,blank,0,-323,-105,847943,847974,31
108,0,blank,0,-323,-105,847974,848548,574
108,0,blank,0,-323,-105,848548,849115,567
108,0,blank,0,-323,-105,849115,849294,179
108,0,blank,0,-323,-105,849294,849391,97
108,0,blank,0,-323,-105,849391,849570,179
108,0,blank,0,-323,-105,849570,849706,136
108,0,blank,0,-323,-105,849706,849964,258
108,0,blank,0,-323,-105,849964,850222,258
108,0,blank,0,-323,-105,850222,850401,179
108,0,blank,0,-323,-105,850401,850441,40
108,0,blank,0,-323,-105,850441,850605,164
108,0,blank,0,-323,-105,850605,850687,82
108,0,blank,0,-323,-105,850687,850858,171
108,0,blank,0,-323,-105,850858,850899,41
108,0,blank,0,-323,-105,850899,851106,207
108,0,blank,0,-323,-105,851106,851613,507
108,0,blank,0,-323,-105,851613,851795,182
108,0,blank,0,-323,-105,851795,851920,125
108,0,blank,0,-323,-105,851920,852049,129
108,0,blank,0,-323,-105,852049,852445,396
108,0,blank,0,-323,-105,852445,852512,67
108,0,blank,0,-323,-105,852512,852707,195
108,0,blank,0,-323,-105,852707,852808,101
108,0,blank,0,-323,-105,852808,852941,133
108,0,blank,0,-323,-105,852941,853100,159
108,0,blank,0,-323,-105,853100,853293,193
108,0,blank,0,-323,-105,853293,853463,170
108,0,blank,0,-323,-105,853463,853592,129
108,0,blank,0,-323,-105,853592,853740,148
108,0,blank,0,-323,-105,853740,853892,152
108,0,blank,0,-323,-105,853892,854026,134
108,0,blank,0,-323,-105,854026,854222,196
108,0,blank,0,-323,-105,854222,854311,89
108,0,blank,0,-323,-105,854311,854546,235
108,0,blank,0,-323,-105,854546,854576,30
108,0,blank,0,-323,-105,854576,854821,245
108,0,blank,0,-323,-105,854821,854869,48
108,0,blank,0,-323,-105,854869,855139,270
108,0,blank,0,-323,-105,855139,855330,191
108,0,blank,0,-323,-105,855330,855496,166
108,0,blank,0,-323,-105,855496,855680,184
108,0,blank,0,-323,-105,855680,855837,157
108,0,blank,0,-323,-105,855837,856077,240
108,0,blank,0,-323,-105,856077,856102,25
108,0,blank,0,-323,-105,856102,856413,311
108,0,blank,0,-323,-105,856413,856582,169
108,0,blank,0,-323,-105,856582,856644,62
108,0,blank,0,-323,-105,856644,856810,166
108,0,blank,0,-323,-105,856810,856908,98
108,0,blank,0,-323,-105,856908,857040,132
108,0,blank,0,-323,-105,857040,857227,187
108,0,blank,0,-323,-105,857227,857406,179
108,0,blank,0,-323,-105,857406,857546,140
108,0,blank,0,-323,-105,857546,857663,117
108,0,blank,0,-323,-105,857663,858063,400
108,0,blank,0,-323,-105,858063,858261,198
108,0,blank,0,-323,-105,858261,858463,202
108,0,blank,0,-323,-105,858463,858666,203
108,0,blank,0,-323,-105,858666,858876,210
108,0,blank,0,-323,-105,858876,859060,184
108,0,blank,0,-323,-105,859060,859175,115
108,0,blank,0,-323,-105,859175,859274,99
108,0,blank,0,-323,-105,859274,859455,181
108,0,blank,0,-323,-105,859455,859716,261
108,0,blank,0,-323,-105,859716,859881,165
108,0,blank,0,-323,-105,859881,860060,179
108,0,blank,0,-323,-105,860060,860254,194
108,0,blank,0,-323,-105,860254,860284,30
108,0,blank,0,-323,-105,860284,860612,328
108,0,blank,0,-323,-105,860612,860643,31
108,0,blank,0,-323,-105,860643,860834,191
108,0,blank,0,-323,-105,860834,860996,162
108,0,blank,0,-323,-105,860996,861334,338
108,0,blank,0,-323,-105,861334,861431,97
108,0,blank,0,-323,-105,861431,861763,332
108,0,blank,0,-323,-105,861763,862155,392
108,0,blank,0,-323,-105,862155,862336,181
108,0,blank,0,-323,-105,862336,862529,193
