Frameno_fix,lineno_fix,Tokenname_fix,tokens_id,gaze_X_fix,gaze_Y_fix,timestamp_fix_start,timestamp_fix_end,time_duration
100,0,blank,0,-323,-105,4079,4275,196
100,0,blank,0,-323,-105,4275,4388,113
100,0,blank,0,-323,-105,4388,4564,176
100,1,SELECTION,6,246.3749,21.8182,4687,4723,36
100,0,blank,0,234.510666666667,-72.4389333333333,4763,4877,114
100,0,blank,0,344.87445,-11.2253,4918,4999,81
100,0,blank,0,343.407175,-15.885425,5038,5236,198
100,0,blank,0,335.686716666667,-9.87506666666667,5236,5425,189
100,0,blank,0,338.9751,-15.0055666666667,5425,5537,112
100,0,blank,0,76.3767666666667,-14.3734166666667,5563,5739,176
100,3,main,18,74.0085,57.63,5739,5768,29
100,0,blank,0,-323,-105,5798,5827,29
100,0,blank,0,447.1598,439.5496,5852,5878,26
100,0,blank,0,455.22835,289.06,5927,5977,50
100,0,blank,0,894.8636,-103.78292,6002,6157,155
100,0,blank,0,898.0395,-103.7622,6157,6247,90
100,0,blank,0,-323,-105,6312,6426,114
100,0,blank,0,269.877316666667,111.855383333333,6457,6635,178
100,0,blank,0,261.6221,112.836033333333,6635,6728,93
100,0,blank,0,315.84565,-13.81905,6758,6951,193
100,0,blank,0,312.3168,-5.19754,6951,7144,193
100,5,int,22,45.022475,106.625675,7271,7395,124
100,0,blank,0,182.7721,99.7757,7453,7478,25
100,0,blank,0,1036.56375,777.255075,7710,7842,132
100,0,blank,0,-323,-105,7944,8124,180
100,0,blank,0,-323,-105,8124,8303,179
100,0,blank,0,-323,-105,8303,8361,58
100,0,blank,0,-323,-105,8686,8846,160
100,8,scanf,42,82.68485,170.27185,8978,9093,115
100,8,scanf,42,54.07025,165.6256,9093,9234,141
100,0,blank,0,332.5913,-103.9359,9280,9368,88
100,0,blank,0,-323,-105,9503,9665,162
100,0,blank,0,-323,-105,9665,9783,118
100,0,blank,0,-323,-105,9783,9934,151
100,0,blank,0,-323,-105,9934,10495,561
100,0,blank,0,-323,-105,10495,10755,260
100,0,blank,0,-323,-105,10755,10862,107
100,7,"Enterthevalueofn\n",39,128.513625,139.09525,11165,11301,136
100,0,blank,0,-323,-105,11576,11733,157
100,5,int,22,69.5305333333333,96.2983666666667,11763,11843,80
100,0,blank,0,247.366816666667,126.748416666667,11873,12058,185
100,0,blank,0,261.40245,131.021083333333,12058,12243,185
100,7,"Enterthevalueofn\n",39,292.04165,142.282816666667,12243,12425,182
100,8,scanf,42,89.4742666666667,163.480283333333,12455,12635,180
100,8,scanf,42,66.9576,159.581883333333,12635,12815,180
100,7,printf,37,80.08195,152.435016666667,12815,12997,182
100,0,blank,0,127.841116666667,156.407133333333,12997,13178,181
100,8,"%d",44,109.400666666667,160.396883333333,13178,13357,179
100,0,blank,0,-323,-105,13387,13468,81
100,7,"Enterthevalueofn\n",39,117.2451,146.918,13494,13522,28
100,8,scanf,42,78.1057666666667,169.434966666667,13589,13761,172
100,8,scanf,42,71.1587,176.4398,13761,13791,30
100,9,"Entertheelementsonebyone\n",52,245.97845,187.284283333333,13822,14003,181
100,9,"Entertheelementsonebyone\n",52,356.103866666667,190.343266666667,14003,14186,183
100,9,"Entertheelementsonebyone\n",52,328.24425,184.12295,14186,14364,178
100,0,blank,0,307.424816666667,171.873433333333,14364,14542,178
100,9,printf,50,94.4587666666667,199.662333333333,14572,14750,178
100,9,"Entertheelementsonebyone\n",52,128.054016666667,197.253783333333,14750,14928,178
100,9,"Entertheelementsonebyone\n",52,172.644683333333,192.339033333333,14928,15107,179
100,0,blank,0,137.7582,230.188683333333,15107,15284,177
100,0,blank,0,129.035283333333,238.499516666667,15284,15461,177
100,12,array,74,223.734133333333,246.642333333333,15461,15642,181
100,0,blank,0,217.6303,236.106483333333,15642,15823,181
100,0,blank,0,196.5181,241.454683333333,15823,16004,181
100,0,blank,0,91.5223,234.0285,16004,16185,181
100,0,blank,0,85.9922666666667,241.297883333333,16185,16367,182
100,0,blank,0,56.9139166666667,264.2861,16367,16549,182
100,0,blank,0,107.2331,276.416016666667,16549,16739,190
100,12,"%d",71,146.093633333333,256.4592,16739,16926,187
100,0,blank,0,184.585483333333,233.57625,16926,17115,189
100,10,;,64,217.9537,220.57195,17115,17291,176
100,10,;,64,221.7387,216.8151,17291,17379,88
100,0,blank,0,-323,-105,17653,17833,180
100,0,blank,0,-323,-105,17833,18030,197
100,0,blank,0,-323,-105,18030,18205,175
100,0,blank,0,-323,-105,18205,18382,177
100,0,blank,0,-323,-105,18382,18558,176
100,0,blank,0,-323,-105,18558,18727,169
100,0,blank,0,-323,-105,18727,18901,174
100,0,blank,0,-323,-105,18901,18948,47
100,0,blank,0,-323,-105,18948,19134,186
100,0,blank,0,-323,-105,19134,19316,182
100,0,blank,0,-323,-105,19316,19495,179
100,0,blank,0,-323,-105,19495,19680,185
100,0,blank,0,-323,-105,19680,19842,162
100,0,blank,0,-323,-105,19842,20028,186
100,0,blank,0,-323,-105,20028,20210,182
100,0,blank,0,-323,-105,20210,20394,184
100,0,blank,0,-323,-105,20394,20562,168
100,0,blank,0,-323,-105,20562,20750,188
100,0,blank,0,-323,-105,20750,20949,199
100,0,blank,0,-323,-105,20949,21126,177
100,0,blank,0,-323,-105,21126,21301,175
100,0,blank,0,-323,-105,21301,21476,175
100,0,blank,0,-323,-105,21476,21653,177
100,0,blank,0,-323,-105,21653,21834,181
100,0,blank,0,-323,-105,21834,22014,180
100,0,blank,0,-323,-105,22014,22193,179
100,0,blank,0,-323,-105,22193,22373,180
100,0,blank,0,-323,-105,22373,22556,183
100,0,blank,0,-323,-105,22556,22736,180
100,0,blank,0,-323,-105,22736,22915,179
100,0,blank,0,-323,-105,22915,23090,175
100,0,blank,0,-323,-105,23090,23267,177
100,0,blank,0,-323,-105,23267,23445,178
100,0,blank,0,-323,-105,23445,23623,178
100,0,blank,0,-323,-105,23623,23712,89
100,0,blank,0,-323,-105,23712,23947,235
100,0,blank,0,-323,-105,23947,23977,30
100,0,blank,0,-323,-105,23977,24158,181
100,0,blank,0,-323,-105,24158,24220,62
100,0,blank,0,-323,-105,24220,24398,178
100,0,blank,0,-323,-105,24398,24575,177
100,0,blank,0,-323,-105,24575,24729,154
100,0,blank,0,-323,-105,24729,24913,184
100,0,blank,0,-323,-105,24913,25090,177
100,0,blank,0,-323,-105,25090,25272,182
100,0,blank,0,-323,-105,25272,25417,145
100,0,blank,0,-323,-105,25417,25525,108
100,0,blank,0,-323,-105,25525,25720,195
100,0,blank,0,-323,-105,25720,25899,179
100,0,blank,0,-323,-105,25899,26081,182
100,0,blank,0,-323,-105,26081,26222,141
100,0,blank,0,-323,-105,26222,26407,185
100,0,blank,0,-323,-105,26407,26548,141
100,0,blank,0,-323,-105,26548,26626,78
100,0,blank,0,-323,-105,26626,26795,169
100,0,blank,0,-323,-105,26795,27131,336
100,0,blank,0,-323,-105,27131,27447,316
100,0,blank,0,-323,-105,27447,27552,105
100,0,blank,0,139.106566666667,339.929666666667,27643,27749,106
100,0,blank,0,265.33974,284.29058,27784,27980,196
100,15,i,96,246.834975,329.351975,27980,28136,156
100,0,blank,0,81.0473,386.70275,28175,28350,175
100,0,blank,0,199.855416666667,390.432116666667,28350,28525,175
100,0,blank,0,186.339383333333,393.008716666667,28525,28700,175
100,0,blank,0,170.693883333333,394.943066666667,28700,28873,173
100,19,Selection,113,118.412783333333,401.481283333333,28873,29047,174
100,0,blank,0,77.29485,398.838933333333,29047,29223,176
100,19,Selection,113,95.8478,408.265133333333,29223,29398,175
100,20,exchange,118,123.439483333333,421.863533333333,29398,29576,178
100,19,Selection,113,126.13465,417.226766666667,29576,29755,179
100,0,blank,0,76.263875,408.357625,29755,29874,119
100,0,blank,0,-323,-105,29903,29934,31
100,19,Selection,113,94.9571833333333,403.376,30034,30206,172
100,19,Selection,113,121.1103,408.767933333333,30206,30384,178
100,19,Selection,113,158.511616666667,416.4782,30384,30561,177
100,19,Selection,113,165.4753,409.377533333333,30561,30736,175
100,0,blank,0,180.9236,410.184,30736,30765,29
100,0,blank,0,1032.273,512.626166666667,30823,31001,178
100,0,blank,0,-323,-105,31030,31210,180
100,20,),123,218.7925,436.4849,31347,31405,58
100,0,blank,0,-323,-105,31466,31656,190
100,0,blank,0,-323,-105,31656,31837,181
100,0,blank,0,-323,-105,31837,32030,193
100,0,blank,0,-323,-105,32030,32213,183
100,0,blank,0,-323,-105,32213,32394,181
100,0,blank,0,-323,-105,32394,32574,180
100,0,blank,0,-323,-105,32574,32735,161
100,0,blank,0,-323,-105,32735,32933,198
100,0,blank,0,-323,-105,32933,33116,183
100,0,blank,0,-323,-105,33116,33310,194
100,0,blank,0,-323,-105,33310,33466,156
100,0,blank,0,-323,-105,33466,33652,186
100,0,blank,0,-323,-105,33652,33831,179
100,0,blank,0,-323,-105,33831,34030,199
100,0,blank,0,-323,-105,34030,34206,176
100,0,blank,0,-323,-105,34206,34369,163
100,0,blank,0,-323,-105,34369,34578,209
100,0,blank,0,-323,-105,34578,34762,184
100,0,blank,0,-323,-105,34762,34938,176
100,0,blank,0,-323,-105,34938,35125,187
100,0,blank,0,-323,-105,35125,35307,182
100,0,blank,0,-323,-105,35307,35505,198
100,0,blank,0,-323,-105,35505,35665,160
100,0,blank,0,-323,-105,35665,35837,172
100,0,blank,0,-323,-105,35837,36012,175
100,0,blank,0,-323,-105,36012,36127,115
100,0,blank,0,-323,-105,36127,36309,182
100,0,blank,0,-323,-105,36309,36496,187
100,0,blank,0,-323,-105,36496,36666,170
100,0,blank,0,-323,-105,36666,36868,202
100,0,blank,0,-323,-105,36868,37056,188
100,0,blank,0,-323,-105,37056,37235,179
100,0,blank,0,-323,-105,37235,37414,179
100,0,blank,0,-323,-105,37414,37611,197
100,0,blank,0,-323,-105,37611,37778,167
100,0,blank,0,-323,-105,37778,37952,174
100,0,blank,0,-323,-105,37952,38133,181
100,0,blank,0,-323,-105,38133,38192,59
100,0,blank,0,-323,-105,38192,38347,155
100,0,blank,0,-323,-105,38347,38508,161
100,0,blank,0,-323,-105,38508,38677,169
100,0,blank,0,-323,-105,38677,38855,178
100,0,blank,0,-323,-105,38855,39029,174
100,0,blank,0,-323,-105,39029,39204,175
100,0,blank,0,-323,-105,39204,39381,177
100,0,blank,0,-323,-105,39381,39454,73
100,0,blank,0,-323,-105,39454,39712,258
100,0,blank,0,-323,-105,39712,39966,254
100,0,blank,0,-323,-105,39966,40220,254
100,0,blank,0,-323,-105,40220,40399,179
100,0,blank,0,-323,-105,40399,40484,85
100,0,blank,0,-323,-105,40484,40647,163
100,0,blank,0,-323,-105,40647,40845,198
100,0,blank,0,-323,-105,40845,41028,183
100,0,blank,0,-323,-105,41028,41180,152
100,0,blank,0,-323,-105,41180,41323,143
100,0,blank,0,-323,-105,41323,41521,198
100,0,blank,0,-323,-105,41521,41633,112
100,0,blank,0,-323,-105,41633,41794,161
100,0,blank,0,-323,-105,41794,41955,161
100,0,blank,0,-323,-105,41955,42139,184
100,0,blank,0,-323,-105,42139,42237,98
100,0,blank,0,-323,-105,42237,42421,184
100,0,blank,0,-323,-105,42421,42585,164
100,0,blank,0,-323,-105,42585,42773,188
100,0,blank,0,-323,-105,42773,42967,194
100,0,blank,0,-323,-105,42967,43148,181
100,0,blank,0,-323,-105,43148,43331,183
100,0,blank,0,-323,-105,43331,43505,174
100,0,blank,0,-323,-105,43505,43680,175
100,0,blank,0,-323,-105,43680,43705,25
100,0,blank,0,-323,-105,43705,43882,177
100,0,blank,0,-323,-105,43882,44051,169
100,0,blank,0,-323,-105,44051,44249,198
100,0,blank,0,-323,-105,44249,44424,175
100,0,blank,0,-323,-105,44424,44623,199
100,0,blank,0,-323,-105,44623,44801,178
100,0,blank,0,-323,-105,44801,44980,179
100,0,blank,0,-323,-105,44980,45104,124
100,0,blank,0,-323,-105,45104,45218,114
100,0,blank,0,-323,-105,45218,45350,132
100,0,blank,0,-323,-105,45350,45477,127
100,0,blank,0,-323,-105,45477,45651,174
100,0,blank,0,-323,-105,45651,45843,192
100,0,blank,0,-323,-105,45843,45909,66
100,0,blank,0,-323,-105,45909,46080,171
100,0,blank,0,-323,-105,46080,46139,59
100,0,blank,0,-323,-105,46139,46330,191
100,0,blank,0,-323,-105,46330,46523,193
100,0,blank,0,-323,-105,46523,46699,176
100,0,blank,0,-323,-105,46699,46895,196
100,0,blank,0,-323,-105,46895,47009,114
100,0,blank,0,-323,-105,47009,47105,96
100,0,blank,0,-323,-105,47105,47289,184
100,0,blank,0,-323,-105,47289,47473,184
100,0,blank,0,-323,-105,47473,47663,190
101,0,blank,0,-323,-105,49437,49629,192
101,0,blank,0,-323,-105,49629,49772,143
101,0,blank,0,-323,-105,49772,49970,198
101,0,blank,0,-323,-105,49970,50066,96
101,0,blank,0,-323,-105,50066,50236,170
101,0,blank,0,-323,-105,50236,50486,250
101,0,blank,0,-323,-105,50486,50510,24
101,0,blank,0,-323,-105,50510,50735,225
101,0,blank,0,-323,-105,50735,50910,175
101,0,blank,0,-323,-105,50910,51085,175
101,0,blank,0,-323,-105,51085,51257,172
102,0,blank,0,-323,-105,51681,51880,199
102,0,blank,0,-323,-105,51880,52069,189
102,0,blank,0,-323,-105,52069,52156,87
102,0,blank,0,-323,-105,52156,52385,229
102,0,blank,0,-323,-105,52385,52528,143
102,0,blank,0,-323,-105,52528,52617,89
102,0,blank,0,-323,-105,52617,52783,166
102,0,blank,0,-323,-105,52783,52915,132
102,0,blank,0,-323,-105,52915,53169,254
102,0,blank,0,-323,-105,53169,53419,250
102,0,blank,0,-323,-105,53419,53596,177
102,0,blank,0,-323,-105,53596,53788,192
102,0,blank,0,-323,-105,53788,53941,153
102,0,blank,0,-323,-105,53941,54078,137
102,0,blank,0,-323,-105,54078,54194,116
102,0,blank,0,-323,-105,54194,54306,112
102,0,blank,0,-323,-105,54306,54474,168
102,0,blank,0,-323,-105,54474,54609,135
102,0,blank,0,-323,-105,54609,54766,157
102,0,blank,0,-323,-105,54766,54915,149
102,0,blank,0,-323,-105,54915,55054,139
102,0,blank,0,-323,-105,55054,55188,134
102,0,blank,0,-323,-105,55188,55357,169
102,0,blank,0,-323,-105,55357,55499,142
102,0,blank,0,-323,-105,55499,55716,217
102,0,blank,0,-323,-105,55716,55904,188
102,0,blank,0,-323,-105,55904,56109,205
102,0,blank,0,-323,-105,56109,56278,169
102,0,blank,0,-323,-105,56278,56464,186
102,0,blank,0,-323,-105,56464,56730,266
102,0,blank,0,-323,-105,56730,56882,152
102,0,blank,0,-323,-105,56882,56952,70
102,0,blank,0,-323,-105,56952,57124,172
102,0,blank,0,-323,-105,57124,57307,183
102,0,blank,0,-323,-105,57307,57467,160
102,0,blank,0,-323,-105,57467,57649,182
102,0,blank,0,-323,-105,57649,57827,178
102,0,blank,0,-323,-105,57827,58003,176
102,0,blank,0,-323,-105,58003,58177,174
102,0,blank,0,-323,-105,58177,58287,110
102,0,blank,0,-323,-105,58287,58382,95
102,0,blank,0,-323,-105,58382,58708,326
102,0,blank,0,270.2596,416.3608,58958,58989,31
102,0,blank,0,-323,-105,59104,59173,69
102,0,blank,0,277.921,411.21595,59274,59437,163
102,0,blank,0,273.932075,420.5978,59437,59615,178
102,40,int,234,267.1383,451.2574,59615,59662,47
102,0,blank,0,-323,-105,59769,59963,194
102,0,blank,0,-323,-105,59963,60160,197
102,0,blank,0,-323,-105,60160,60339,179
102,0,blank,0,-323,-105,60339,60520,181
102,0,blank,0,-323,-105,60520,60703,183
102,0,blank,0,-323,-105,60703,60875,172
102,0,blank,0,-323,-105,60875,61196,321
102,0,blank,0,-323,-105,61196,61401,205
102,0,blank,0,-323,-105,61401,61463,62
102,0,blank,0,-323,-105,61561,62673,1112
102,0,blank,0,-323,-105,62673,62788,115
102,0,blank,0,-323,-105,62788,62946,158
102,0,blank,0,-323,-105,62946,63102,156
102,0,blank,0,-323,-105,63102,63293,191
102,0,blank,0,-323,-105,63293,63419,126
102,0,blank,0,-323,-105,63419,63600,181
102,0,blank,0,-323,-105,63600,63699,99
102,0,blank,0,23.0428,-105.0048,64845,65025,180
102,0,blank,0,21.2706,-85.93985,65025,65165,140
102,0,blank,0,27.5135,-36.6768,65226,65370,144
102,0,blank,0,-323,-105,65571,65685,114
102,0,blank,0,-323,-105,65685,66116,431
102,0,blank,0,-323,-105,66116,66298,182
102,0,blank,0,-323,-105,66298,66469,171
102,0,blank,0,-323,-105,66469,66625,156
102,0,blank,0,-323,-105,66625,66790,165
102,0,blank,0,-323,-105,66790,66940,150
102,0,blank,0,-323,-105,66940,67027,87
102,0,blank,0,-323,-105,67027,67145,118
102,0,blank,0,-323,-105,67145,67679,534
102,0,blank,0,-323,-105,67679,67795,116
102,0,blank,0,148.132466666667,469.595,67820,68011,191
102,0,blank,0,162.940766666667,480.783766666667,68011,68108,97
102,0,blank,0,174.9697,434.8557,68108,68396,288
102,0,blank,0,173.7806,429.2692,68396,68438,42
102,0,blank,0,-323,-105,68465,68574,109
102,0,blank,0,216.3889,420.93758,68767,68966,199
102,40,int,234,159.148775,448.1929,68966,69148,182
102,0,blank,0,157.762675,436.97915,69148,69328,180
102,0,blank,0,213.455825,424.0453,69372,69543,171
102,0,blank,0,167.628433333333,426.05295,69543,69742,199
102,0,blank,0,149.92315,422.71345,69742,69803,61
102,0,blank,0,-323,-105,69834,69940,106
102,0,blank,0,233.3113,421.4867,69981,70034,53
102,0,blank,0,239.36545,412.757183333333,70102,70280,178
102,0,blank,0,241.655116666667,419.368733333333,70280,70470,190
102,0,blank,0,244.037033333333,420.482,70470,70657,187
102,0,blank,0,201.963166666667,441.834783333333,70657,70851,194
102,0,blank,0,188.439083333333,442.406433333333,70851,71045,194
102,0,blank,0,160.728716666667,438.13645,71045,71242,197
102,0,blank,0,167.87975,435.2376,71242,71435,193
102,0,blank,0,185.686666666667,431.962683333333,71435,71623,188
102,0,blank,0,188.835933333333,431.017516666667,71623,71811,188
102,0,blank,0,178.750633333333,441.8356,71811,71998,187
102,40,int,234,165.1973,448.6338,71998,72033,35
102,0,blank,0,-323,-105,72065,72239,174
102,40,int,234,143.902233333333,448.40085,72354,72546,192
102,40,exchange,226,123.1671,445.94195,72546,72735,189
102,40,exchange,226,117.649666666667,454.135733333333,72735,72918,183
102,40,exchange,226,81.2294833333333,446.1618,72918,73098,180
102,40,exchange,226,67.9037,458.089283333333,73098,73280,182
102,40,exchange,226,61.6763,465.2316,73280,73312,32
102,0,blank,0,178.284966666667,436.890483333333,73342,73528,186
102,0,blank,0,178.7365,436.75645,73528,73590,62
102,0,blank,0,-323,-105,73621,73781,160
102,43,k,249,137.5412,513.1419,73806,73832,26
102,40,(,227,138.203985714286,457.397471428571,73888,74087,199
102,0,blank,0,185.239866666667,436.456633333333,74087,74276,189
102,0,blank,0,190.180883333333,433.319033333333,74276,74466,190
102,0,blank,0,188.8515,431.505366666667,74466,74652,186
102,40,10,231,212.1908,459.1345,74652,74683,31
102,0,blank,0,-323,-105,74714,74796,82
102,0,blank,0,232.0912,421.8174,74821,74852,31
102,0,blank,0,232.650783333333,426.046416666667,74919,75097,178
102,0,blank,0,171.591783333333,426.206083333333,75097,75286,189
102,0,blank,0,183.713716666667,423.0143,75286,75474,188
102,40,exchange,226,94.5473333333333,458.073116666667,75474,75660,186
102,0,blank,0,126.225833333333,469.713866666667,75660,75847,187
102,0,blank,0,150.5507,478.3026,75847,75878,31
102,0,blank,0,-323,-105,75941,75991,50
102,43,1,253,223.9888,526.5815,76017,76043,26
102,0,blank,0,175.84885,475.687616666667,76096,76284,188
102,0,blank,0,199.004766666667,423.732116666667,76284,76471,187
102,0,blank,0,183.434466666667,429.7995,76471,76659,188
102,40,exchange,226,130.502116666667,463.6819,76721,76914,193
102,0,blank,0,111.145733333333,489.319966666667,76914,77010,96
102,0,blank,0,-323,-105,77046,77127,81
102,0,blank,0,187.0287,545.1199,77153,77179,26
102,40,int,234,149.8141,456.62684,77234,77406,172
102,0,blank,0,197.56854,426.89264,77406,77595,189
102,0,blank,0,194.905566666667,430.1812,77595,77784,189
102,0,blank,0,175.085583333333,437.742083333333,77784,77980,196
102,0,blank,0,166.46285,444.5954,77980,78108,128
102,0,blank,0,45.50715,443.9761,78138,78325,187
102,40,exchange,226,53.7395,448.1769,78325,78356,31
102,0,blank,0,189.51416,428.51488,78387,78545,158
102,0,blank,0,247.9826,426.8303,78545,78685,140
102,40,],232,224.3258,458.7681,78894,78921,27
102,0,blank,0,228.968833333333,440.14145,79009,79189,180
102,0,blank,0,63.0509833333333,318.5032,79220,79411,191
102,0,blank,0,67.8607,310.7195,79411,79442,31
102,0,blank,0,121.06545,477.637,79473,79660,187
102,0,blank,0,117.84315,487.82425,79660,79788,128
102,0,blank,0,89.6180333333333,599.374233333333,79819,80014,195
102,0,blank,0,120.716633333333,537.654816666667,80014,80203,189
102,42,comma,242,134.8589,504.3705,80203,80234,31
102,0,blank,0,205.302166666667,431.2963,80267,80457,190
102,0,blank,0,217.552666666667,425.1043,80457,80552,95
102,31,j,196,167.9755,264.322,80583,80751,168
102,31,j,196,165.0716,264.2056,80751,80786,35
102,0,blank,0,-323,-105,80817,80903,86
102,38,max,221,130.3312,417.9656,80930,80959,29
102,0,blank,0,137.824683333333,425.940783333333,81028,81210,182
102,0,blank,0,201.718833333333,431.136133333333,81210,81404,194
102,0,blank,0,206.821116666667,421.05835,81404,81595,191
102,0,blank,0,209.2666,431.264966666667,81595,81690,95
102,0,blank,0,89.6051666666667,480.36635,81721,81919,198
102,0,blank,0,169.1627,478.903166666667,81919,82110,191
102,0,blank,0,-323,-105,82141,82264,123
102,0,blank,0,112.673783333333,472.780216666667,82292,82474,182
102,0,blank,0,121.74535,467.5248,82474,82603,129
102,0,blank,0,-323,-105,82634,82744,110
102,42,temp,239,104.6995,501.6993,82781,82832,51
102,42,temp,239,105.738633333333,491.963033333333,82902,83092,190
102,42,temp,239,107.01625,493.935383333333,83092,83289,197
102,0,blank,0,130.83735,485.577216666667,83289,83482,193
102,0,blank,0,160.07995,482.058383333333,83482,83667,185
102,42,comma,242,137.236916666667,491.973633333333,83667,83857,190
102,42,comma,242,140.946283333333,501.68275,83857,84042,185
102,0,blank,0,-323,-105,84072,84103,31
102,0,blank,0,217.6681,701.0923,84129,84155,26
102,0,blank,0,-323,-105,84193,84385,192
102,0,blank,0,-323,-105,84385,84539,154
102,0,blank,0,-323,-105,84539,84712,173
102,0,blank,0,80.2177,610.89484,84750,84939,189
102,0,blank,0,77.600025,512.9259,84939,85128,189
102,0,blank,0,130.972233333333,553.460133333333,85128,85311,183
102,45,=,260,124.695233333333,556.454566666667,85311,85493,182
102,0,blank,0,75.29256,553.94062,85493,85646,153
102,0,blank,0,-323,-105,85677,85733,56
102,0,blank,0,128.567116666667,542.8243,85842,86018,176
102,45,findmax,261,181.774216666667,556.283766666667,86018,86206,188
102,0,blank,0,177.90555,554.501,86206,86394,188
102,45,=,260,128.339383333333,561.4257,86394,86579,185
102,45,big,259,88.0914333333333,563.279233333333,86579,86673,94
102,0,blank,0,96.8082333333333,210.617966666667,86736,86921,185
102,27,function,158,96.19525,166.37985,86921,87107,186
102,27,function,158,95.6043833333333,167.983816666667,87107,87294,187
102,28,findmax,167,96.4795166666667,189.229266666667,87294,87480,186
102,0,blank,0,99.01455,209.2176,87480,87541,61
102,0,blank,0,-323,-105,87572,87715,143
102,45,findmax,261,151.463616666667,573.64735,87746,87918,172
102,45,=,260,131.4075,573.001383333333,87918,88102,184
102,45,findmax,261,166.380983333333,559.496183333333,88102,88287,185
102,45,findmax,261,195.26755,555.562233333333,88287,88474,187
102,45,findmax,261,196.02635,556.03295,88474,88659,185
102,45,big,259,106.090616666667,562.45925,88659,88845,186
102,45,big,259,86.01255,564.39735,88845,89031,186
102,0,blank,0,94.4860166666667,577.1828,89031,89218,187
102,45,findmax,261,164.5335,575.367266666667,89218,89407,189
102,45,findmax,261,163.8054,573.421,89407,89532,125
102,0,blank,0,-323,-105,89564,89595,31
102,45,findmax,261,156.297233333333,575.358716666667,89645,89816,171
102,45,findmax,261,177.1926,559.61505,89816,90004,188
102,45,findmax,261,156.973733333333,567.161316666667,90004,90190,186
102,0,blank,0,79.8666333333333,584.246433333333,90190,90376,186
102,0,blank,0,149.31955,550.962483333333,90376,90558,182
102,45,findmax,261,190.43645,555.482633333333,90558,90743,185
102,45,findmax,261,202.01495,566.424633333333,90743,90927,184
102,45,findmax,261,199.508516666667,568.252516666667,90927,91110,183
102,45,findmax,261,203.66625,557.077683333333,91110,91295,185
102,45,findmax,261,202.318783333333,556.364266666667,91295,91480,185
102,42,big,241,168.134783333333,496.206416666667,91480,91665,185
102,0,blank,0,160.529966666667,480.324033333333,91665,91851,186
102,0,blank,0,170.003383333333,443.64195,91851,92037,186
102,0,blank,0,177.021566666667,442.336,92037,92223,186
102,0,blank,0,200.061466666667,477.307866666667,92223,92409,186
102,0,blank,0,213.271883333333,533.399483333333,92409,92595,186
102,45,(,262,222.0046,555.4784,92595,92785,190
102,45,b,263,229.9248,566.1896,92785,92816,31
102,0,blank,0,-323,-105,92846,92902,56
102,0,blank,0,173.3814,525.1503,92927,92953,26
102,42,comma,242,135.667016666667,499.76045,93006,93179,173
102,42,temp,239,107.1673,507.448375,93179,93303,124
102,0,blank,0,-323,-105,93335,93467,132
102,0,blank,0,152.828783333333,504.122833333333,93492,93664,172
102,0,blank,0,151.47695,508.867166666667,93664,93848,184
102,42,big,241,160.043333333333,500.770433333333,93848,94034,186
102,0,blank,0,195.588033333333,508.950116666667,94034,94216,182
102,42,comma,242,191.710483333333,499.140833333333,94216,94401,185
102,0,blank,0,175.93965,512.4788,94401,94585,184
102,0,blank,0,179.465566666667,513.33245,94585,94769,184
102,42,;,244,220.5273,506.740316666667,94769,94953,184
102,43,1,253,213.2285,513.3577,94953,95015,62
102,0,blank,0,-323,-105,95077,95178,101
102,0,blank,0,212.596533333333,510.643816666667,95203,95373,170
102,0,blank,0,181.517566666667,512.13975,95373,95561,188
102,42,temp,239,121.8717,505.522633333333,95561,95750,189
102,45,findmax,261,151.9627,555.781266666667,95750,95937,187
102,45,findmax,261,176.917333333333,566.099366666667,95937,96124,187
102,0,blank,0,229.311583333333,509.1443,96124,96308,184
102,42,big,241,177.41825,506.439133333333,96308,96496,188
102,42,comma,242,140.373166666667,505.592733333333,96496,96684,188
102,42,comma,242,136.998325,505.058675,96684,96808,124
102,0,blank,0,-323,-105,96871,96974,103
102,42,temp,239,113.412183333333,498.33685,97072,97249,177
102,42,temp,239,115.42745,497.986233333333,97249,97437,188
102,42,temp,239,112.50495,502.190566666667,97437,97625,188
102,0,blank,0,86.5800166666667,499.688233333333,97625,97812,187
102,0,blank,0,82.6712166666667,495.2867,97812,97999,187
102,0,blank,0,143.980533333333,482.69465,97999,98185,186
102,42,temp,239,132.140216666667,494.90705,98185,98369,184
102,42,temp,239,127.233766666667,498.9043,98369,98463,94
102,0,blank,0,-323,-105,98494,98575,81
102,42,comma,242,188.2082,493.3509,98601,98626,25
102,0,blank,0,181.625466666667,510.037583333333,98690,98868,178
102,0,blank,0,187.041725,510.031225,98868,99018,150
102,42,big,241,164.9891,500.7419,99018,99130,112
102,42,big,241,156.2049,503.5775,99130,99219,89
102,0,blank,0,182.041033333333,511.496783333333,99378,99572,194
102,42,big,241,182.795783333333,509.052483333333,99572,99758,186
102,42,big,241,165.1437,506.485266666667,99758,99939,181
102,43,=,248,123.635933333333,516.955466666667,99939,100120,181
102,0,blank,0,106.56744,523.76118,100120,100273,153
102,0,blank,0,-323,-105,100335,100364,29
102,0,blank,0,-323,-105,100443,100625,182
102,0,blank,0,-323,-105,100625,100655,30
102,42,temp,239,130.722883333333,502.13855,100685,100862,177
102,0,blank,0,160.8386,478.08565,100862,101052,190
102,0,blank,0,165.8633,472.075683333333,101052,101241,189
102,0,blank,0,192.852716666667,536.988416666667,101241,101429,188
102,0,blank,0,195.417633333333,543.314016666667,101429,101617,188
102,45,=,260,126.2899,564.46945,101617,101805,188
102,0,blank,0,134.671283333333,573.28105,101805,101994,189
102,45,findmax,261,148.447733333333,560.6902,101994,102180,186
102,0,blank,0,110.07845,480.139683333333,102180,102369,189
102,42,temp,239,133.584816666667,499.927966666667,102369,102556,187
102,0,blank,0,-323,-105,102588,102731,143
102,42,big,241,183.85238,498.49672,102760,102931,171
102,0,blank,0,222.85825,434.96495,102931,103116,185
102,0,blank,0,233.539616666667,440.16125,103116,103301,185
102,0,blank,0,249.08424,442.93576,103301,103454,153
102,0,blank,0,120.942316666667,510.619266666667,103484,103669,185
102,43,j,255,169.84795,514.15165,103669,103854,185
102,0,blank,0,173.160833333333,515.386016666667,103854,104038,184
102,42,big,241,179.342066666667,506.902966666667,104038,104130,92
102,0,blank,0,-323,-105,104161,104294,133
102,0,blank,0,153.770583333333,470.7053,104318,104491,173
102,43,>=,252,198.161933333333,518.952766666667,104491,104585,94
102,31,=,189,121.083533333333,267.093283333333,104617,104802,185
102,0,blank,0,121.1069,273.37485,104802,104862,60
102,0,blank,0,-323,-105,104893,105058,165
102,0,blank,0,144.4926,333.251233333333,105100,105276,176
102,0,blank,0,159.1204,286.8454,105276,105340,64
102,42,temp,239,133.0869,508.935816666667,105368,105552,184
102,43,k,249,133.154216666667,515.085216666667,105552,105735,183
102,0,blank,0,127.5242,513.7392,105735,105764,29
102,36,},217,89.54428,359.1841,105796,105949,153
102,27,function,158,71.99455,160.981383333333,105980,106162,182
102,0,blank,0,121.723033333333,149.06145,106162,106344,182
102,0,blank,0,168.613883333333,158.22585,106344,106526,182
102,0,blank,0,105.7981,207.669966666667,106526,106709,183
102,0,blank,0,105.706383333333,214.585916666667,106709,106893,184
102,0,blank,0,113.17815,209.65495,106893,106954,61
102,0,blank,0,-323,-105,106985,107016,31
102,28,int,175,153.2014,193.891928571429,107066,107261,195
102,0,blank,0,91.0218833333333,205.588416666667,107261,107442,181
102,0,blank,0,90.0513666666667,214.442116666667,107442,107622,180
102,0,blank,0,121.8587,213.4681,107622,107772,150
102,0,blank,0,-323,-105,107803,107884,81
102,28,int,175,152.9047,198.5452,107909,107936,27
102,28,int,175,152.598033333333,201.845833333333,108001,108173,172
102,0,blank,0,147.6519,214.3645,108173,108203,30
102,0,blank,0,-323,-105,108234,108339,105
102,0,blank,0,144.2165,218.2131,108365,108393,28
102,0,blank,0,151.0064,212.517316666667,108458,108633,175
102,0,blank,0,121.359016666667,223.377,108633,108827,194
102,0,blank,0,-323,-105,109352,109530,178
102,0,blank,0,-323,-105,109530,109722,192
102,0,blank,0,-323,-105,109722,109845,123
102,0,blank,0,253.142,231.243,109876,109900,24
102,0,blank,0,145.3596,279.1194,109928,110112,184
102,0,blank,0,138.282083333333,280.715716666667,110112,110292,180
102,0,blank,0,147.4193,274.3403,110292,110321,29
102,0,blank,0,101.652033333333,374.440833333333,110352,110533,181
102,0,blank,0,127.37935,383.965666666667,110533,110715,182
102,0,blank,0,156.3082,391.3203,110715,110745,30
102,0,blank,0,-323,-105,110776,110858,82
102,0,blank,0,105.1168,363.6611,110883,110909,26
102,0,blank,0,113.75855,387.728325,110971,111084,113
102,28,findmax,167,83.0471333333333,198.389916666667,111116,111297,181
102,0,blank,0,89.4684,208.602583333333,111297,111478,181
102,0,blank,0,212.362866666667,137.01045,111507,111687,180
102,0,blank,0,-323,-105,111717,111823,106
102,0,blank,0,243.3129,145.1023,111849,111874,25
102,0,blank,0,299.7495,126.559166666667,111937,112109,172
102,0,blank,0,357.62425,127.152025,112109,112231,122
102,27,to,159,146.2478,163.494016666667,112261,112441,180
102,27,to,159,142.09854,176.3314,112441,112594,153
102,0,blank,0,93.8381666666667,399.424666666667,112624,112804,180
102,38,return,219,93.65295,401.815183333333,112804,112985,181
102,0,blank,0,88.1552,395.6095,112985,113015,30
102,0,blank,0,-323,-105,113045,113214,169
102,0,blank,0,130.371742857143,364.406842857143,113243,113441,198
102,0,blank,0,112.205733333333,365.1932,113441,113532,91
102,0,blank,0,68.3556333333333,212.046033333333,113563,113745,182
102,0,blank,0,76.49725,215.3559,113745,113806,61
102,0,blank,0,75.71688,442.47096,113836,114026,190
102,40,exchange,226,56.1578666666667,459.025333333333,114026,114204,178
102,40,void,225,41.23534,460.37222,114204,114355,151
102,0,blank,0,117.7736,437.9986,114355,114414,59
102,0,blank,0,-323,-105,114531,114563,32
102,28,(,168,117.8641,187.7761,114683,114857,174
102,28,int,175,150.320733333333,188.552416666667,114857,115039,182
102,28,10,172,193.45895,192.16875,115039,115100,61
102,0,blank,0,-323,-105,115131,115238,107
102,28,10,172,183.5175,183.3764,115264,115300,36
102,0,blank,0,132.498683333333,204.1841,115365,115539,174
102,0,blank,0,126.19665,213.158216666667,115539,115720,181
102,0,blank,0,217.385016666667,212.984816666667,115720,115903,183
102,0,blank,0,220.9774,230.9403,115903,115934,31
102,0,blank,0,-323,-105,115964,116070,106
102,31,<=,193,191.0441,248.3423,116096,116122,26
102,0,blank,0,162.325416666667,265.7993,116186,116362,176
102,31,=,189,119.8206,261.908916666667,116362,116546,184
102,0,blank,0,84.89655,219.517266666667,116546,116728,182
102,0,blank,0,165.779983333333,205.425283333333,116728,116912,184
102,0,blank,0,178.855133333333,213.417416666667,116912,117094,182
102,0,blank,0,238.0458,212.8342,117094,117281,187
102,0,blank,0,233.770216666667,211.824683333333,117281,117462,181
102,0,blank,0,-323,-105,117493,117600,107
102,0,blank,0,245.7642,378.6269,117625,117650,25
102,43,),257,274.111166666667,525.854766666667,117676,117861,185
102,0,blank,0,236.161866666667,514.684166666667,117861,118046,185
102,43,>=,252,193.52185,515.818133333333,118046,118232,186
102,43,j,255,171.2142,527.784366666667,118232,118415,183
102,0,blank,0,191.981216666667,548.000866666667,118415,118598,183
102,0,blank,0,218.23215,545.608933333333,118598,118781,183
102,0,blank,0,232.382775,526.29365,118781,118903,122
102,0,blank,0,144.284916666667,213.781033333333,118934,119117,183
102,28,],173,207.285,201.684416666667,119117,119299,182
102,0,blank,0,237.7885,219.8428,119299,119330,31
102,0,blank,0,-323,-105,119366,119433,67
102,0,blank,0,220.3236,203.466,119457,119646,189
102,0,blank,0,208.5501,206.311566666667,119767,119944,177
102,0,blank,0,174.160016666667,215.550333333333,119944,120126,182
102,0,blank,0,240.683633333333,154.0316,120126,120305,179
102,0,blank,0,245.6708,142.5455,120305,120335,30
102,0,blank,0,208.232783333333,479.614166666667,120395,120577,182
102,0,blank,0,283.958833333333,542.1004,120577,120759,182
102,0,blank,0,283.223033333333,536.36865,120759,120942,183
102,0,blank,0,266.474066666667,535.92425,120942,121124,182
102,0,blank,0,241.4912,552.285766666667,121124,121305,181
102,0,blank,0,192.955733333333,548.6843,121305,121395,90
102,0,blank,0,-323,-105,121426,121561,135
102,0,blank,0,277.83545,544.4408,121588,121761,173
102,45,;,267,280.970466666667,555.094133333333,121761,121852,91
102,43,j,255,171.53685,519.680083333333,121882,122064,182
102,42,big,241,153.61675,500.880833333333,122064,122244,180
102,42,big,241,174.843516666667,505.6036,122244,122424,180
102,0,blank,0,222.88655,537.155233333333,122424,122605,181
102,0,blank,0,237.82348,550.46238,122605,122758,153
102,0,blank,0,-323,-105,122789,122896,107
102,43,;,254,230.969,528.4488,122922,122947,25
102,0,blank,0,245.73655,550.459,123012,123063,51
102,0,blank,0,244.616083333333,212.457616666667,123125,123309,184
102,0,blank,0,247.1929,215.667216666667,123309,123492,183
102,0,blank,0,244.126366666667,228.287933333333,123492,123585,93
102,0,blank,0,193.302283333333,541.2258,123616,123798,182
102,0,blank,0,245.449633333333,546.903216666667,123798,123981,183
102,0,blank,0,252.45945,547.71775,123981,124162,181
102,45,b,263,223.890433333333,570.55625,124162,124348,186
102,45,(,262,219.8582,569.5749,124348,124409,61
102,0,blank,0,-323,-105,124439,124579,140
102,45,findmax,261,189.730616666667,564.620616666667,124608,124785,177
102,45,findmax,261,157.4264,574.094283333333,124785,124975,190
102,0,blank,0,139.43675,235.806716666667,125037,125219,182
102,30,0,182,145.57344,238.67174,125219,125370,151
102,45,findmax,261,209.851533333333,559.542866666667,125400,125583,183
102,45,findmax,261,209.359983333333,569.1095,125583,125767,184
102,45,b,263,223.415316666667,569.0036,125767,125953,186
102,0,blank,0,210.927766666667,554.328533333333,125953,126137,184
102,0,blank,0,196.916066666667,532.7012,126137,126320,183
102,0,blank,0,174.18045,514.354383333333,126320,126504,184
102,0,blank,0,225.200733333333,543.488266666667,126504,126693,189
102,0,blank,0,168.22745,486.586483333333,126693,126881,188
102,0,blank,0,165.8249,486.653,126881,126912,31
102,0,blank,0,-323,-105,126943,126998,55
102,0,blank,0,222.763566666667,490.2761,127102,127272,170
102,0,blank,0,195.8494,488.09115,127272,127458,186
102,0,blank,0,181.874633333333,464.419633333333,127458,127639,181
102,40,[,230,198.34992,461.14176,127639,127791,152
102,0,blank,0,-323,-105,127820,127981,161
102,45,findmax,261,172.79065,563.91285,128012,128061,49
102,42,temp,239,117.77705,494.37115,128091,128151,60
102,0,blank,0,-323,-105,128181,128288,107
102,0,blank,0,149.014216666667,508.720916666667,128382,128565,183
102,43,>=,252,184.397,520.167816666667,128565,128756,191
102,43,>=,252,192.6534,529.28372,128756,128924,168
102,0,blank,0,212.364016666667,553.1416,128924,129118,194
102,45,findmax,261,187.8928,555.299566666667,129118,129312,194
102,45,=,260,132.8541,569.6828,129312,129478,166
102,0,blank,0,-323,-105,129510,129569,59
102,46,big,272,179.64,597.7695,129595,129621,26
102,43,1,253,222.144516666667,531.7248,129682,129870,188
102,0,blank,0,223.0817,508.629366666667,129870,130066,196
102,0,blank,0,205.63885,483.604483333333,130066,130261,195
102,0,blank,0,190.45755,476.9804,130261,130453,192
102,0,blank,0,171.34835,486.064183333333,130453,130645,192
102,0,blank,0,195.270366666667,483.398783333333,130645,130836,191
102,0,blank,0,204.45095,484.648516666667,130836,131028,192
102,0,blank,0,205.6168,487.745175,131028,131156,128
102,0,blank,0,-323,-105,131187,131324,137
102,40,[,230,195.5015,463.118133333333,131352,131533,181
102,0,blank,0,237.81845,441.025433333333,131533,131726,193
102,0,blank,0,154.682783333333,483.199016666667,131726,131918,192
102,0,blank,0,110.185866666667,473.08045,131918,132109,191
102,40,[,230,199.980983333333,464.061683333333,132109,132300,191
102,0,blank,0,-323,-105,132332,132469,137
102,0,blank,0,205.937783333333,471.96125,132499,132679,180
102,0,blank,0,220.925216666667,488.337683333333,132679,132870,191
102,0,blank,0,192.6974,496.706166666667,132870,133057,187
102,43,>=,252,199.672683333333,515.15775,133057,133244,187
102,45,(,262,222.110783333333,560.396466666667,133244,133432,188
102,45,b,263,223.382483333333,565.66205,133432,133622,190
102,0,blank,0,239.82145,542.892566666667,133622,133818,196
102,0,blank,0,200.669366666667,540.95245,133818,134012,194
102,0,blank,0,165.206633333333,542.6994,134012,134204,192
102,45,(,262,220.566283333333,569.2176,134204,134396,192
102,45,findmax,261,209.9059,574.026966666667,134396,134585,189
102,0,blank,0,164.5972,589.883233333333,134585,134775,190
102,46,b,270,159.368416666667,582.709416666667,134775,134968,193
102,46,],273,209.5227,587.418116666667,134968,135160,192
102,0,blank,0,229.46865,577.238475,135160,135287,127
102,0,blank,0,-323,-105,135319,135454,135
102,45,findmax,261,170.0437,571.9929,135480,135506,26
102,0,blank,0,183.505,577.455216666667,135564,135744,180
102,46,;,274,218.713116666667,586.218766666667,135744,135939,195
102,46,b,270,155.198783333333,595.38875,135939,136128,189
102,47,=,279,161.164033333333,602.496633333333,136128,136319,191
102,45,findmax,261,179.240533333333,569.9205,136319,136513,194
102,45,findmax,261,183.251833333333,560.2107,136513,136610,97
102,0,blank,0,125.50875,682.323933333333,136643,136837,194
102,0,blank,0,145.814283333333,642.6207,136837,137030,193
102,46,[,271,170.419966666667,595.433,137030,137223,193
102,46,[,271,166.478816666667,594.345683333333,137223,137416,193
102,0,blank,0,162.8039,599.5335,137416,137449,33
102,0,blank,0,-323,-105,137482,137590,108
102,45,b,263,230.7016,571.0496,137615,137641,26
102,46,;,274,219.247883333333,579.085133333333,137730,137917,187
102,46,;,274,216.7084,583.7398,137917,138110,193
102,46,],273,210.070375,589.860925,138110,138238,128
102,0,blank,0,-323,-105,138269,138378,109
102,46,big,272,182.45825,591.276016666667,138580,138756,176
102,45,findmax,261,179.067466666667,568.613666666667,138756,138941,185
102,46,b,270,161.154883333333,588.640816666667,138941,139126,185
102,0,blank,0,146.564083333333,608.17035,139126,139315,189
102,45,findmax,261,150.46495,572.1905,139315,139501,186
102,0,blank,0,173.360416666667,540.244316666667,139501,139693,192
102,0,blank,0,250.954033333333,544.8349,139693,139830,137
102,0,blank,0,161.0001,544.4023,139830,140024,194
102,0,blank,0,222.841833333333,552.673,140024,140210,186
102,0,blank,0,230.977,549.278433333333,140210,140306,96
102,0,blank,0,-323,-105,140338,140421,83
102,0,blank,0,275.4587,600.6964,140447,140473,26
102,0,blank,0,276.00305,538.1552,140532,140582,50
102,0,blank,0,150.789533333333,537.733366666667,140613,140805,192
102,0,blank,0,154.372633333333,541.689316666667,140805,140989,184
102,45,findmax,261,163.84366,555.82424,140989,141146,157
102,0,blank,0,-323,-105,141209,141347,138
102,28,int,175,127.1007,199.2577,141382,141425,43
102,45,findmax,261,192.978516666667,555.699583333333,141510,141708,198
102,45,(,262,216.00364,575.48736,141708,141881,173
102,45,findmax,261,161.9533,572.1091,141881,142078,197
102,0,blank,0,142.86865,573.287883333333,142078,142271,193
102,45,findmax,261,166.869533333333,569.434783333333,142271,142460,189
102,45,findmax,261,157.657933333333,561.569566666667,142460,142551,91
102,0,blank,0,-323,-105,142612,142721,109
102,0,blank,0,-323,-105,142721,142836,115
102,0,blank,0,209.80404,534.03788,143388,143580,192
102,0,blank,0,171.340533333333,550.694083333333,143580,143764,184
102,45,b,263,229.6371,561.998066666667,143764,143948,184
102,45,),266,271.873516666667,562.70055,143948,144131,183
102,0,blank,0,297.4431,562.2675,144131,144162,31
102,0,blank,0,-323,-105,144193,144299,106
102,43,--,256,264.0596,531.6788,144326,144362,36
102,43,--,256,263.424866666667,526.861883333333,144427,144601,174
102,43,--,256,263.507866666667,527.358266666667,144601,144784,183
102,0,blank,0,265.826216666667,532.37065,144784,144968,184
102,0,blank,0,239.780633333333,519.626866666667,144968,145059,91
102,35,max,213,127.3598,355.71155,145090,145152,62
102,0,blank,0,55.4729,126.276,145181,145364,183
102,27,function,158,120.189316666667,164.052766666667,145364,145547,183
102,28,int,175,127.357666666667,187.320483333333,145547,145729,182
102,28,(,168,118.3054,197.02695,145729,145790,61
102,0,blank,0,-323,-105,145821,145929,108
102,28,b,170,169.0781,192.5723,145970,146023,53
102,28,b,170,171.713233333333,195.377883333333,146102,146277,175
102,0,blank,0,164.971866666667,224.00645,146277,146459,182
102,0,blank,0,191.266083333333,222.652883333333,146459,146641,182
102,0,blank,0,221.8917,211.3881,146641,146824,183
102,0,blank,0,188.653066666667,219.028883333333,146824,147005,181
102,0,blank,0,195.192516666667,221.89575,147005,147187,182
102,0,blank,0,237.200083333333,215.885833333333,147187,147370,183
102,0,blank,0,238.24065,216.989266666667,147370,147553,183
102,0,blank,0,238.896166666667,217.211083333333,147553,147737,184
102,0,blank,0,269.083816666667,217.111983333333,147737,147919,182
102,0,blank,0,272.50015,216.954683333333,147919,148103,184
102,0,blank,0,215.60195,213.13195,148103,148285,182
102,0,blank,0,161.8787,209.586983333333,148285,148468,183
102,0,blank,0,163.692233333333,203.287,148468,148651,183
102,0,blank,0,-323,-105,148682,148823,141
102,0,blank,0,181.699633333333,251.18205,148849,149027,178
102,31,j,196,168.482766666667,263.173416666667,149027,149211,184
102,0,blank,0,181.587466666667,261.700116666667,149211,149396,185
102,0,blank,0,175.62825,246.801816666667,149396,149577,181
102,0,blank,0,162.801766666667,210.8876,149577,149759,182
102,0,blank,0,224.984183333333,210.261283333333,149759,149942,183
102,0,blank,0,232.6535,218.1765,149942,149973,31
102,0,blank,0,-323,-105,150003,150084,81
102,31,++,197,258.1841,258.9052,150110,150136,26
102,0,blank,0,231.372533333333,210.15445,150191,150363,172
102,0,blank,0,257.123566666667,213.48635,150363,150549,186
102,0,blank,0,286.059816666667,222.797683333333,150549,150736,187
102,0,blank,0,267.334833333333,222.888933333333,150736,150920,184
102,0,blank,0,259.242466666667,271.4781,150920,151104,184
102,0,blank,0,223.79155,276.946166666667,151104,151285,181
102,0,blank,0,187.788466666667,275.557166666667,151285,151469,184
102,0,blank,0,-323,-105,151500,151644,144
102,0,blank,0,234.997333333333,263.047883333333,151669,151848,179
102,31,++,197,260.625583333333,258.360883333333,151848,152033,185
102,31,k,194,222.5939,267.569016666667,152033,152214,181
102,0,blank,0,180.869916666667,269.921933333333,152214,152395,181
102,0,blank,0,-323,-105,152426,152536,110
102,33,b,207,210.5621,302.901,152671,152725,54
102,0,blank,0,194.8625,337.8831,152725,153141,416
102,0,blank,0,192.70285,338.63785,153141,153192,51
102,0,blank,0,-323,-105,153219,153330,111
102,0,blank,0,168.475966666667,273.363,153512,153595,83
102,0,blank,0,-323,-105,153624,153731,107
102,31,;,195,226.0584,267.0713,153757,153783,26
102,0,blank,0,206.893171428571,272.798857142857,153841,154039,198
102,0,blank,0,250.41965,268.549383333333,154039,154219,180
102,31,k,194,223.181883333333,267.7941,154219,154398,179
102,0,blank,0,167.163433333333,272.847816666667,154398,154579,181
102,0,blank,0,166.19255,244.46125,154579,154761,182
102,0,blank,0,186.706283333333,210.50605,154761,154943,182
102,0,blank,0,221.71115,243.551383333333,154943,155128,185
102,31,;,195,225.5115,249.5028,155128,155250,122
102,0,blank,0,-323,-105,155311,155363,52
102,0,blank,0,237.618833333333,255.68325,155470,155646,176
102,31,++,197,254.488466666667,261.75245,155646,155830,184
102,31,++,197,253.2665,267.6834,155830,155860,30
102,0,blank,0,151.35255,208.467583333333,155892,156075,183
102,0,blank,0,180.483783333333,213.776783333333,156075,156259,184
102,0,blank,0,241.668833333333,220.581566666667,156259,156443,184
102,0,blank,0,237.3077,260.881216666667,156443,156626,183
102,0,blank,0,268.799866666667,214.5015,156626,156809,183
102,31,1,190,133.143316666667,252.2292,156840,157025,185
102,0,blank,0,179.567516666667,263.0357,157025,157209,184
102,30,comma,183,155.919616666667,237.687716666667,157209,157393,184
102,28,findmax,167,106.455333333333,194.904416666667,157393,157576,183
102,0,blank,0,154.597233333333,191.716333333333,157576,157758,182
102,28,10,172,186.96714,192.5102,157758,157913,155
102,0,blank,0,-323,-105,157943,158049,106
102,0,blank,0,176.3639,180.4088,158087,158137,50
102,0,blank,0,211.233683333333,220.998916666667,158206,158383,177
102,0,blank,0,237.662233333333,250.489466666667,158383,158476,93
102,0,blank,0,-323,-105,158507,158565,58
102,0,blank,0,-323,-105,158618,158704,86
102,30,j,184,173.860816666667,239.344883333333,158718,158890,172
102,0,blank,0,158.273966666667,223.223116666667,158890,159073,183
102,31,k,194,220.254125,260.718325,159073,159198,125
102,0,blank,0,-323,-105,159343,159519,176
102,0,blank,0,-323,-105,159519,159697,178
102,0,blank,0,-323,-105,159697,159880,183
102,0,blank,0,-323,-105,159880,160023,143
102,0,blank,0,164.383875,302.71015,160043,160200,157
102,0,blank,0,154.006,330.0346,160200,160283,83
102,33,(,201,120.0529,291.346233333333,160625,160796,171
102,0,blank,0,104.332966666667,273.790066666667,160796,160971,175
102,0,blank,0,105.814783333333,254.000533333333,160971,161144,173
102,30,max,180,109.5965,230.157983333333,161144,161318,174
102,30,max,180,90.1474666666667,236.343283333333,161318,161492,174
102,30,int,179,60.77655,234.946083333333,161492,161666,174
102,30,int,179,71.4684,234.0078,161666,161695,29
102,0,blank,0,-323,-105,161724,161853,129
102,0,blank,0,119.167314285714,218.7309,161882,162074,192
102,0,blank,0,120.2338,216.741,162074,162254,180
102,0,blank,0,179.290583333333,246.770833333333,162254,162434,180
102,0,blank,0,170.606433333333,283.798633333333,162434,162619,185
102,0,blank,0,124.8627,275.543516666667,162619,162805,186
102,0,blank,0,118.527483333333,232.15105,162805,162996,191
102,0,blank,0,127.323966666667,217.512383333333,162996,163191,195
102,0,blank,0,123.09638,220.87072,163191,163357,166
102,31,1,190,137.980466666667,251.418316666667,163357,163551,194
102,0,blank,0,142.9286,276.05755,163551,163614,63
102,0,blank,0,-323,-105,163645,163752,107
102,31,j,196,171.858,259.2367,163789,163839,50
102,0,blank,0,177.09865,264.749566666667,163905,164087,182
102,0,blank,0,140.725766666667,274.186133333333,164087,164278,191
102,0,blank,0,163.402166666667,274.965233333333,164278,164468,190
102,0,blank,0,159.46925,283.353633333333,164468,164653,185
102,33,b,207,124.293266666667,298.38155,164653,164841,188
102,33,b,207,131.7446,294.0138,164841,164967,126
102,0,blank,0,-323,-105,164998,165116,118
102,0,blank,0,140.275983333333,268.767816666667,165143,165322,179
102,31,k,194,220.7221,267.248033333333,165322,165513,191
102,31,k,194,222.925133333333,265.104116666667,165513,165705,192
102,0,blank,0,213.6624,269.956283333333,165705,165895,190
102,0,blank,0,154.9044,253.4137,165895,165927,32
102,0,blank,0,153.281425,286.1683,165958,166088,130
102,0,blank,0,-323,-105,166124,166182,58
102,40,int,234,158.3824,460.2959,166207,166233,26
102,0,blank,0,135.57145,285.471083333333,166285,166461,176
102,0,blank,0,115.709483333333,282.744466666667,166461,166655,194
102,0,blank,0,159.73495,276.07925,166655,166842,187
102,0,blank,0,164.614883333333,270.709133333333,166842,167027,185
102,31,=,189,118.87205,262.153733333333,167027,167218,191
102,0,blank,0,-323,-105,167282,167451,169
102,0,blank,0,173.3542,306.7213,167484,167505,21
102,0,blank,0,171.89114,315.13286,168687,168845,158
102,0,blank,0,-323,-105,168877,168909,32
102,0,blank,0,103.743933333333,322.211166666667,169013,169101,88
102,0,blank,0,-323,-105,169165,169348,183
102,0,blank,0,-323,-105,169348,169523,175
102,0,blank,0,-323,-105,169523,169707,184
102,0,blank,0,-323,-105,169707,169885,178
102,0,blank,0,-323,-105,169885,170064,179
102,0,blank,0,-323,-105,170064,170139,75
102,0,blank,0,-323,-105,170139,170365,226
102,0,blank,0,-323,-105,170365,170602,237
102,0,blank,0,-323,-105,170602,170796,194
102,0,blank,0,-323,-105,170796,170973,177
102,0,blank,0,-323,-105,170973,171149,176
102,0,blank,0,-323,-105,171149,171327,178
102,0,blank,0,-323,-105,171327,171508,181
102,0,blank,0,-323,-105,171508,171675,167
102,0,blank,0,-323,-105,171675,171822,147
102,0,blank,0,-323,-105,171822,171977,155
102,0,blank,0,-323,-105,171977,172089,112
102,0,blank,0,-323,-105,172089,172203,114
102,0,blank,0,-323,-105,172203,172362,159
102,0,blank,0,-323,-105,172362,172553,191
102,0,blank,0,-323,-105,172553,172718,165
102,0,blank,0,-323,-105,172718,172755,37
102,0,blank,0,-323,-105,173188,173318,130
102,0,blank,0,127.9702,262.2226,173358,173511,153
102,30,0,182,150.094375,229.970525,173511,173697,186
102,30,0,182,146.299933333333,237.965633333333,173697,173838,141
102,0,blank,0,176.04,225.1549,173838,174073,235
102,0,blank,0,144.5187,203.4299,174073,174258,185
102,0,blank,0,-323,-105,174289,174435,146
102,0,blank,0,186.12035,155.0331,174464,174641,177
102,0,blank,0,229.631933333333,147.201666666667,174641,174740,99
102,0,blank,0,174.938333333333,178.895416666667,174773,174955,182
102,0,blank,0,171.095333333333,212.262916666667,174955,175139,184
102,28,[,171,175.784333333333,190.851316666667,175139,175322,183
102,28,int,175,147.737983333333,201.302733333333,175322,175502,180
102,0,blank,0,113.051183333333,204.4136,175502,175691,189
102,28,findmax,167,112.96645,189.7825,175691,175756,65
102,0,blank,0,-323,-105,175788,175871,83
102,0,blank,0,158.6082,211.012,175896,175924,28
102,30,;,185,185.909883333333,228.03875,175989,176160,171
102,0,blank,0,221.369716666667,221.835933333333,176160,176341,181
102,0,blank,0,264.98005,221.980916666667,176341,176528,187
102,0,blank,0,276.965283333333,220.8417,176528,176711,183
102,0,blank,0,290.0267,205.8798,176711,176775,64
102,0,blank,0,-323,-105,176805,176886,81
102,0,blank,0,214.243066666667,209.830666666667,177013,177099,86
102,30,0,182,143.767866666667,243.15065,177133,177321,188
102,0,blank,0,162.14645,215.758,177321,177448,127
102,0,blank,0,-323,-105,177542,177620,78
102,0,blank,0,157.8287,218.5229,177651,177703,52
102,0,blank,0,189.847833333333,210.364366666667,177769,177945,176
102,0,blank,0,186.72255,219.60015,177945,178005,60
102,0,blank,0,-323,-105,178035,178167,132
102,0,blank,0,133.2677,217.5632,178199,178249,50
102,0,blank,0,202.407716666667,213.213066666667,178315,178487,172
102,0,blank,0,164.9677,216.45165,178487,178673,186
102,0,blank,0,143.6248,221.765566666667,178673,178774,101
102,0,blank,0,-323,-105,178807,178945,138
102,0,blank,0,189.139366666667,268.6125,178974,179058,84
102,0,blank,0,-323,-105,179153,179330,177
102,0,blank,0,-323,-105,179330,179432,102
102,0,blank,0,-323,-105,179432,179602,170
102,0,blank,0,-323,-105,179602,179787,185
102,0,blank,0,-323,-105,179787,179951,164
102,0,blank,0,-323,-105,179951,180122,171
102,0,blank,0,-323,-105,180122,180156,34
102,0,blank,0,128.6851,332.6623,180272,180385,113
102,0,blank,0,49.9555,577.7482,180589,180767,178
102,0,blank,0,111.5896,510.2741,180767,180973,206
102,0,blank,0,39.6797666666667,477.709866666667,180973,181166,193
102,0,blank,0,83.903825,427.27265,181166,181328,162
102,0,blank,0,137.8624,476.236,181328,181370,42
102,0,blank,0,-323,-105,181409,181602,193
102,0,blank,0,-323,-105,181602,181780,178
102,0,blank,0,-323,-105,181780,181839,59
102,0,blank,0,156.33865,547.992125,182085,182265,180
102,0,blank,0,137.98832,568.6854,182265,182439,174
102,45,big,259,84.9974833333333,559.5005,182439,182619,180
102,0,blank,0,142.179516666667,559.64065,182619,182799,180
102,45,findmax,261,183.75395,557.068283333333,182799,182977,178
102,45,findmax,261,178.384983333333,560.824483333333,182977,183157,180
102,45,findmax,261,153.677283333333,561.4223,183157,183337,180
102,45,findmax,261,154.548183333333,564.617433333333,183337,183518,181
102,45,findmax,261,155.397883333333,565.8339,183518,183698,180
102,45,findmax,261,202.47346,556.85438,183698,183848,150
102,0,blank,0,-323,-105,183878,183907,29
102,0,blank,0,125.825842857143,585.645357142857,183958,184150,192
102,0,blank,0,-323,-105,184181,184261,80
102,50,return,293,74.1139,673.2738,184287,184313,26
102,46,temp,268,96.6401142857143,583.611871428571,184364,184561,197
102,46,b,270,153.33575,579.4846,184561,184743,182
102,45,findmax,261,152.0247,573.2707,184743,184803,60
102,0,blank,0,-323,-105,184834,184913,79
102,0,blank,0,79.8934,-103.8699,184939,184964,25
102,0,blank,0,126.484142857143,584.323085714286,185033,185231,198
102,0,blank,0,72.3978333333333,579.7591,185231,185411,180
102,0,blank,0,75.0346333333333,580.897216666667,185411,185587,176
102,0,blank,0,79.3275,568.169966666667,185587,185766,179
102,0,blank,0,80.9194,552.939,185766,185945,179
102,0,blank,0,86.932325,553.955375,185945,186063,118
102,0,blank,0,-323,-105,186093,186198,105
102,45,findmax,261,146.0172,562.7884,186224,186249,25
102,45,findmax,261,150.298928571429,561.032485714286,186300,186496,196
102,46,temp,268,89.7527833333333,593.656833333333,186496,186677,181
102,0,blank,0,82.3575166666667,601.1337,186677,186858,181
102,0,blank,0,129.493333333333,599.170983333333,186858,187037,179
102,46,b,270,159.668,594.2955,187037,187217,180
102,46,b,270,158.9732,583.256,187217,187306,89
102,0,blank,0,-323,-105,187335,187477,142
102,45,=,260,128.693133333333,557.693366666667,187504,187676,172
102,45,=,260,133.057083333333,563.712116666667,187676,187858,182
102,45,=,260,129.7813,556.51205,187858,187918,60
102,0,blank,0,-323,-105,187978,188003,25
102,0,blank,0,287.426583333333,587.140783333333,188055,188217,162
102,0,blank,0,120.723125,538.282825,188246,188364,118
102,0,blank,0,-323,-105,188425,188529,104
102,0,blank,0,138.1768,542.4709,188555,188590,35
102,0,blank,0,128.993633333333,535.7046,188653,188735,82
102,0,blank,0,509.539083333333,711.020633333333,188795,188976,181
102,0,blank,0,75.1655833333333,547.5411,189007,189186,179
102,0,blank,0,75.1647833333333,556.459316666667,189186,189365,179
102,0,blank,0,142.8483,556.7041,189365,189485,120
102,0,blank,0,-323,-105,189515,189622,107
102,0,blank,0,163.0855,534.2867,189649,189689,40
102,0,blank,0,152.302716666667,548.342883333333,189756,189928,172
102,46,temp,268,87.3620666666666,582.215883333333,189928,190111,183
102,0,blank,0,71.3448666666667,589.9281,190111,190296,185
102,46,=,269,133.7124,593.7802,190296,190484,188
102,0,blank,0,145.19695,599.1611,190484,190546,62
102,0,blank,0,-323,-105,190578,190761,183
102,0,blank,0,-323,-105,190761,190853,92
102,46,=,269,139.638225,592.377325,190889,191015,126
102,0,blank,0,-323,-105,191228,191422,194
102,0,blank,0,-323,-105,191422,191505,83
102,0,blank,0,-323,-105,191505,191632,127
102,0,blank,0,-323,-105,191632,191815,183
102,0,blank,0,-323,-105,191815,191989,174
102,0,blank,0,-323,-105,191989,192209,220
102,0,blank,0,303.3525,668.05505,192287,192354,67
102,0,blank,0,-323,-105,192386,192576,190
102,0,blank,0,-323,-105,192576,192712,136
102,45,findmax,261,202.21092,565.97812,192754,192918,164
102,0,blank,0,220.551875,550.81145,192918,193065,147
102,0,blank,0,205.20792,538.4066,193065,193251,186
102,43,>=,252,191.158066666667,527.61215,193251,193438,187
102,0,blank,0,166.112233333333,477.917983333333,193438,193625,187
102,0,blank,0,259.563383333333,484.8885,193625,193816,191
102,0,blank,0,252.8258,492.107383333333,193816,194006,190
102,42,;,244,221.1432,503.4404,194006,194038,32
102,0,blank,0,-323,-105,194071,194181,110
102,0,blank,0,278.82595,484.3396,194206,194380,174
102,0,blank,0,196.6652,506.094866666667,194380,194569,189
102,42,big,241,174.5306,500.321583333333,194569,194753,184
102,0,blank,0,177.23265,487.465816666667,194753,194937,184
102,0,blank,0,210.090133333333,544.959016666667,194937,195123,186
102,0,blank,0,251.080833333333,534.239633333333,195123,195309,186
102,0,blank,0,-323,-105,195341,195450,109
102,0,blank,0,242.0193,545.826,195480,195520,40
102,43,;,254,225.861016666667,530.8007,195589,195773,184
102,42,comma,242,188.31395,494.562933333333,195773,195965,192
102,0,blank,0,127.109533333333,117.656933333333,195998,196190,192
102,0,blank,0,199.02956,220.2326,196221,196377,156
102,0,blank,0,-323,-105,196439,196494,55
102,0,blank,0,246.99995,472.83105,196604,196784,180
102,43,j,255,251.6588,529.384383333333,196784,196974,190
102,0,blank,0,270.10995,486.361016666667,196974,197163,189
102,0,blank,0,257.996,478.8752,197163,197195,32
102,0,blank,0,139.665316666667,209.12495,197228,197420,192
102,0,blank,0,169.393733333333,208.7045,197420,197610,190
102,0,blank,0,207.29414,219.2444,197610,197765,155
102,0,blank,0,280.1271,470.921683333333,197796,197985,189
102,0,blank,0,279.802483333333,468.8492,197985,198176,191
102,0,blank,0,276.1212,466.868833333333,198176,198365,189
102,40,int,234,279.947933333333,459.8023,198365,198557,192
102,0,blank,0,254.383716666667,439.660816666667,198557,198749,192
102,0,blank,0,252.580483333333,428.440883333333,198749,198944,195
102,0,blank,0,250.897866666667,425.028516666667,198944,199136,192
102,0,blank,0,257.9105,440.891666666667,199136,199238,102
102,0,blank,0,-323,-105,199271,199410,139
102,27,find,160,191.194416666667,168.706616666667,199467,199656,189
102,31,;,195,229.0833,249.289833333333,199656,199848,192
102,0,blank,0,-323,-105,199881,199964,83
102,0,blank,0,192.0332,277.1987,199990,200016,26
102,0,blank,0,178.752733333333,262.292316666667,200083,200260,177
102,0,blank,0,178.691083333333,268.987916666667,200260,200447,187
102,31,++,197,257.46785,254.018925,200447,200575,128
102,0,blank,0,-323,-105,200606,200689,83
102,0,blank,0,208.8239,257.2085,200736,200787,51
102,0,blank,0,210.55765,266.9647,200871,201065,194
102,0,blank,0,206.1212,279.3186,201065,201152,87
102,31,j,196,243.21385,254.6874,201152,201337,185
102,31,j,196,248.127133333333,259.860283333333,201337,201528,191
102,33,>=,206,182.655183333333,298.394033333333,201528,201712,184
102,0,blank,0,168.099625,308.236475,201712,201836,124
102,0,blank,0,-323,-105,201866,201974,108
102,33,b,207,206.2115,295.8689,202000,202025,25
102,0,blank,0,169.987166666667,229.898,202088,202263,175
102,0,blank,0,164.931366666667,223.914283333333,202263,202450,187
102,0,blank,0,211.756433333333,213.66045,202450,202638,188
102,0,blank,0,228.376416666667,220.124616666667,202638,202824,186
102,0,blank,0,196.049616666667,217.911083333333,202824,203010,186
102,30,j,184,176.8079,228.3151,203010,203040,30
102,0,blank,0,-323,-105,203071,203178,107
102,0,blank,0,202.8597,203.4227,203204,203232,28
102,0,blank,0,183.63685,211.874016666667,203303,203484,181
102,0,blank,0,157.7059,212.3371,203484,203672,188
102,0,blank,0,228.649616666667,216.105566666667,203672,203860,188
102,0,blank,0,229.130933333333,223.890133333333,203860,203952,92
102,0,blank,0,-323,-105,203983,204091,108
102,28,int,175,236.9246,196.7511,204128,204177,49
102,0,blank,0,190.840016666667,209.70235,204242,204418,176
102,0,blank,0,161.146883333333,215.061366666667,204418,204604,186
102,0,blank,0,149.15975,212.29995,204604,204663,59
102,0,blank,0,-323,-105,204694,204826,132
102,0,blank,0,216.476733333333,215.127933333333,204853,205029,176
102,0,blank,0,175.56135,223.2248,205029,205213,184
102,0,blank,0,170.35566,215.0463,205213,205367,154
102,0,blank,0,-323,-105,205399,205506,107
102,30,j,184,180.295216666667,233.438283333333,205594,205769,175
102,30,j,184,178.680216666667,241.43605,205769,205952,183
102,31,<=,193,184.953,251.497766666667,205952,206139,187
102,31,<=,193,186.0309,261.7594,206139,206169,30
102,0,blank,0,-323,-105,206202,206308,106
102,31,<=,193,198.8188,255.5475,206351,206405,54
102,30,j,184,177.6621,236.016266666667,206474,206651,177
102,0,blank,0,178.409533333333,216.5772,206651,206838,187
102,0,blank,0,236.045533333333,222.19055,206838,207023,185
102,0,blank,0,230.273416666667,218.38645,207023,207206,183
102,0,blank,0,235.2911,219.235866666667,207206,207299,93
102,0,blank,0,-323,-105,207360,207414,54
102,33,>=,206,193.3012,306.2813,207440,207465,25
102,0,blank,0,209.562233333333,248.959716666667,207522,207696,174
102,31,j,196,166.689533333333,260.96365,207696,207881,185
102,0,blank,0,152.775666666667,276.35895,207881,208067,186
102,0,blank,0,158.38632,283.63696,208067,208221,154
102,0,blank,0,-323,-105,208252,208390,138
102,0,blank,0,208.77815,257.21055,208422,208599,177
102,0,blank,0,160.70476,275.79048,208599,208752,153
102,0,blank,0,-323,-105,208783,208891,108
102,0,blank,0,156.2028,249.831,208916,208942,26
102,31,j,196,165.962983333333,255.608833333333,209008,209185,177
102,31,j,196,168.018533333333,259.332566666667,209185,209278,93
102,0,blank,0,184.57185,438.9959,209308,209492,184
102,0,blank,0,173.953516666667,438.72105,209492,209678,186
102,0,blank,0,127.099616666667,516.17055,209708,209896,188
102,0,blank,0,125.6363,518.6993,209896,209927,31
102,0,blank,0,182.96274,262.53664,209990,210142,152
102,0,blank,0,-323,-105,210204,210283,79
102,0,blank,0,174.3579,271.2754,210309,210335,26
102,0,blank,0,166.770566666667,275.520316666667,210394,210572,178
102,0,blank,0,171.8049,278.231616666667,210572,210759,187
102,0,blank,0,175.3351,289.47895,210759,210820,61
102,0,blank,0,247.332716666667,461.967833333333,210850,211037,187
102,40,comma,233,241.3394,458.3604,211037,211068,31
102,0,blank,0,143.808083333333,246.012566666667,211099,211283,184
102,0,blank,0,154.3193,265.6194,211283,211315,32
102,0,blank,0,-323,-105,211345,211427,82
102,0,blank,0,213.1011,246.2499,211453,211480,27
102,31,<=,193,200.85435,257.123466666667,211546,211721,175
102,31,<=,193,184.079866666667,267.214233333333,211721,211907,186
102,0,blank,0,242.700066666667,272.257566666667,211907,212090,183
102,0,blank,0,171.801633333333,315.828366666667,212090,212272,182
102,0,blank,0,169.485233333333,314.886316666667,212272,212454,182
102,0,blank,0,171.752316666667,311.22905,212454,212636,182
102,0,blank,0,217.47624,273.21968,212636,212788,152
102,0,blank,0,-323,-105,212819,212874,55
102,0,blank,0,204.238,476.5846,212900,212926,26
102,31,<=,193,192.420833333333,253.639683333333,212988,213166,178
102,0,blank,0,174.531883333333,260.545183333333,213166,213352,186
102,31,j,196,168.6543,261.945333333333,213352,213444,92
102,46,big,272,181.081666666667,594.94195,213474,213660,186
102,46,big,272,177.074316666667,596.1573,213660,213845,185
102,0,blank,0,124.2695,579.16746,213845,213997,152
102,0,blank,0,-323,-105,214027,214185,158
102,0,blank,0,199.861783333333,278.196333333333,214216,214388,172
102,33,b,207,207.342433333333,296.990133333333,214388,214569,181
102,33,b,207,210.0342,301.4023,214569,214751,182
102,0,blank,0,192.97615,290.920533333333,214751,214929,178
102,0,blank,0,186.64235,280.82575,214929,215107,178
102,0,blank,0,-323,-105,215136,215192,56
102,0,blank,0,270.814885714286,277.384785714286,215296,215491,195
102,0,blank,0,234.007366666667,275.240466666667,215491,215668,177
102,0,blank,0,222.299533333333,286.6027,215668,215757,89
102,0,blank,0,-323,-105,215816,215870,54
102,0,blank,0,265.3079,376.4311,215895,215921,26
102,0,blank,0,242.912142857143,280.914928571429,215973,216166,193
102,0,blank,0,167.9374,270.821283333333,216166,216343,177
102,31,j,196,172.28655,265.72415,216343,216520,177
102,0,blank,0,172.438683333333,270.419816666667,216520,216695,175
102,31,j,196,167.880766666667,265.9418,216695,216870,175
102,0,blank,0,163.507066666667,222.023066666667,216870,217046,176
102,0,blank,0,165.830633333333,217.2482,217046,217226,180
102,0,blank,0,-323,-105,217285,217312,27
102,0,blank,0,268.05235,244.3852,217412,217462,50
102,0,blank,0,-323,-105,217488,217542,54
102,31,<=,193,203.446585714286,254.877728571429,217683,217882,199
102,0,blank,0,170.663466666667,269.78445,217882,218059,177
102,0,blank,0,166.7924,275.876816666667,218059,218237,178
102,0,blank,0,157.7959,284.963366666667,218237,218324,87
102,0,blank,0,-323,-105,218353,218457,104
102,31,<=,193,193.5439,257.1397,218508,218572,64
102,31,<=,193,191.962842857143,263.641671428571,218637,218834,197
102,0,blank,0,180.96355,273.097466666667,218834,219012,178
102,31,<=,193,185.41515,256.8906,219012,219187,175
102,0,blank,0,210.24495,231.5535,219187,219365,178
102,31,j,196,250.129733333333,266.83815,219365,219543,178
102,33,max,209,228.566283333333,291.811766666667,219543,219722,179
102,0,blank,0,175.085783333333,324.533533333333,219722,219901,179
102,0,blank,0,186.806683333333,319.90125,219901,220082,181
102,0,blank,0,206.375475,317.95765,220082,220200,118
102,0,blank,0,-323,-105,220230,220285,55
102,31,j,196,248.615471428571,262.911771428571,220403,220602,199
102,0,blank,0,210.419116666667,275.206066666667,220602,220783,181
102,0,blank,0,163.396716666667,284.548466666667,220783,220960,177
102,0,blank,0,172.068683333333,284.38445,220960,221135,175
102,0,blank,0,205.989383333333,315.924416666667,221135,221309,174
102,0,blank,0,204.2588,323.5339,221309,221391,82
102,0,blank,0,210.4737,271.9094,221562,221737,175
102,0,blank,0,207.131183333333,275.144633333333,221737,221916,179
102,0,blank,0,215.715083333333,289.034633333333,221916,222093,177
102,0,blank,0,211.84315,283.18545,222093,222151,58
102,0,blank,0,-323,-105,222210,222318,108
102,31,),198,278.9288,256.5254,222343,222369,26
102,31,j,196,249.676671428571,261.975928571429,222436,222633,197
102,31,j,196,243.483116666667,260.333116666667,222633,222811,178
102,0,blank,0,211.8299,271.8337,222811,222989,178
102,0,blank,0,168.91185,268.644933333333,222989,223163,174
102,0,blank,0,150.35075,285.8373,223163,223220,57
102,0,blank,0,-323,-105,223250,223304,54
102,0,blank,0,235.3209,406.5244,223330,223355,25
102,0,blank,0,213.6789,272.4758,223413,223612,199
102,0,blank,0,186.106483333333,283.978283333333,223612,223789,177
102,0,blank,0,178.140816666667,279.2643,223789,223967,178
102,0,blank,0,171.9936,275.0689,223967,223996,29
102,0,blank,0,-323,-105,224026,224156,130
102,0,blank,0,256.1588,288.6739,224182,224207,25
102,0,blank,0,258.692528571429,271.710942857143,224257,224453,196
102,0,blank,0,255.270733333333,269.131283333333,224453,224631,178
102,33,],210,261.70285,296.65195,224631,224690,59
102,0,blank,0,155.041916666667,283.2538,224720,224894,174
102,0,blank,0,197.086566666667,276.618283333333,224894,225071,177
102,33,b,207,213.239333333333,298.694116666667,225071,225249,178
102,0,blank,0,190.3174,317.0014,225249,225338,89
102,0,blank,0,-323,-105,225398,225475,77
102,0,blank,0,212.8724,272.0334,225505,225581,76
102,0,blank,0,212.297383333333,277.799316666667,225647,225817,170
102,0,blank,0,203.2475,285.3964,225817,225877,60
102,0,blank,0,-323,-105,225906,226037,131
102,0,blank,0,157.2275,250.3973,226062,226094,32
102,31,;,195,149.68592,261.39856,226160,226299,139
102,0,blank,0,232.950283333333,274.034816666667,226329,226504,175
102,31,j,196,171.87445,265.0098,226504,226679,175
102,30,0,182,145.713716666667,243.871383333333,226679,226857,178
102,0,blank,0,153.967933333333,220.897166666667,226857,227037,180
102,0,blank,0,214.9921,206.155783333333,227037,227219,182
102,0,blank,0,221.533733333333,222.601,227219,227404,185
102,0,blank,0,269.747116666667,228.814633333333,227404,227586,182
102,0,blank,0,248.634683333333,217.402566666667,227586,227769,183
102,0,blank,0,229.99845,225.613725,227769,227892,123
102,0,blank,0,-323,-105,227922,228003,81
102,0,blank,0,237.193,210.0619,228028,228066,38
102,0,blank,0,271.2854,212.97025,228132,228307,175
102,0,blank,0,283.9801,217.2945,228307,228338,31
102,0,blank,0,167.1749,218.45268,228368,228522,154
102,0,blank,0,243.3515,532.877983333333,228553,228739,186
102,0,blank,0,277.276833333333,552.970216666667,228739,228922,183
102,0,blank,0,278.154725,549.8778,228922,229047,125
102,0,blank,0,207.6608,205.41715,229077,229263,186
102,28,10,172,201.589016666667,197.056033333333,229263,229445,182
102,28,10,172,199.475875,200.861825,229445,229567,122
102,0,blank,0,247.205625,680.4563,229597,229720,123
102,0,blank,0,192.28035,541.229583333333,229751,229933,182
102,0,blank,0,245.8035,550.712833333333,229933,230115,182
102,43,j,255,251.621583333333,514.12625,230115,230298,183
102,0,blank,0,242.79015,470.10145,230298,230480,182
102,0,blank,0,281.193566666667,431.257333333333,230480,230663,183
102,0,blank,0,283.994316666667,426.745466666667,230663,230846,183
102,0,blank,0,229.201033333333,420.166283333333,230846,231027,181
102,0,blank,0,246.464266666667,423.276483333333,231027,231212,185
102,0,blank,0,256.9922,426.5843,231212,231242,30
102,0,blank,0,-323,-105,231272,231353,81
102,0,blank,0,265.5157,597.1176,231379,231404,25
102,0,blank,0,239.505785714286,482.932585714286,231456,231654,198
102,42,big,241,160.744866666667,491.66535,231654,231838,184
102,0,blank,0,192.103716666667,501.540083333333,231838,232023,185
102,42,j,243,204.07045,497.712333333333,232023,232202,179
102,0,blank,0,236.77275,487.715366666667,232202,232380,178
102,0,blank,0,177.676933333333,458.59605,232380,232563,183
102,40,int,234,147.81025,461.6032,232563,232624,61
102,0,blank,0,322.409866666667,396.340933333333,232656,232842,186
102,0,blank,0,328.8575,413.7777,232842,232872,30
102,0,blank,0,-323,-105,232903,233041,138
102,0,blank,0,279.626,396.947533333333,233071,233247,176
102,0,blank,0,287.89052,420.37354,233247,233404,157
102,0,blank,0,151.47974,498.32686,233435,233619,184
102,0,blank,0,176.85125,475.441316666667,233619,233809,190
102,40,b,229,191.17495,458.395666666667,233809,233990,181
102,0,blank,0,201.7969,502.08525,233990,234173,183
102,42,j,243,209.99935,504.274825,234173,234322,149
102,0,blank,0,329.1848,659.9263,234413,234446,33
102,0,blank,0,170.36835,479.60825,234476,234594,118
102,42,big,241,176.10232,506.0249,234661,234841,180
102,42,big,241,171.091416666667,496.355966666667,234841,235031,190
102,0,blank,0,163.78295,489.365125,235031,235153,122
102,0,blank,0,298.051925,436.96125,235183,235305,122
102,0,blank,0,-323,-105,235336,235442,106
102,0,blank,0,269.5522,408.3367,235468,235494,26
102,40,10,231,216.72305,453.740766666667,235551,235726,175
102,0,blank,0,158.077783333333,481.393766666667,235726,235908,182
102,42,big,241,169.1434,496.457683333333,235908,236095,187
102,0,blank,0,201.56135,478.377283333333,236095,236282,187
102,0,blank,0,220.05445,472.092266666667,236282,236468,186
102,0,blank,0,222.287633333333,471.168766666667,236468,236560,92
102,0,blank,0,-323,-105,236592,236733,141
102,42,;,244,221.889266666667,490.006416666667,236763,236934,171
102,0,blank,0,180.833133333333,519.094133333333,236934,237118,184
102,0,blank,0,175.0409,522.5935,237118,237180,62
102,0,blank,0,284.08995,430.13585,237239,237419,180
102,0,blank,0,299.0598,376.7439,237419,237451,32
102,0,blank,0,322.4861,435.58335,237520,237675,155
102,0,blank,0,343.9685,404.02275,237706,237771,65
102,0,blank,0,227.4624,414.864866666667,237805,237896,91
102,0,blank,0,-323,-105,237927,238061,134
102,0,blank,0,229.334125,419.47015,238092,238205,113
102,0,blank,0,137.539766666667,543.833766666667,238236,238424,188
102,0,blank,0,197.064816666667,495.335966666667,238424,238606,182
102,0,blank,0,259.867866666667,506.507733333333,238606,238790,184
102,0,blank,0,282.90295,493.624616666667,238790,238976,186
102,0,blank,0,253.393933333333,493.924666666667,238976,239158,182
102,0,blank,0,241.137483333333,494.132866666667,239158,239337,179
102,0,blank,0,241.327625,497.033575,239337,239456,119
102,0,blank,0,-323,-105,239486,239567,81
102,0,blank,0,222.042833333333,498.056616666667,239678,239854,176
102,0,blank,0,222.320866666667,499.846783333333,239854,240042,188
102,42,j,243,208.649016666667,497.7077,240042,240228,186
102,42,comma,242,184.661383333333,497.221916666667,240228,240415,187
102,43,j,255,172.42565,514.5513,240415,240477,62
102,0,blank,0,274.566416666667,492.042783333333,240508,240692,184
102,0,blank,0,278.89362,510.31608,240692,240845,153
102,43,=,248,119.984116666667,515.277466666667,240875,241059,184
102,42,big,241,178.455066666667,491.33255,241059,241241,182
102,0,blank,0,174.306116666667,478.41695,241241,241429,188
102,42,big,241,169.623216666667,504.9637,241429,241615,186
102,0,blank,0,211.84104,533.9394,241615,241795,180
102,45,j,265,254.29715,555.07195,241795,241992,197
102,0,blank,0,253.1803,543.4871,241992,242180,188
102,45,),266,264.91395,566.09295,242180,242242,62
102,0,blank,0,-323,-105,242272,242379,107
102,40,[,230,202.1656,461.597,242406,242445,39
102,0,blank,0,213.048633333333,478.422666666667,242512,242686,174
102,0,blank,0,193.800666666667,501.085883333333,242686,242872,186
102,42,big,241,174.2839,504.460283333333,242872,243052,180
102,42,big,241,179.668,493.5401,243052,243082,30
102,0,blank,0,286.70835,494.4086,243111,243291,180
102,0,blank,0,251.21295,495.3572,243291,243472,181
102,0,blank,0,212.845183333333,488.153783333333,243472,243652,180
102,0,blank,0,196.513066666667,489.2587,243652,243834,182
102,0,blank,0,147.3019,471.630233333333,243834,243930,96
102,0,blank,0,270.622683333333,385.374316666667,243963,244154,191
102,0,blank,0,295.5211,410.26118,244154,244310,156
102,0,blank,0,-323,-105,244340,244396,56
102,0,blank,0,200.5937,496.7726,244502,244678,176
102,0,blank,0,268.4575,487.926783333333,244678,244866,188
102,0,blank,0,265.967133333333,492.949083333333,244866,245049,183
102,0,blank,0,272.687383333333,494.4042,245049,245227,178
102,0,blank,0,206.346283333333,532.505216666667,245227,245410,183
102,43,>=,252,199.832716666667,529.2191,245410,245592,182
102,0,blank,0,202.965883333333,497.38765,245592,245774,182
102,0,blank,0,200.771933333333,493.202216666667,245774,245955,181
102,0,blank,0,188.154183333333,486.028666666667,245955,246138,183
102,0,blank,0,-323,-105,246168,246299,131
102,0,blank,0,189.769016666667,488.51085,246393,246566,173
102,0,blank,0,250.905566666667,471.4262,246566,246754,188
102,0,blank,0,262.4022,474.226,246754,246785,31
102,0,blank,0,-323,-105,246817,246924,107
102,0,blank,0,210.6862,474.92035,247007,247183,176
102,0,blank,0,205.0084,482.298816666667,247183,247376,193
102,0,blank,0,255.877466666667,491.893233333333,247376,247569,193
102,0,blank,0,220.0092,510.3271,247569,247734,165
102,0,blank,0,189.277825,554.9129,247734,247905,171
102,0,blank,0,224.91442,543.56832,247905,248078,173
102,43,1,253,220.277375,531.311625,248078,248207,129
102,0,blank,0,-323,-105,248235,248427,192
102,0,blank,0,-323,-105,248427,248480,53
102,0,blank,0,227.271616666667,550.950733333333,248514,248698,184
102,45,b,263,224.062283333333,558.4947,248698,248889,191
102,0,blank,0,251.115233333333,551.528983333333,248889,249075,186
102,0,blank,0,264.749683333333,545.183933333333,249075,249261,186
102,45,b,263,232.148916666667,565.173433333333,249261,249444,183
102,45,(,262,217.223166666667,575.312366666667,249444,249538,94
102,0,blank,0,-323,-105,249569,249704,135
102,0,blank,0,202.596416666667,532.075816666667,249816,250008,192
102,0,blank,0,-323,-105,250040,250175,135
102,43,1,253,215.9655,528.6039,250206,250249,43
102,0,blank,0,197.803666666667,545.642066666667,250331,250512,181
102,0,blank,0,157.311933333333,554.76155,250512,250699,187
102,45,findmax,261,182.819283333333,563.706533333333,250699,250886,187
102,47,;,284,220.885016666667,600.87905,250886,251072,186
102,46,b,270,153.89965,595.752033333333,251072,251258,186
102,0,blank,0,165.392266666667,613.5092,251258,251446,188
102,0,blank,0,152.707266666667,579.9207,251446,251633,187
102,45,findmax,261,143.558833333333,570.059316666667,251633,251819,186
102,45,findmax,261,188.649116666667,574.385233333333,251819,252006,187
102,45,b,263,228.582475,561.406125,252006,252130,124
102,0,blank,0,-323,-105,252161,252326,165
102,45,findmax,261,194.950566666667,575.888683333333,252358,252532,174
102,46,;,274,221.596733333333,589.8741,252532,252720,188
102,0,blank,0,184.515333333333,598.934133333333,252720,252907,187
102,47,],283,136.3359,606.44035,252907,252969,62
102,0,blank,0,230.16025,553.130933333333,253000,253187,187
102,0,blank,0,215.799433333333,550.357333333333,253187,253373,186
102,45,(,262,217.1282,558.2432,253373,253404,31
102,0,blank,0,-323,-105,253435,253542,107
102,0,blank,0,197.8819,670.5237,253568,253593,25
102,45,findmax,261,202.64715,565.797033333333,253666,253848,182
102,0,blank,0,264.3375,537.0009,253848,254040,192
102,0,blank,0,253.6577,533.8953,254040,254073,33
102,0,blank,0,-323,-105,254107,254290,183
102,0,blank,0,-323,-105,254499,254558,59
102,0,blank,0,247.5621,596.6539,254747,254773,26
102,0,blank,0,-323,-105,254994,255139,145
102,0,blank,0,239.004583333333,548.807533333333,255172,255344,172
102,45,findmax,261,167.89276,559.49176,255344,255493,149
102,45,findmax,261,170.8494,572.196,255493,255577,84
102,0,blank,0,297.0793,561.02005,255660,255829,169
102,0,blank,0,-323,-105,255860,255940,80
102,0,blank,0,294.1147,644.9874,255965,255991,26
102,45,;,267,281.054057142857,560.305214285714,256057,256254,197
102,0,blank,0,290.32785,565.705233333333,256254,256433,179
102,0,blank,0,284.0484,584.4722,256433,256521,88
102,0,blank,0,-323,-105,256551,256682,131
102,0,blank,0,239.827028571429,583.980385714286,256707,256898,191
102,46,big,272,197.823333333333,584.993583333333,256898,257075,177
102,46,big,272,197.660966666667,588.460583333333,257075,257252,177
102,0,blank,0,159.555675,691.346625,257281,257403,122
102,46,b,270,153.103325,597.271775,257432,257554,122
102,0,blank,0,157.40905,660.732916666667,257583,257764,181
102,0,blank,0,141.4983,681.808716666667,257764,257941,177
102,0,blank,0,149.7989,679.667333333333,257941,258031,90
102,0,blank,0,273.882966666667,495.05695,258061,258242,181
102,0,blank,0,271.9587,498.9834,258242,258415,173
102,0,blank,0,272.070825,502.887975,258415,258536,121
102,0,blank,0,-323,-105,258566,258674,108
102,0,blank,0,276.192383333333,493.530183333333,258863,259033,170
102,0,blank,0,275.633116666667,480.861633333333,259033,259217,184
102,0,blank,0,302.089883333333,424.193066666667,259217,259397,180
102,0,blank,0,300.8794,439.3159,259397,259487,90
102,0,blank,0,303.484633333333,547.588033333333,259517,259700,183
102,0,blank,0,301.07585,553.834625,259700,259823,123
102,0,blank,0,163.058333333333,540.5587,259854,260038,184
102,43,j,255,169.74535,527.192266666667,260038,260218,180
102,43,>=,252,201.947683333333,516.281783333333,260218,260403,185
102,0,blank,0,237.816233333333,514.036366666667,260403,260586,183
102,43,),257,277.739183333333,514.159616666667,260586,260769,183
102,0,blank,0,-323,-105,260799,260854,55
102,0,blank,0,297.3671,666.7012,260880,260906,26
102,0,blank,0,278.266685714286,468.456728571429,260960,261156,196
102,43,),257,278.450433333333,522.97215,261156,261338,182
102,45,comma,264,237.242066666667,566.105683333333,261338,261525,187
102,0,blank,0,234.137766666667,576.594116666667,261525,261710,185
102,45,j,265,258.744766666667,565.962183333333,261710,261893,183
102,0,blank,0,246.00786,560.96356,261893,262043,150
102,0,blank,0,-323,-105,262073,262156,83
102,0,blank,0,207.8265,743.5101,262179,262208,29
102,0,blank,0,215.717966666667,533.091633333333,262465,262575,110
102,0,blank,0,775.351666666667,580.546633333333,262635,262725,90
102,42,int,238,72.5078833333333,509.662383333333,262786,262964,178
102,0,blank,0,123.896516666667,689.029066666667,262993,263170,177
102,0,blank,0,127.194266666667,699.5849,263170,263351,181
102,0,blank,0,135.779666666667,698.046183333333,263351,263529,178
102,0,blank,0,144.6878,692.8227,263529,263559,30
102,0,blank,0,-323,-105,263588,263770,182
102,0,blank,0,-323,-105,263770,263953,183
102,0,blank,0,-323,-105,263953,264119,166
102,0,blank,0,-323,-105,264119,264286,167
102,0,blank,0,-323,-105,264286,264453,167
102,0,blank,0,-323,-105,264453,264625,172
102,0,blank,0,-323,-105,264625,264677,52
102,0,blank,0,1028.43166666667,353.7377,264854,265053,199
102,0,blank,0,1026.70566666667,391.216383333333,265053,265240,187
102,0,blank,0,1023.846,394.26015,265240,265428,188
102,0,blank,0,1016.6795,403.042883333333,265428,265614,186
102,0,blank,0,1024.43966666667,419.324333333333,265614,265804,190
102,0,blank,0,1040.46533333333,427.479,265804,265993,189
102,0,blank,0,1037.45333333333,428.233733333333,265993,266182,189
102,0,blank,0,1022.2,438.37345,266182,266371,189
102,0,blank,0,1025.09833333333,431.477916666667,266371,266560,189
102,0,blank,0,1040.5095,270.954366666667,266592,266779,187
102,0,blank,0,1040.42166666667,277.391333333333,266779,266874,95
103,0,blank,0,1026.93966666667,10.5041833333333,267441,267626,185
103,0,blank,0,1020.44833333333,2.1633,267626,267719,93
103,10,n,63,203.189916666667,215.85055,267813,267998,185
103,0,blank,0,189.256483333333,240.367133333333,267998,268188,190
103,0,blank,0,154.5147,267.025975,268188,268314,126
103,0,blank,0,-323,-105,268344,268425,81
103,12,&,73,202.9411,259.9081,268450,268483,33
103,0,blank,0,221.214533333333,283.410533333333,268549,268630,81
103,19,Selection,113,125.50435,412.287733333333,268662,268850,188
103,19,sorting,114,213.263816666667,404.61525,268850,269045,195
103,0,blank,0,279.063883333333,395.117966666667,269045,269239,194
103,0,blank,0,-323,-105,269272,269461,189
103,21,"Sortedarrayis...\n",127,137.80955,448.022483333333,269496,269688,192
103,20,;,124,230.36778,432.95476,269752,269922,170
103,0,blank,0,223.8606,431.7304,269922,270017,95
103,0,blank,0,-323,-105,270050,270186,136
103,22,<,137,192.91135,480.32045,270312,270495,183
103,0,blank,0,169.312883333333,492.209883333333,270495,270690,195
103,0,blank,0,222.47704,486.05186,270690,270850,160
103,0,blank,0,292.5988,598.2488,271005,271041,36
103,0,blank,0,134.364283333333,344.843383333333,271105,271291,186
103,0,blank,0,169.12375,384.582666666667,271291,271477,186
103,0,blank,0,191.26025,346.905766666667,271477,271668,191
103,15,n,94,209.45385,324.717583333333,271668,271858,190
103,0,blank,0,295.5207,321.932683333333,271858,272049,191
103,0,blank,0,234.701483333333,280.186633333333,272049,272239,190
103,0,blank,0,222.9438,284.53435,272239,272302,63
103,0,blank,0,-323,-105,272335,272418,83
103,0,blank,0,316.2787,318.379,272444,272492,48
103,15,),98,275.132233333333,315.67935,272559,272739,180
103,0,blank,0,270.215333333333,333.2506,272739,272834,95
103,0,blank,0,152.58175,310.331183333333,272865,273051,186
103,0,blank,0,206.0485,286.1547,273051,273240,189
103,0,blank,0,203.215083333333,281.341783333333,273240,273427,187
103,14,"Inputarrayelements\n",83,202.648366666667,290.581233333333,273427,273519,92
103,0,blank,0,-323,-105,273550,273683,133
103,0,blank,0,-323,-105,273833,273946,113
103,12,(,70,137.376566666667,257.8707,274169,274295,126
103,0,blank,0,191.2,338.7088,274295,274628,333
103,14,"Inputarrayelements\n",83,300.13695,296.21605,274660,274729,69
103,0,blank,0,155.451233333333,399.831533333333,274761,274957,196
103,0,blank,0,187.85336,420.9106,274957,275147,190
103,0,blank,0,209.067333333333,386.825166666667,275147,275239,92
103,21,"Sortedarrayis...\n",127,242.976025,458.625325,275305,275427,122
103,22,++,141,262.6375,481.5585,275519,275547,28
103,14,"Inputarrayelements\n",83,215.096783333333,309.23305,275579,275765,186
103,0,blank,0,202.61855,279.079325,275765,275896,131
103,0,blank,0,-323,-105,276029,276137,108
103,19,sorting,114,225.032,412.1014,276163,276188,25
103,0,blank,0,244.581716666667,434.259783333333,276241,276415,174
103,0,blank,0,278.12345,468.211575,276415,276540,125
103,0,blank,0,-323,-105,276571,276712,141
103,0,blank,0,253.842283333333,381.3752,276792,276983,191
103,19,sorting,114,227.581016666667,403.52475,276983,277170,187
103,19,sorting,114,234.305783333333,408.55885,277170,277353,183
103,19,sorting,114,231.243116666667,400.386566666667,277353,277536,183
103,0,blank,0,232.580366666667,396.8253,277536,277628,92
103,0,blank,0,1037.703,428.4601,277688,277875,187
103,0,blank,0,1041.5,430.9278,277875,277906,31
103,0,blank,0,1019.02266666667,179.346,277936,278030,94
103,0,blank,0,-323,-105,278093,278235,142
103,0,blank,0,-323,-105,278235,278310,75
103,0,blank,0,1048.82766666667,66.59245,278853,279051,198
103,0,blank,0,1048.87433333333,122.8136,279051,279246,195
103,0,blank,0,1056.60666666667,113.41425,279246,279437,191
103,0,blank,0,1056.7258,110.93458,279437,279599,162
103,0,blank,0,1044.478,130.053875,279599,279769,170
103,0,blank,0,1046.53183333333,120.764583333333,279769,279960,191
103,0,blank,0,1044.906,123.374116666667,279960,280154,194
103,0,blank,0,1042.4165,133.964516666667,280154,280346,192
103,0,blank,0,1042.38075,135.050725,280346,280475,129
104,40,b,229,184.8023,456.954,280896,280928,32
104,0,blank,0,1054.68166666667,548.406583333333,281026,281222,196
104,0,blank,0,1029.02166666667,578.015183333333,281222,281413,191
104,0,blank,0,1026.9266,569.75178,281413,281569,156
104,0,blank,0,-323,-105,281600,281753,153
104,0,blank,0,-323,-105,282096,282211,115
104,0,blank,0,75.0324,639.2825,282614,282755,141
104,0,blank,0,-323,-105,282874,283058,184
104,0,blank,0,158.0218,486.407183333333,283098,283285,187
104,42,big,241,162.67656,498.21474,283285,283457,172
104,0,blank,0,-323,-105,283492,283554,62
104,0,blank,0,114.232516666667,553.089416666667,283672,283856,184
104,45,findmax,261,195.223733333333,557.881066666667,283856,284051,195
104,45,findmax,261,192.334366666667,557.5342,284051,284247,196
104,0,blank,0,191.750766666667,544.981533333333,284247,284437,190
104,0,blank,0,136.766716666667,550.268883333333,284437,284628,191
104,45,findmax,261,147.5087,560.4186,284628,284660,32
104,0,blank,0,-323,-105,284692,284800,108
104,43,1,253,216.7513,527.4918,284826,284851,25
104,0,blank,0,214.800516666667,536.727033333333,284911,285092,181
104,0,blank,0,213.792066666667,537.771866666667,285092,285284,192
104,0,blank,0,211.4766,541.4526,285284,285316,32
104,0,blank,0,-323,-105,285348,285431,83
104,0,blank,0,184.4825,612.59,285456,285482,26
104,45,findmax,261,151.26365,557.558566666667,285536,285711,175
104,0,blank,0,145.673483333333,543.48865,285711,285898,187
104,0,blank,0,146.643633333333,551.0915,285898,286089,191
104,45,findmax,261,152.999733333333,556.8998,286089,286185,96
104,0,blank,0,-323,-105,286217,286350,133
104,0,blank,0,196.5142,533.4188,286376,286401,25
104,0,blank,0,188.080166666667,541.16025,286461,286639,178
104,0,blank,0,131.34626,577.56754,286639,286800,161
104,0,blank,0,-323,-105,286864,286917,53
104,45,findmax,261,162.689416666667,575.667533333333,287028,287211,183
104,0,blank,0,225.850416666667,581.748983333333,287211,287403,192
104,0,blank,0,144.035466666667,596.217633333333,287403,287594,191
104,0,blank,0,157.1902,598.7282,287594,287625,31
104,0,blank,0,315.7894,760.725766666667,287657,287852,195
104,0,blank,0,292.440533333333,765.736583333333,287852,288042,190
104,0,blank,0,272.734666666667,780.700716666667,288042,288238,196
104,0,blank,0,254.927466666667,775.998166666667,288238,288333,95
104,0,blank,0,-323,-105,288365,288499,134
104,43,;,254,147.926683333333,523.123383333333,288622,288819,197
104,0,blank,0,196.1463,538.1257,288819,288854,35
104,0,blank,0,-323,-105,288991,289168,177
104,0,blank,0,-323,-105,289168,289345,177
104,0,blank,0,-323,-105,289345,289519,174
104,0,blank,0,-323,-105,289519,289693,174
104,0,blank,0,-323,-105,289693,289873,180
104,0,blank,0,-323,-105,289873,290050,177
104,0,blank,0,-323,-105,290050,290217,167
104,0,blank,0,-323,-105,290217,290348,131
104,45,findmax,261,171.26095,555.5931,290382,290575,193
104,45,findmax,261,161.89205,565.636766666667,290575,290749,174
104,46,big,272,177.759583333333,585.231333333333,290749,290923,174
104,46,;,274,218.111425,587.54775,290923,291039,116
104,0,blank,0,-323,-105,291068,291122,54
104,0,blank,0,162.3055,747.4728,291148,291173,25
104,0,blank,0,111.706742857143,510.728457142857,291223,291411,188
104,0,blank,0,89.5566333333333,505.952833333333,291411,291498,87
104,42,big,241,166.4026,501.26772,291528,291698,170
104,45,findmax,261,187.7435,556.6132,291698,291735,37
104,0,blank,0,128.50974,513.20568,291771,291947,176
104,42,comma,242,140.21216,507.46034,291947,292134,187
104,0,blank,0,143.6518,539.112183333333,292134,292332,198
104,0,blank,0,265.782533333333,509.25975,292332,292504,172
104,0,blank,0,239.921071428571,488.190128571429,292504,292703,199
104,0,blank,0,248.469642857143,451.327657142857,292703,292902,199
104,0,blank,0,186.65138,422.74828,292902,293046,144
104,0,blank,0,330.353383333333,443.589066666667,293074,293248,174
104,0,blank,0,179.345542857143,512.078528571429,293279,293478,199
104,0,blank,0,175.507333333333,484.8751,293478,293650,172
104,43,j,255,249.041257142857,513.587514285714,293650,293847,197
104,43,j,255,250.34675,526.87275,293847,293904,57
104,0,blank,0,-323,-105,293967,294069,102
104,0,blank,0,230.523542857143,498.106614285714,294193,294390,197
104,0,blank,0,238.877166666667,506.246383333333,294390,294570,180
104,43,--,256,258.33895,521.9132,294570,294697,127
104,0,blank,0,278.3743,509.9271,294697,294913,216
104,0,blank,0,273.648825,510.086025,294913,295047,134
104,0,blank,0,-323,-105,295111,295198,87
104,0,blank,0,-323,-105,295333,295507,174
104,0,blank,0,-323,-105,295507,295691,184
104,0,blank,0,-323,-105,295691,295816,125
104,0,blank,0,-323,-105,295816,295942,126
104,0,blank,0,235.4379,546.33706,295986,296155,169
104,45,;,267,275.90744,564.30192,296155,296314,159
104,0,blank,0,-323,-105,296347,296498,151
104,0,blank,0,-323,-105,296498,296550,52
104,0,blank,0,-323,-105,297010,297055,45
104,0,blank,0,-323,-105,297320,297774,454
104,0,blank,0,-323,-105,297774,298017,243
104,0,blank,0,-323,-105,298017,298157,140
104,0,blank,0,-323,-105,298235,298339,104
104,0,blank,0,-323,-105,298339,298601,262
104,0,blank,0,-323,-105,298601,299083,482
104,0,blank,0,-323,-105,299083,299273,190
104,0,blank,0,-323,-105,299273,299414,141
104,0,blank,0,-323,-105,299414,299513,99
104,0,blank,0,-323,-105,299513,299636,123
104,0,blank,0,-323,-105,299636,299732,96
104,0,blank,0,-323,-105,299732,299878,146
104,0,blank,0,-323,-105,299878,300378,500
104,0,blank,0,-323,-105,300378,300685,307
104,0,blank,0,-323,-105,300685,300889,204
104,0,blank,0,-323,-105,300889,301045,156
104,0,blank,0,-323,-105,301045,301187,142
104,0,blank,0,-323,-105,301187,301379,192
104,0,blank,0,-323,-105,301379,301634,255
104,0,blank,0,-323,-105,301634,301978,344
104,0,blank,0,-323,-105,301978,302160,182
104,0,blank,0,-323,-105,302160,302231,71
104,0,blank,0,-323,-105,302231,302519,288
104,0,blank,0,-323,-105,302519,303642,1123
104,0,blank,0,-323,-105,303642,303820,178
104,0,blank,0,228.604933333333,538.543166666667,303861,303998,137
104,0,blank,0,595.4719,791.684,304077,304109,32
104,0,blank,0,596.121,783.9332,304171,304201,30
104,0,blank,0,-323,-105,304232,304339,107
104,0,blank,0,125.1263,533.309,304376,304424,48
104,0,blank,0,168.458366666667,543.487816666667,304490,304669,179
104,0,blank,0,187.654483333333,551.3841,304669,304856,187
104,45,findmax,261,213.981933333333,557.794516666667,304856,305043,187
104,45,findmax,261,200.35915,555.3292,305043,305227,184
104,45,findmax,261,199.983,556.369316666667,305227,305411,184
104,45,findmax,261,146.230066666667,568.176783333333,305411,305594,183
104,0,blank,0,-323,-105,305625,305681,56
104,0,blank,0,166.5444,794.0364,305707,305733,26
104,45,findmax,261,181.962483333333,555.690666666667,305785,305954,169
104,45,findmax,261,198.790183333333,557.1739,305954,306141,187
104,45,comma,264,234.166766666667,556.900716666667,306141,306327,186
104,45,b,263,228.920566666667,559.100466666667,306327,306509,182
104,45,b,263,232.2301,557.812366666667,306509,306692,183
104,45,findmax,261,182.9529,571.2815,306692,306875,183
104,46,temp,268,114.88075,579.0856,306875,307059,184
104,0,blank,0,155.99088,577.55342,307059,307213,154
104,0,blank,0,-323,-105,307244,307326,82
104,0,blank,0,124.9904,579.7089,307352,307377,25
104,45,=,260,133.306266666667,575.28935,307436,307606,170
104,0,blank,0,233.062333333333,545.928616666667,307637,307823,186
104,45,b,263,230.483433333333,558.220083333333,307823,308007,184
104,45,comma,264,234.46525,556.8016,308007,308070,63
104,0,blank,0,77.7580833333333,590.0616,308101,308287,186
104,46,temp,268,97.9321333333333,591.11005,308287,308468,181
104,46,temp,268,123.509883333333,586.432433333333,308468,308645,177
104,46,temp,268,120.33462,588.25482,308645,308791,146
104,0,blank,0,-323,-105,308820,308874,54
104,0,blank,0,65.3665,-103.8109,308900,308926,26
104,45,big,259,109.072,562.054633333333,308996,309074,78
104,45,b,263,225.104533333333,561.18305,309103,309280,177
104,45,(,262,221.94095,569.05675,309280,309341,61
104,0,blank,0,-323,-105,309400,309558,158
104,0,blank,0,128.341933333333,541.66655,309675,309848,173
104,0,blank,0,177.559883333333,543.32375,309848,310028,180
104,0,blank,0,219.0134,548.948016666667,310028,310211,183
104,0,blank,0,222.5095,546.5892,310211,310272,61
104,0,blank,0,-323,-105,310302,310408,106
104,45,findmax,261,166.9466,556.8223,310434,310460,26
104,45,findmax,261,170.276716666667,557.726416666667,310522,310695,173
104,0,blank,0,170.9491,544.7674,310695,310726,31
104,0,blank,0,-323,-105,310756,310886,130
104,0,blank,0,208.1477,544.0213,310912,310949,37
104,0,blank,0,206.1223,545.25655,311015,311186,171
104,0,blank,0,90.5307,550.589933333333,311186,311368,182
104,45,big,259,93.1676,564.9919,311368,311398,30
104,0,blank,0,222.63715,550.758366666667,311428,311608,180
104,0,blank,0,222.4382,547.835016666667,311608,311790,182
104,45,(,262,222.919833333333,558.452033333333,311790,311883,93
104,0,blank,0,-323,-105,311913,312054,141
104,0,blank,0,198.8642,550.540766666667,312082,312254,172
104,45,findmax,261,196.41395,561.4512,312254,312315,61
104,45,big,259,100.473016666667,558.5365,312345,312529,184
104,0,blank,0,167.768633333333,551.601,312529,312715,186
104,45,(,262,222.86332,572.88652,312715,312869,154
104,0,blank,0,-323,-105,312900,312954,54
104,0,blank,0,262.8394,652.6203,312979,313005,26
104,0,blank,0,207.722283333333,552.59245,313057,313227,170
104,45,b,263,230.27735,557.863583333333,313227,313411,184
104,45,b,263,233.39955,559.83535,313411,313593,182
104,45,(,262,218.906783333333,556.17305,313593,313774,181
104,45,findmax,261,214.0673,569.3422,313774,313804,30
104,45,big,259,86.3291,556.635416666667,313835,314017,182
104,0,blank,0,171.584033333333,548.654033333333,314017,314201,184
104,45,findmax,261,190.491916666667,557.39115,314201,314385,184
104,45,=,260,127.116625,572.01155,314385,314509,124
104,0,blank,0,-323,-105,314539,314620,81
104,0,blank,0,128.2805,-103.9651,314645,314671,26
104,46,temp,268,120.84875,578.501316666667,314722,314894,172
104,0,blank,0,84.1464666666667,577.541566666667,314894,315078,184
104,46,temp,268,85.66885,582.856166666667,315078,315264,186
104,46,temp,268,85.3695666666667,587.407583333333,315264,315448,184
104,0,blank,0,152.372716666667,583.012366666667,315448,315633,185
104,45,findmax,261,156.597733333333,574.609316666667,315633,315821,188
104,46,b,270,153.750333333333,587.412366666667,315821,315912,91
104,0,blank,0,-323,-105,315943,315973,30
104,0,blank,0,247.3271,541.232866666667,316049,316225,176
104,0,blank,0,220.935016666667,550.080866666667,316225,316412,187
104,45,(,262,218.669733333333,556.9896,316412,316597,185
104,45,(,262,221.3978,562.3713,316597,316628,31
104,0,blank,0,-323,-105,316659,316842,183
104,0,blank,0,-323,-105,316842,317016,174
104,0,blank,0,-323,-105,317016,317209,193
104,0,blank,0,-323,-105,317209,317386,177
104,0,blank,0,-323,-105,317386,317546,160
104,0,blank,0,-323,-105,317546,317732,186
104,0,blank,0,-323,-105,317732,317843,111
104,0,blank,0,-323,-105,317843,318041,198
104,0,blank,0,-323,-105,318041,318163,122
104,47,j,282,199.5928,604.0103,318202,318244,42
104,0,blank,0,-323,-105,318402,318595,193
104,47,b,280,178.446766666667,609.897683333333,318632,318808,176
104,47,[,281,185.380814285714,606.5267,318808,319004,196
104,47,b,280,181.815128571429,614.706214285714,319004,319202,198
104,46,temp,268,112.020571428571,592.246228571428,319202,319399,197
104,46,[,271,172.0286,590.470128571429,319399,319596,197
104,46,big,272,180.635471428571,584.687728571429,319596,319795,199
104,45,big,259,94.7498428571429,571.4705,319823,320022,199
104,46,temp,268,90.9492857142857,578.620028571429,320022,320217,195
104,45,big,259,98.2756857142857,571.912414285714,320217,320415,198
104,46,b,270,153.192,588.78255,320415,320529,114
104,0,blank,0,-323,-105,320587,320615,28
104,0,blank,0,223.7617,663.7977,320665,320689,24
104,45,findmax,261,204.148314285714,565.531128571429,320715,320903,188
104,45,findmax,261,207.53532,559.16384,320903,321074,171
104,46,big,272,181.84615,588.311583333333,321074,321245,171
104,0,blank,0,150.85165,585.432375,321245,321358,113
104,0,blank,0,-323,-105,321386,321546,160
104,47,b,280,183.028257142857,600.537857142857,321578,321772,194
104,46,big,272,204.290014285714,579.302171428571,321772,321970,198
104,0,blank,0,101.7958,540.5799,321970,321999,29
104,45,big,259,96.52294,574.6543,322026,322169,143
104,0,blank,0,172.767228571429,532.417457142857,322197,322394,197
104,0,blank,0,191.619228571429,550.040814285714,322394,322587,193
104,45,big,259,99.3418285714286,559.284357142857,322644,322842,198
104,0,blank,0,-323,-105,322871,322950,79
104,0,blank,0,219.671,637.1066,322975,323000,25
104,0,blank,0,102.804933333333,510.429266666667,323051,323249,198
104,0,blank,0,89.1369,510.53715,323249,323349,100
104,0,blank,0,143.828,482.6598,323349,323467,118
104,0,blank,0,-323,-105,323594,323745,151
104,0,blank,0,119.9781,483.5569,323829,323913,84
104,0,blank,0,131.514,517.5604,324187,324251,64
104,0,blank,0,-323,-105,324300,324454,154
104,43,k,249,141.576816666667,527.03205,324681,324870,189
104,42,temp,239,126.81595,501.951516666667,324870,325065,195
104,43,>=,252,191.0561,515.303733333333,325065,325259,194
104,43,>=,252,185.75535,516.82945,325259,325322,63
104,0,blank,0,-323,-105,325387,325417,30
104,0,blank,0,225.300875,540.304325,325469,325582,113
104,43,j,255,102.099066666667,518.595033333333,325617,325810,193
104,42,temp,239,126.40905,507.2997,325810,326001,191
104,0,blank,0,156.905166666667,489.84135,326001,326190,189
104,42,temp,239,130.258133333333,493.53475,326190,326379,189
104,42,temp,239,111.49395,501.874,326379,326565,186
104,42,comma,242,134.692916666667,508.218616666667,326565,326754,189
104,0,blank,0,-323,-105,326820,326952,132
104,0,blank,0,204.572366666667,474.344866666667,326978,327155,177
104,0,blank,0,230.168266666667,444.0548,327155,327347,192
104,0,blank,0,248.912516666667,456.035083333333,327347,327540,193
104,0,blank,0,175.41272,529.35846,327540,327730,190
104,42,big,241,161.468083333333,499.81755,327730,327922,192
104,42,big,241,172.707716666667,506.085133333333,327922,328109,187
104,0,blank,0,205.10005,532.630166666667,328109,328305,196
104,45,(,262,222.144583333333,559.1898,328305,328498,193
104,45,findmax,261,197.1283,559.205225,328498,328627,129
104,0,blank,0,-323,-105,328659,328768,109
104,46,temp,268,116.803433333333,584.8326,328792,328872,80
104,0,blank,0,-323,-105,328904,329041,137
104,0,blank,0,132.075833333333,578.382516666667,329064,329243,179
104,45,findmax,261,167.1999,574.030933333333,329243,329434,191
104,0,blank,0,146.50434,581.83124,329434,329626,192
104,0,blank,0,63.5310833333333,584.232383333333,329626,329809,183
104,0,blank,0,134.1066,574.994366666667,329809,329998,189
104,0,blank,0,132.9765,579.73785,329998,330191,193
104,0,blank,0,141.8082,577.4235,330191,330222,31
104,0,blank,0,107.908983333333,364.479183333333,330335,330518,183
104,0,blank,0,99.1486333333334,356.2414,330518,330707,189
104,0,blank,0,112.133216666667,292.852883333333,330707,330896,189
104,0,blank,0,135.4904,285.6784,330896,330927,31
104,0,blank,0,-323,-105,330959,331018,59
104,0,blank,0,201.0992,320.573,331043,331069,26
104,31,j,196,170.1744,266.2257,331136,331317,181
104,0,blank,0,159.751083333333,269.533133333333,331317,331501,184
104,0,blank,0,158.909866666667,266.3196,331501,331683,182
104,0,blank,0,137.36025,271.082466666667,331683,331864,181
104,0,blank,0,126.61605,280.8294,331864,331926,62
104,0,blank,0,-323,-105,331956,332064,108
104,0,blank,0,116.0348,243.5613,332091,332117,26
104,30,max,180,109.971816666667,233.9086,332170,332341,171
104,0,blank,0,88.0207,216.210966666667,332341,332526,185
104,0,blank,0,88.5166,209.9233,332526,332588,62
104,31,<=,193,198.673816666667,263.49945,332618,332800,182
104,0,blank,0,156.151683333333,261.018733333333,332800,332983,183
104,31,=,189,117.217,257.2278,332983,333044,61
104,0,blank,0,-323,-105,333074,333156,82
104,0,blank,0,115.7079,229.7904,333182,333219,37
104,30,max,180,113.636966666667,229.657283333333,333282,333458,176
104,0,blank,0,109.7551,224.047483333333,333458,333641,183
104,0,blank,0,116.555216666667,233.680633333333,333641,333821,180
104,0,blank,0,144.620133333333,208.216916666667,333821,334001,180
104,28,int,175,130.606766666667,199.688416666667,334001,334181,180
104,0,blank,0,154.11455,247.354583333333,334181,334364,183
104,0,blank,0,153.761766666667,248.632866666667,334364,334547,183
104,0,blank,0,168.6355,222.269716666667,334547,334732,185
104,0,blank,0,164.3418,216.9232,334732,334825,93
104,0,blank,0,-323,-105,334856,334937,81
104,0,blank,0,172.9041,220.7036,334963,334988,25
104,0,blank,0,184.677116666667,217.20365,335041,335215,174
104,0,blank,0,143.417433333333,213.552316666667,335215,335400,185
104,28,findmax,167,111.140483333333,200.122633333333,335400,335585,185
104,28,findmax,167,90.3769166666667,199.4198,335585,335767,182
104,28,int,175,129.414766666667,196.183633333333,335767,335952,185
104,28,int,175,136.900233333333,197.05585,335952,336139,187
104,0,blank,0,125.880433333333,202.525716666667,336139,336323,184
104,28,b,170,171.01985,196.5023,336323,336506,183
104,28,[,171,176.77495,199.72255,336506,336690,184
104,0,blank,0,133.04735,225.1478,336690,336874,184
104,0,blank,0,133.967683333333,212.99355,336874,337060,186
104,0,blank,0,144.9548,210.20162,337060,337218,158
104,0,blank,0,-323,-105,337249,337280,31
104,28,[,171,180.582,182.7727,337305,337330,25
104,0,blank,0,-323,-105,337412,337539,127
104,30,j,184,174.991,232.0252,337580,337635,55
104,30,;,185,190.79932,228.35586,337704,337875,171
104,0,blank,0,198.48525,212.768183333333,337875,338059,184
104,0,blank,0,209.72884,215.08392,338059,338210,151
104,0,blank,0,-323,-105,338242,338349,107
104,30,max,180,84.7096,233.7733,338391,338444,53
104,30,max,180,112.24535,229.809916666667,338510,338688,178
104,0,blank,0,138.980633333333,221.12115,338688,338879,191
104,0,blank,0,188.378483333333,224.445783333333,338879,339068,189
104,0,blank,0,192.407633333333,228.087616666667,339068,339254,186
104,0,blank,0,221.474766666667,235.867366666667,339254,339446,192
104,30,;,185,186.3425,242.116433333333,339446,339633,187
104,0,blank,0,173.403816666667,255.540466666667,339633,339816,183
104,33,[,208,136.749583333333,291.99715,339816,340000,184
104,33,b,207,133.445366666667,294.671183333333,340000,340177,177
104,33,b,207,133.065666666667,293.90155,340177,340352,175
104,0,blank,0,153.91465,260.73375,340352,340411,59
104,0,blank,0,-323,-105,340440,340546,106
104,0,blank,0,148.414828571429,316.099885714286,340571,340762,191
104,33,[,208,141.42315,311.199283333333,340762,340944,182
104,0,blank,0,121.66085,334.81925,340944,341127,183
104,33,if,200,99.3794333333333,297.964116666667,341127,341315,188
104,0,blank,0,118.86015,290.521883333333,341315,341504,189
104,0,blank,0,134.320783333333,288.876416666667,341504,341695,191
104,0,blank,0,173.161783333333,282.721366666667,341695,341884,189
104,0,blank,0,179.231933333333,256.9494,341884,342072,188
104,30,0,182,153.72325,229.7881,342072,342261,189
104,31,<=,193,193.740133333333,266.973666666667,342261,342449,188
104,0,blank,0,207.213816666667,265.717433333333,342449,342637,188
104,0,blank,0,198.929216666667,270.34515,342637,342829,192
104,0,blank,0,195.7648,272.117266666667,342829,343019,190
104,35,max,213,123.79845,340.2592,343019,343212,193
104,0,blank,0,140.91485,322.489583333333,343212,343401,189
104,33,],210,158.634033333333,311.5643,343401,343591,190
104,0,blank,0,205.658275,264.74155,343591,343755,164
104,0,blank,0,207.726,272.8568,343755,343871,116
104,0,blank,0,169.72255,275.91815,343871,344065,194
104,0,blank,0,125.990016666667,289.47525,344065,344263,198
104,33,b,207,129.346433333333,291.8658,344263,344447,184
104,0,blank,0,-323,-105,344507,344535,28
104,0,blank,0,129.09405,258.440816666667,344635,344812,177
104,0,blank,0,124.9467,267.6168,344812,344844,32
104,0,blank,0,-323,-105,344874,344957,83
104,0,blank,0,150.0794,274.1115,344991,345041,50
104,0,blank,0,143.685216666667,375.425216666667,345131,345317,186
104,0,blank,0,129.1023,516.0848,345317,345350,33
104,0,blank,0,-323,-105,345412,345538,126
104,0,blank,0,-323,-105,345538,345888,350
104,0,blank,0,-323,-105,345888,345997,109
104,42,big,241,172.07105,502.9454,346149,346215,66
104,45,big,259,104.895916666667,564.918516666667,346249,346444,195
104,0,blank,0,144.489966666667,546.959233333333,346444,346638,194
104,45,findmax,261,151.8707,560.74025,346638,346703,65
104,0,blank,0,-323,-105,346735,346792,57
104,45,=,260,125.2649,572.4669,346818,346843,25
104,42,temp,239,133.38855,503.644566666667,346896,347067,171
104,42,temp,239,129.02665,504.619133333333,347067,347252,185
104,0,blank,0,131.88255,534.945,347252,347314,62
104,0,blank,0,-323,-105,347345,347452,107
104,0,blank,0,107.8136,526.5535,347477,347503,26
104,0,blank,0,143.66275,536.07365,347568,347745,177
104,45,findmax,261,147.254583333333,564.105616666667,347745,347932,187
104,45,big,259,88.5155,566.624233333333,347932,348119,187
104,0,blank,0,162.0875,553.374383333333,348119,348306,187
104,0,blank,0,166.53505,550.661583333333,348306,348493,187
104,45,big,259,87.9912166666667,570.59475,348493,348682,189
104,0,blank,0,134.157183333333,572.540433333333,348682,348871,189
104,45,findmax,261,149.864333333333,574.463733333333,348871,349061,190
104,46,b,270,157.3139,579.923,349061,349093,32
104,0,blank,0,-323,-105,349126,349260,134
104,45,big,259,106.902,574.003666666667,349288,349466,178
104,45,big,259,86.3628666666667,567.687316666667,349466,349659,193
104,45,big,259,87.0585833333333,573.896133333333,349659,349849,190
104,0,blank,0,126.423333333333,578.7154,349849,350040,191
104,45,findmax,261,147.01615,573.609133333333,350040,350228,188
104,46,=,269,137.395733333333,585.229466666667,350228,350417,189
104,48,b,285,85.4320833333333,622.1284,350417,350607,190
104,0,blank,0,65.5573166666667,647.3377,350607,350798,191
104,0,blank,0,82.2715333333333,641.96475,350798,350989,191
104,0,blank,0,150.024233333333,611.106366666667,350989,351084,95
104,0,blank,0,-323,-105,351117,351174,57
104,0,blank,0,80.8558166666667,659.914866666667,351224,351400,176
104,0,blank,0,84.33875,660.986625,351400,351529,129
104,42,temp,239,114.412266666667,500.933616666667,351561,351756,195
104,42,temp,239,121.07038,500.3493,351756,351917,161
104,0,blank,0,195.354275,509.337525,351917,352116,199
104,42,big,241,158.930966666667,496.849866666667,352116,352306,190
104,43,;,254,150.5503,514.15065,352306,352369,63
104,0,blank,0,-323,-105,352431,352456,25
104,42,comma,242,134.8664,495.9983,352510,352535,25
104,0,blank,0,-323,-105,352560,352743,183
104,0,blank,0,-323,-105,352743,352922,179
104,0,blank,0,-323,-105,352922,353102,180
104,0,blank,0,-323,-105,353102,353245,143
104,0,blank,0,128.0087,160.273,353280,353327,47
104,0,blank,0,205.2144,206.772,353327,353877,550
104,28,],173,205.17826,188.19742,353877,354049,172
104,27,find,160,175.861,173.75375,354049,354162,113
104,0,blank,0,-323,-105,354332,354404,72
104,0,blank,0,199.7133,237.781457142857,354533,354728,195
104,0,blank,0,161.90785,510.767616666667,354756,354929,173
104,0,blank,0,160.843666666667,522.7291,354929,355103,174
104,0,blank,0,159.115733333333,519.680333333333,355103,355190,87
104,0,blank,0,175.329866666667,453.071783333333,355220,355391,171
104,40,int,234,171.578666666667,447.9875,355391,355563,172
104,40,(,227,138.1142,451.716966666667,355563,355738,175
104,40,int,234,159.883183333333,458.803183333333,355738,355912,174
104,40,b,229,192.77638,457.8415,355912,356058,146
104,0,blank,0,-323,-105,356087,356217,130
104,0,blank,0,186.381233333333,423.796866666667,356241,356402,161
104,0,blank,0,200.655033333333,118.7054,356432,356607,175
104,28,comma,174,216.0769,194.92555,356607,356783,176
104,0,blank,0,212.432166666667,191.284916666667,356783,356957,174
104,0,blank,0,232.139983333333,181.36895,356957,357132,175
104,0,blank,0,203.811816666667,175.428633333333,357132,357305,173
104,0,blank,0,156.7522,181.092925,357305,357423,118
104,0,blank,0,218.4335,440.479616666667,357449,357623,174
104,0,blank,0,208.134983333333,466.71695,357623,357800,177
104,40,[,230,196.476133333333,451.68175,357800,357974,174
104,0,blank,0,181.9103,472.1735,357974,358122,148
104,0,blank,0,-323,-105,358151,358287,136
104,40,10,231,211.571342857143,456.6027,358314,358509,195
104,40,int,234,257.334283333333,465.986433333333,358509,358687,178
104,0,blank,0,207.2293,469.669666666667,358687,358863,176
104,40,int,234,163.55505,448.32695,358863,359037,174
104,40,int,234,169.475033333333,457.4434,359037,359213,176
104,40,int,234,172.824783333333,456.60335,359213,359387,174
104,0,blank,0,-323,-105,359417,359496,79
104,0,blank,0,167.8201,609.3149,359521,359547,26
104,40,10,231,209.000666666667,460.261333333333,359597,359672,75
104,0,blank,0,156.498316666667,171.427583333333,359728,359904,176
104,27,find,160,192.03455,175.346783333333,359904,360080,176
104,27,the,161,227.5565,176.0405,360080,360253,173
104,0,blank,0,-323,-105,360283,360448,165
104,27,find,160,193.38635,169.413575,360476,360581,105
104,0,blank,0,212.158133333333,480.600133333333,360612,360784,172
104,0,blank,0,194.576533333333,437.3901,360784,360960,176
104,40,int,234,150.595383333333,463.627516666667,360960,361135,175
104,0,blank,0,48.4844,453.5345,361164,361338,174
104,0,blank,0,45.4809666666667,461.37425,361338,361512,174
104,0,blank,0,82.3823,149.909466666667,361541,361715,174
104,28,findmax,167,99.2272,187.2792,361715,361914,199
104,0,blank,0,106.1526,206.107,361914,361943,29
104,0,blank,0,-323,-105,361972,362051,79
104,0,blank,0,157.459842857143,163.589228571429,362158,362352,194
104,0,blank,0,159.966466666667,159.945,362352,362440,88
104,0,blank,0,-323,-105,362470,362578,108
104,45,=,260,132.461616666667,569.79495,362720,362895,175
104,0,blank,0,132.520583333333,224.279416666667,362927,363126,199
104,0,blank,0,134.8655,221.7044,363126,363155,29
104,0,blank,0,-323,-105,363186,363242,56
104,0,blank,0,164.657216666667,178.25655,363351,363526,175
104,0,blank,0,165.891316666667,155.939766666667,363526,363718,192
104,0,blank,0,160.5667,158.3151,363718,363750,32
104,42,comma,242,185.32995,506.644033333333,363780,363971,191
104,0,blank,0,152.556725,438.231825,363971,364134,163
104,0,blank,0,195.1479,427.1213,364134,364255,121
104,0,blank,0,188.68085,434.3524,364255,364447,192
104,0,blank,0,187.948966666667,435.437566666667,364447,364636,189
104,0,blank,0,191.6039,443.3424,364636,364668,32
104,0,blank,0,-323,-105,364699,364756,57
104,0,blank,0,146.5926,744.5451,364782,364808,26
104,0,blank,0,152.904933333333,501.5611,364860,365035,175
104,42,big,241,154.7487,502.7042,365035,365225,190
104,0,blank,0,214.77995,436.332683333333,365225,365413,188
104,0,blank,0,219.646,431.772,365413,365507,94
104,0,blank,0,-323,-105,365538,365723,185
104,0,blank,0,-323,-105,365723,365901,178
104,0,blank,0,-323,-105,365901,366079,178
104,0,blank,0,-323,-105,366079,366256,177
104,0,blank,0,-323,-105,366256,366442,186
104,0,blank,0,-323,-105,366442,366679,237
104,0,blank,0,-323,-105,366679,366762,83
104,0,blank,0,-323,-105,366762,366934,172
104,0,blank,0,-323,-105,366934,367110,176
104,0,blank,0,-323,-105,367110,367287,177
104,0,blank,0,-323,-105,367287,367484,197
104,0,blank,0,-323,-105,367484,367515,31
104,0,blank,0,-323,-105,367515,367694,179
104,0,blank,0,-323,-105,367694,367721,27
104,0,blank,0,-323,-105,367721,367900,179
104,0,blank,0,-323,-105,367900,368114,214
104,0,blank,0,-323,-105,368114,368307,193
104,0,blank,0,-323,-105,368307,368493,186
104,0,blank,0,-323,-105,368493,368673,180
104,0,blank,0,-323,-105,368673,368853,180
104,0,blank,0,-323,-105,368853,369034,181
104,0,blank,0,-323,-105,369034,369205,171
104,0,blank,0,-323,-105,369205,369293,88
104,0,blank,0,-323,-105,369293,369430,137
104,0,blank,0,-323,-105,369430,369588,158
104,0,blank,0,-323,-105,369588,369771,183
104,0,blank,0,-323,-105,369771,369965,194
104,0,blank,0,-323,-105,369965,370040,75
104,40,int,234,153.6893,460.5439,370212,370247,35
104,0,blank,0,178.3891,459.6607,370247,370416,169
104,0,blank,0,193.546266666667,483.673666666667,370521,370708,187
104,0,blank,0,199.2377,487.31675,370708,370884,176
104,40,[,230,199.16415,446.282025,370884,371066,182
104,0,blank,0,180.6879,447.3777,371066,371110,44
104,0,blank,0,-323,-105,371157,371355,198
104,0,blank,0,-323,-105,371355,371533,178
104,0,blank,0,-323,-105,371533,371724,191
104,0,blank,0,-323,-105,371724,371879,155
104,40,comma,233,234.85235,446.5157,372024,372195,171
104,0,blank,0,242.667416666667,431.742133333333,372195,372385,190
104,0,blank,0,246.0052,427.5616,372385,372417,32
104,0,blank,0,-323,-105,372449,372558,109
104,42,big,241,177.5102,496.9932,372607,372668,61
104,42,temp,239,125.280833333333,499.769916666667,372738,372917,179
104,42,temp,239,105.939733333333,508.96845,372917,373107,190
104,0,blank,0,149.132216666667,506.007366666667,373107,373297,190
104,43,>=,252,184.856033333333,511.0702,373297,373487,190
104,43,>=,252,189.3573,519.445375,373487,373612,125
104,0,blank,0,-323,-105,373644,373700,56
104,0,blank,0,193.4442,685.1218,373725,373751,26
104,42,big,241,162.006533333333,496.975516666667,373802,373979,177
104,42,big,241,164.156916666667,507.064983333333,373979,374170,191
104,42,temp,239,121.68165,502.14525,374170,374361,191
104,42,big,241,179.352683333333,499.756583333333,374361,374551,190
104,42,j,243,208.0596,503.8231,374551,374582,31
104,42,temp,239,99.6287666666667,501.58235,374613,374800,187
104,42,temp,239,121.22865,506.2606,374800,374990,190
104,42,temp,239,127.8518,505.6774,374990,375022,32
104,0,blank,0,-323,-105,375085,375163,78
104,42,big,241,171.7026,500.1064,375189,375214,25
104,42,big,241,173.8644,500.9972,375274,375454,180
104,42,big,241,180.097383333333,504.05105,375454,375644,190
104,42,comma,242,135.90315,508.889216666667,375644,375833,189
104,0,blank,0,129.119733333333,515.26825,375833,376019,186
104,0,blank,0,124.8588,527.9123,376019,376050,31
104,0,blank,0,-323,-105,376081,376271,190
104,0,blank,0,-323,-105,376271,376328,57
104,0,blank,0,246.398528571429,475.536757142857,376362,376558,196
104,0,blank,0,254.122816666667,469.269216666667,376558,376738,180
104,0,blank,0,-323,-105,376767,376849,82
104,42,j,243,203.067,509.6392,376874,376900,26
104,40,],232,224.32105,462.4653,376955,377122,167
104,0,blank,0,103.831316666667,516.580466666667,377153,377342,189
104,0,blank,0,125.051,516.008933333333,377342,377529,187
104,43,;,254,151.368583333333,516.222266666667,377529,377722,193
104,0,blank,0,152.05655,509.1349,377722,377921,199
104,0,blank,0,193.248783333333,504.7402,377921,378118,197
104,0,blank,0,-323,-105,378151,378210,59
104,46,big,272,187.5577,583.1907,378236,378263,27
104,42,big,241,167.060783333333,496.16425,378322,378506,184
104,0,blank,0,134.5483,488.282016666667,378506,378701,195
104,42,temp,239,123.462783333333,490.878683333333,378701,378896,195
104,42,temp,239,133.287216666667,491.234216666667,378896,379089,193
104,42,big,241,179.69425,491.61935,379089,379283,194
104,42,big,241,181.69655,492.3339,379283,379347,64
104,0,blank,0,-323,-105,379380,379437,57
104,42,comma,242,189.860433333333,498.270666666667,379513,379696,183
104,0,blank,0,203.8375,550.125716666667,379696,379889,193
104,0,blank,0,211.511383333333,548.805466666667,379889,380083,194
104,43,>=,252,191.963033333333,530.40365,380083,380275,192
104,42,big,241,162.948333333333,504.74835,380275,380467,192
104,42,comma,242,190.628766666667,499.796716666667,380467,380660,193
104,42,comma,242,190.8416,501.137633333333,380660,380851,191
104,0,blank,0,207.4785,535.84005,380851,381044,193
104,0,blank,0,207.92435,543.607633333333,381044,381236,192
104,0,blank,0,137.952233333333,557.008766666667,381236,381428,192
104,45,=,260,132.193016666667,567.262616666667,381428,381620,192
104,45,findmax,261,150.784916666667,565.976933333333,381620,381812,192
104,0,blank,0,180.483433333333,536.5041,381812,382004,192
104,42,big,241,167.772083333333,501.2082,382004,382200,196
104,42,temp,239,115.326833333333,493.6381,382200,382297,97
104,0,blank,0,-323,-105,382330,382412,82
104,0,blank,0,179.0276,489.6866,382437,382463,26
104,42,big,241,177.348616666667,492.125316666667,382533,382715,182
104,42,big,241,177.482466666667,495.6743,382715,382811,96
104,0,blank,0,-323,-105,382843,382987,144
104,43,>=,252,184.460116666667,519.799066666667,383013,383190,177
104,0,blank,0,126.090733333333,517.3864,383190,383386,196
104,0,blank,0,103.171083333333,511.458383333333,383386,383580,194
104,0,blank,0,109.0318,515.5506,383580,383766,186
104,0,blank,0,106.563333333333,526.6874,383766,383950,184
104,27,to,159,135.677983333333,161.74895,383981,384158,177
104,0,blank,0,200.054116666667,233.002316666667,384187,384365,178
104,0,blank,0,207.355225,244.1975,384365,384514,149
104,31,<=,193,193.47695,267.93195,384514,384696,182
104,31,<=,193,187.78975,267.17915,384696,384856,160
104,0,blank,0,186.63926,268.41972,384856,385023,167
104,0,blank,0,-323,-105,385053,385109,56
104,35,=,214,168.6193,346.0989,385135,385161,26
104,30,j,184,177.026083333333,236.454333333333,385210,385383,173
104,0,blank,0,169.2298,227.9065,385383,385569,186
104,0,blank,0,167.7431,221.674233333333,385569,385751,182
104,0,blank,0,116.13365,243.747066666667,385751,385932,181
104,0,blank,0,119.383616666667,223.254933333333,385932,386121,189
104,0,blank,0,127.596316666667,215.15555,386121,386304,183
104,0,blank,0,169.389816666667,214.964916666667,386304,386483,179
104,0,blank,0,178.472433333333,218.864866666667,386483,386666,183
104,0,blank,0,179.898,217.5269,386666,386697,31
104,0,blank,0,-323,-105,386727,386783,56
104,33,b,207,203.5793,291.0152,386808,386833,25
104,0,blank,0,205.217683333333,216.17445,386885,387056,171
104,0,blank,0,161.81645,218.767966666667,387056,387241,185
104,0,blank,0,116.606466666667,228.541983333333,387241,387426,185
104,0,blank,0,120.983466666667,234.07815,387426,387605,179
104,0,blank,0,201.170283333333,244.616183333333,387605,387787,182
104,0,blank,0,151.966533333333,272.77315,387787,387970,183
104,0,blank,0,116.86635,284.3426,387970,388032,62
104,0,blank,0,-323,-105,388063,388118,55
104,0,blank,0,-323,-105,388170,388198,28
104,31,j,196,170.4688,266.41415,388224,388404,180
104,0,blank,0,172.6582,297.208566666667,388404,388497,93
104,0,blank,0,-323,-105,388529,388582,53
104,0,blank,0,196.2407,368.0349,388608,388633,25
104,31,<=,193,188.582766666667,248.235333333333,388685,388855,170
104,30,;,185,188.74865,243.5163,388855,388978,123
104,0,blank,0,194.25205,467.821766666667,389009,389192,183
104,0,blank,0,182.4844,453.52225,389192,389373,181
104,40,int,234,169.026983333333,451.6521,389373,389552,179
104,40,int,234,170.100733333333,454.21425,389552,389735,183
104,0,blank,0,-323,-105,389765,389948,183
104,0,blank,0,-323,-105,389948,389974,26
104,28,],173,209.8568,192.4437,390173,390200,27
104,0,blank,0,231.4545,233.6458,390200,390514,314
104,0,blank,0,133.126866666667,269.951,390552,390740,188
104,0,blank,0,178.88674,266.81444,390740,390898,158
104,0,blank,0,-323,-105,390930,391089,159
104,31,<=,193,189.343266666667,260.94195,391118,391297,179
104,31,1,190,143.0455,267.481266666667,391297,391490,193
104,31,<=,193,189.96935,264.186116666667,391490,391681,191
104,31,<=,193,194.624233333333,265.278516666667,391681,391871,190
104,0,blank,0,215.900766666667,227.893983333333,391871,392059,188
104,0,blank,0,153.544866666667,253.18745,392059,392248,189
104,31,1,190,139.56165,262.0255,392248,392312,64
104,0,blank,0,-323,-105,392344,392428,84
104,0,blank,0,135.6197,205.7561,392453,392479,26
104,0,blank,0,138.698816666667,218.47415,392539,392722,183
104,0,blank,0,191.765233333333,222.917216666667,392722,392911,189
104,0,blank,0,192.35135,228.29545,392911,393099,188
104,0,blank,0,168.399883333333,227.872766666667,393099,393283,184
104,0,blank,0,118.75735,224.797316666667,393283,393466,183
104,0,blank,0,-323,-105,393498,393605,107
104,0,blank,0,186.196,339.4189,393647,393700,53
104,0,blank,0,189.633883333333,269.02355,393766,393948,182
104,0,blank,0,197.710866666667,232.034133333333,393948,394139,191
104,30,comma,183,160.450933333333,228.6444,394139,394327,188
104,31,;,195,147.452933333333,247.133533333333,394327,394511,184
104,0,blank,0,155.408566666667,251.650416666667,394511,394693,182
104,0,blank,0,180.233033333333,252.041666666667,394693,394781,88
104,0,blank,0,-323,-105,394810,394865,55
104,0,blank,0,198.0876,397.7758,394891,394917,26
104,0,blank,0,148.730614285714,278.279642857143,394966,395155,189
104,0,blank,0,98.5526333333333,283.176033333333,395155,395328,173
104,0,blank,0,-323,-105,395356,395550,194
104,0,blank,0,171.183142857143,288.360328571429,395579,395764,185
104,0,blank,0,171.982466666667,301.332866666667,395764,395846,82
104,0,blank,0,-323,-105,395900,396052,152
104,0,blank,0,-323,-105,396052,396146,94
104,30,=,181,130.813466666667,227.85465,396172,396345,173
104,30,=,181,129.740266666667,226.638366666667,396345,396534,189
104,30,j,184,182.821333333333,230.985683333333,396534,396724,190
104,30,comma,183,157.493416666667,233.965433333333,396724,396915,191
104,0,blank,0,166.017066666667,221.345066666667,396915,397091,176
104,0,blank,0,208.2284,215.127033333333,397091,397278,187
104,0,blank,0,124.23102,214.59038,397278,397435,157
104,0,blank,0,171.0226,473.518533333333,397466,397657,191
104,42,big,241,172.321933333333,498.49455,397657,397846,189
104,42,big,241,169.001433333333,505.230916666667,397846,398039,193
104,42,big,241,155.207633333333,504.223633333333,398039,398229,190
104,42,temp,239,111.13915,504.686983333333,398229,398420,191
104,42,temp,239,111.303766666667,508.314916666667,398420,398609,189
104,42,temp,239,109.772666666667,507.573966666667,398609,398798,189
104,42,temp,239,130.370983333333,509.800633333333,398798,398992,194
104,42,temp,239,128.7716,507.67275,398992,399114,122
104,0,blank,0,-323,-105,399146,399202,56
104,43,k,249,136.5351,515.620683333333,399311,399487,176
104,42,j,243,206.705333333333,507.318333333333,399487,399676,189
104,43,>=,252,199.83695,517.34915,399676,399864,188
104,40,10,231,223.42682,462.34384,399864,400015,151
104,43,j,255,99.2703833333333,526.59085,400047,400234,187
104,42,temp,239,130.392916666667,492.045916666667,400234,400424,190
104,0,blank,0,201.559483333333,433.043016666667,400424,400613,189
104,0,blank,0,246.617,436.623,400613,400739,126
104,0,blank,0,-323,-105,400771,400828,57
104,0,blank,0,240.55,528.4368,400854,400879,25
104,0,blank,0,246.8799,429.823966666667,400935,401110,175
104,0,blank,0,249.0192,434.57575,401110,401237,127
104,0,blank,0,-323,-105,401268,401376,108
104,0,blank,0,177.0195,422.8312,401405,401446,41
104,0,blank,0,183.715733333333,438.21595,401528,401707,179
104,0,blank,0,182.4062,440.349616666667,401707,401896,189
104,0,blank,0,212.31904,438.32502,401896,402054,158
104,0,blank,0,-323,-105,402085,402168,83
104,40,int,234,278.9161,449.0643,402194,402220,26
104,0,blank,0,270.170933333333,434.047133333333,402279,402451,172
104,0,blank,0,234.243966666667,437.703633333333,402451,402637,186
104,0,blank,0,172.035433333333,442.9052,402637,402824,187
104,0,blank,0,235.784516666667,429.4782,402824,403008,184
104,0,blank,0,181.785125,437.4833,403008,403132,124
104,0,blank,0,-323,-105,403163,403219,56
104,42,;,244,218.0072,500.4988,403244,403270,26
104,0,blank,0,187.958983333333,429.9414,403324,403496,172
104,0,blank,0,189.57395,433.9962,403496,403620,124
104,0,blank,0,-323,-105,403651,403759,108
104,0,blank,0,183.2594,434.149,403785,403810,25
104,0,blank,0,175.45425,425.58345,403874,404053,179
104,0,blank,0,176.82915,431.173575,404053,404177,124
104,0,blank,0,-323,-105,404208,404359,151
104,0,blank,0,205.555366666667,439.721633333333,404387,404560,173
104,40,b,229,190.683916666667,446.6574,404560,404748,188
104,0,blank,0,176.348625,437.044075,404748,404913,165
104,0,blank,0,252.3488,463.6714,404913,405031,118
104,0,blank,0,241.50695,491.71325,405031,405223,192
104,0,blank,0,255.341825,470.1837,405223,405353,130
104,0,blank,0,-323,-105,405384,405543,159
104,0,blank,0,-323,-105,405543,405603,60
104,0,blank,0,186.034383333333,443.0243,405639,405813,174
104,0,blank,0,190.00615,444.3897,405813,405876,63
104,0,blank,0,-323,-105,405908,406016,108
104,0,blank,0,581.9563,449.7603,406041,406067,26
104,0,blank,0,151.32335,434.91955,406131,406316,185
104,0,blank,0,155.5018,437.47774,406316,406477,161
104,0,blank,0,255.192133333333,427.961783333333,406508,406697,189
104,0,blank,0,105.8674,481.486133333333,406728,406916,188
104,0,blank,0,117.021483333333,486.44915,406916,407105,189
104,0,blank,0,-323,-105,407137,407270,133
104,0,blank,0,119.520683333333,481.0363,407344,407521,177
104,42,comma,242,136.57095,498.8264,407521,407713,192
104,0,blank,0,153.651733333333,523.418,407713,407905,192
104,42,temp,239,124.282383333333,508.635333333333,407905,408097,192
104,0,blank,0,152.89205,507.855433333333,408097,408296,199
104,42,big,241,166.6346,498.537683333333,408296,408495,199
104,42,temp,239,124.26296,497.63084,408495,408663,168
104,0,blank,0,162.2392,541.58968,408663,408834,171
104,0,blank,0,197.427916666667,548.895833333333,408834,409029,195
104,0,blank,0,210.0561,550.595066666667,409029,409215,186
104,0,blank,0,138.0358,488.920166666667,409215,409402,187
104,42,comma,242,134.927533333333,494.860966666667,409402,409588,186
104,42,comma,242,134.7038,498.7773,409588,409778,190
104,42,temp,239,121.3714,497.721816666667,409778,409971,193
104,42,temp,239,116.5882,495.756133333333,409971,410163,192
104,0,blank,0,116.9005,485.2573,410163,410195,32
104,45,findmax,261,172.302666666667,569.159216666667,410226,410420,194
104,45,big,259,97.8532166666667,565.843983333333,410420,410614,194
104,45,findmax,261,144.529483333333,555.804,410614,410807,193
104,45,findmax,261,159.18365,564.008566666667,410807,410998,191
104,0,blank,0,154.877583333333,598.594633333333,410998,411187,189
104,45,findmax,261,165.97055,574.609216666667,411187,411380,193
104,46,b,270,154.12155,585.28545,411380,411572,192
104,46,temp,268,90.5775333333333,583.580516666667,411572,411767,195
104,0,blank,0,128.406783333333,586.794783333333,411767,411960,193
104,47,big,277,131.14535,604.1583,411960,412025,65
104,0,blank,0,-323,-105,412056,412174,118
104,0,blank,0,177.1469,549.106716666667,412204,412387,183
104,0,blank,0,216.384683333333,540.593566666667,412387,412579,192
104,0,blank,0,198.4124,544.245866666667,412579,412770,191
104,0,blank,0,130.657316666667,512.535416666667,412770,412961,191
104,42,temp,239,107.0033,490.634416666667,412961,413150,189
104,42,temp,239,105.46696,494.3894,413150,413309,159
104,0,blank,0,151.660433333333,617.04905,413340,413531,191
104,46,b,270,156.014566666667,585.91905,413531,413721,190
104,46,temp,268,101.02845,578.035583333333,413721,413912,191
104,46,temp,268,91.64956,578.34288,413912,414073,161
104,0,blank,0,-323,-105,414106,414214,108
104,0,blank,0,128.7731,582.6564,414240,414273,33
104,0,blank,0,147.015283333333,583.149916666667,414342,414528,186
104,46,[,271,167.433266666667,584.94085,414528,414726,198
104,46,temp,268,100.48836,592.4219,414726,414890,164
104,0,blank,0,-323,-105,414922,414980,58
104,0,blank,0,150.518016666667,581.931366666667,415031,415205,174
104,0,blank,0,148.601566666667,583.225966666667,415205,415401,196
104,46,temp,268,89.6466,595.946533333333,415401,415594,193
104,46,temp,268,108.7684,594.142,415594,415790,196
104,45,findmax,261,158.161983333333,572.451683333333,415790,415984,194
104,45,findmax,261,162.97145,564.362175,415984,416117,133
104,38,max,221,120.49014,416.20814,416152,416321,169
104,0,blank,0,120.106,431.995475,416321,416459,138
104,50,return,293,87.3189,683.98485,416493,416560,67
104,0,blank,0,-323,-105,416627,416788,161
104,0,blank,0,-323,-105,416788,416922,134
104,0,blank,0,-323,-105,416922,417095,173
104,0,blank,0,-323,-105,417095,417238,143
104,0,blank,0,-323,-105,417238,417403,165
104,0,blank,0,-323,-105,417403,417581,178
104,0,blank,0,-323,-105,417581,417757,176
104,0,blank,0,-323,-105,417757,417951,194
104,0,blank,0,-323,-105,417951,418081,130
104,0,blank,0,-323,-105,418081,418240,159
104,0,blank,0,-323,-105,418240,418424,184
104,0,blank,0,-323,-105,418424,418602,178
104,0,blank,0,-323,-105,418602,418779,177
104,0,blank,0,-323,-105,418779,418958,179
104,0,blank,0,-323,-105,418958,419138,180
104,0,blank,0,-323,-105,419138,419317,179
104,0,blank,0,-323,-105,419317,419500,183
104,0,blank,0,-323,-105,419500,419669,169
104,0,blank,0,-323,-105,419669,419753,84
104,0,blank,0,-323,-105,419753,419910,157
104,0,blank,0,-323,-105,419910,420079,169
104,0,blank,0,-323,-105,420079,420277,198
104,0,blank,0,-323,-105,420277,420453,176
104,0,blank,0,-323,-105,420453,420494,41
104,0,blank,0,-323,-105,420494,420662,168
104,0,blank,0,-323,-105,420662,420843,181
104,0,blank,0,-323,-105,420843,421017,174
104,0,blank,0,-323,-105,421017,421110,93
104,0,blank,0,-323,-105,421110,421286,176
104,0,blank,0,-323,-105,421286,421459,173
104,0,blank,0,-323,-105,421459,421627,168
104,0,blank,0,-323,-105,421627,421792,165
104,0,blank,0,-323,-105,421792,421968,176
104,0,blank,0,-323,-105,421968,422160,192
104,0,blank,0,-323,-105,422160,422340,180
104,0,blank,0,-323,-105,422340,422502,162
104,0,blank,0,-323,-105,422502,422700,198
104,0,blank,0,-323,-105,422700,422888,188
104,0,blank,0,-323,-105,422888,423010,122
104,0,blank,0,-323,-105,423010,423178,168
104,0,blank,0,-323,-105,423178,423291,113
104,0,blank,0,-323,-105,423291,423469,178
104,0,blank,0,-323,-105,423469,423653,184
104,0,blank,0,-323,-105,423653,423821,168
104,0,blank,0,-323,-105,423821,423911,90
104,0,blank,0,-323,-105,423911,424057,146
104,0,blank,0,-323,-105,424057,424188,131
104,0,blank,0,-323,-105,424188,424303,115
104,0,blank,0,-323,-105,424303,424484,181
104,0,blank,0,-323,-105,424484,424683,199
104,0,blank,0,-323,-105,424683,424856,173
104,0,blank,0,-323,-105,424856,425028,172
104,0,blank,0,-323,-105,425028,425240,212
104,0,blank,0,-323,-105,425240,425653,413
104,0,blank,0,-323,-105,425653,425838,185
104,0,blank,0,-323,-105,425838,426035,197
104,0,blank,0,-323,-105,426035,426140,105
104,0,blank,0,-323,-105,426140,426258,118
104,0,blank,0,-323,-105,426258,426418,160
104,0,blank,0,-323,-105,426418,426588,170
104,0,blank,0,-323,-105,426588,426768,180
104,0,blank,0,-323,-105,426768,426931,163
104,0,blank,0,-323,-105,426931,427056,125
104,0,blank,0,-323,-105,427056,427221,165
104,0,blank,0,-323,-105,427221,427420,199
104,0,blank,0,-323,-105,427420,427637,217
104,0,blank,0,-323,-105,427637,427834,197
104,0,blank,0,-323,-105,427834,427982,148
104,0,blank,0,-323,-105,427982,428134,152
104,0,blank,0,-323,-105,428134,428418,284
104,0,blank,0,-323,-105,428418,428583,165
104,0,blank,0,-323,-105,428583,428809,226
104,0,blank,0,-323,-105,428809,429083,274
104,0,blank,0,-323,-105,429083,429260,177
104,0,blank,0,-323,-105,429260,429429,169
104,0,blank,0,-323,-105,429429,429582,153
104,0,blank,0,-323,-105,429582,429675,93
104,0,blank,0,-323,-105,429675,429799,124
104,0,blank,0,-323,-105,429799,429993,194
104,0,blank,0,-323,-105,429993,430023,30
104,0,blank,0,-323,-105,430023,430240,217
104,0,blank,0,-323,-105,430240,430457,217
104,0,blank,0,-323,-105,430457,430633,176
104,0,blank,0,-323,-105,430633,430809,176
104,0,blank,0,-323,-105,430809,430990,181
104,0,blank,0,-323,-105,430990,431176,186
104,0,blank,0,-323,-105,431176,431293,117
104,0,blank,0,-323,-105,431293,431434,141
104,0,blank,0,-323,-105,431434,431658,224
104,0,blank,0,-323,-105,431658,431696,38
104,0,blank,0,-323,-105,431696,431870,174
104,0,blank,0,-323,-105,431870,432057,187
104,0,blank,0,-323,-105,432057,432231,174
104,0,blank,0,-323,-105,432231,432409,178
104,0,blank,0,-323,-105,432409,432517,108
104,0,blank,0,-323,-105,432517,432638,121
104,0,blank,0,-323,-105,432638,432819,181
104,0,blank,0,-323,-105,432819,432938,119
104,0,blank,0,-323,-105,432938,433137,199
104,0,blank,0,-323,-105,433137,433324,187
104,0,blank,0,-323,-105,433324,433503,179
104,0,blank,0,-323,-105,433503,433529,26
104,0,blank,0,-323,-105,433529,433860,331
104,0,blank,0,-323,-105,433860,433990,130
104,0,blank,0,-323,-105,433990,434448,458
104,0,blank,0,-323,-105,434448,434728,280
104,0,blank,0,-323,-105,434728,434917,189
104,0,blank,0,-323,-105,434917,435101,184
104,0,blank,0,-323,-105,435101,435298,197
104,0,blank,0,-323,-105,435298,435474,176
104,0,blank,0,-323,-105,435474,435653,179
104,0,blank,0,-323,-105,435653,435710,57
104,0,blank,0,-323,-105,435710,435857,147
104,0,blank,0,-323,-105,435857,436007,150
104,0,blank,0,-323,-105,436007,436085,78
104,0,blank,0,-323,-105,436085,436233,148
104,0,blank,0,-323,-105,436233,436419,186
104,0,blank,0,-323,-105,436419,436516,97
104,0,blank,0,-323,-105,436516,436709,193
104,0,blank,0,-323,-105,436709,436898,189
104,0,blank,0,-323,-105,436898,436985,87
104,0,blank,0,-323,-105,436985,437155,170
104,0,blank,0,-323,-105,437155,437281,126
104,0,blank,0,-323,-105,437281,437356,75
104,0,blank,0,-323,-105,437356,437498,142
104,0,blank,0,-323,-105,437498,437562,64
104,0,blank,0,-323,-105,437562,437714,152
104,0,blank,0,-323,-105,437714,437922,208
104,0,blank,0,-323,-105,437922,438105,183
104,0,blank,0,-323,-105,438105,438279,174
104,0,blank,0,-323,-105,438279,438389,110
104,0,blank,0,-323,-105,438389,438657,268
104,0,blank,0,-323,-105,438657,438760,103
104,0,blank,0,-323,-105,438760,438923,163
104,0,blank,0,-323,-105,438923,439308,385
104,0,blank,0,-323,-105,439308,439400,92
104,0,blank,0,-323,-105,440180,440513,333
104,0,blank,0,-323,-105,440513,440616,103
104,0,blank,0,169.1247,487.9522,440665,440813,148
104,0,blank,0,143.12395,482.86555,440813,440934,121
104,0,blank,0,183.251333333333,442.5365,440986,441113,127
104,0,blank,0,182.5673,485.0534,441200,441287,87
104,0,blank,0,244.933583333333,537.220183333333,441375,441574,199
104,0,blank,0,235.832433333333,534.29585,441574,441761,187
104,0,blank,0,206.725233333333,512.642333333333,441761,441854,93
104,0,blank,0,-323,-105,441885,441967,82
104,0,blank,0,220.9854,471.1351,441997,442031,34
104,0,blank,0,222.432766666667,484.589933333333,442100,442184,84
104,45,),266,265.336333333333,555.66805,442215,442407,192
104,0,blank,0,236.215583333333,542.267266666667,442407,442595,188
104,0,blank,0,247.389433333333,559.690033333333,442595,442778,183
104,0,blank,0,250.276766666667,560.376616666667,442778,442958,180
104,45,j,265,262.597583333333,567.389033333333,442958,443140,182
104,45,j,265,255.571916666667,565.633683333333,443140,443318,178
104,0,blank,0,258.5905,582.4501,443318,443348,30
104,0,blank,0,-323,-105,443378,443564,186
104,0,blank,0,-323,-105,443564,443744,180
104,0,blank,0,-323,-105,443744,443919,175
104,0,blank,0,-323,-105,443919,444084,165
104,0,blank,0,-323,-105,444084,444255,171
104,0,blank,0,-323,-105,444255,444453,198
104,0,blank,0,-323,-105,444453,444526,73
104,0,blank,0,209.658075,248.53935,444574,444741,167
104,0,blank,0,237.5618,211.9162,444741,444934,193
104,0,blank,0,170.24062,206.93056,444934,445088,154
104,43,j,255,168.5931,526.2415,445148,445260,112
104,0,blank,0,148.144433333333,383.178666666667,445286,445466,180
104,0,blank,0,158.54355,360.04725,445466,445528,62
104,0,blank,0,156.39025,203.4563,445560,445650,90
104,0,blank,0,157.2159,204.3424,445650,445861,211
104,28,10,172,201.4973,186.657033333333,445861,446039,178
104,28,10,172,203.781716666667,185.932783333333,446039,446221,182
104,0,blank,0,122.368116666667,209.4794,446221,446405,184
104,0,blank,0,123.2609,214.6175,446405,446435,30
104,0,blank,0,-323,-105,446465,446521,56
104,0,blank,0,123.8206,217.3873,446547,446573,26
104,0,blank,0,125.037233333333,132.437283333333,446627,446799,172
104,0,blank,0,124.4158,137.57174,446799,446953,154
104,0,blank,0,255.585383333333,125.427983333333,446984,447166,182
104,0,blank,0,256.8661,139.1055,447166,447196,30
104,0,blank,0,-323,-105,447227,447334,107
104,0,blank,0,222.2227,122.576883333333,447358,447529,171
104,0,blank,0,274.987275,137.70625,447529,447653,124
104,0,blank,0,139.0022,220.303283333333,447683,447872,189
104,0,blank,0,204.048666666667,168.3233,447872,448054,182
104,0,blank,0,249.32375,137.402833333333,448054,448237,183
104,0,blank,0,277.363666666667,144.5536,448237,448422,185
104,0,blank,0,202.378116666667,137.963616666667,448422,448606,184
104,0,blank,0,191.338575,147.972025,448606,448729,123
104,0,blank,0,226.211216666667,332.211933333333,448759,448942,183
104,0,blank,0,206.683566666667,211.569683333333,448942,449128,186
104,0,blank,0,196.603633333333,206.954666666667,449128,449311,183
104,0,blank,0,-323,-105,449342,449424,82
104,27,find,160,196.5704,168.0272,449456,449491,35
104,0,blank,0,212.414983333333,157.7605,449558,449736,178
104,0,blank,0,264.30954,130.42814,449736,449891,155
104,0,blank,0,177.9876,150.5948,449891,450323,432
104,0,blank,0,208.857333333333,151.731816666667,450323,450503,180
104,0,blank,0,220.3969,178.0797,450503,450533,30
104,0,blank,0,-323,-105,450564,450647,83
104,27,the,161,233.0474,167.0552,450673,450709,36
104,27,maximum,162,262.563066666667,169.568816666667,450773,450952,179
104,27,maximum,162,282.477983333333,162.6788,450952,451137,185
104,27,maximum,162,283.553016666667,168.667133333333,451137,451312,175
104,27,maximum,162,277.38585,168.86515,451312,451370,58
104,0,blank,0,-323,-105,451400,451584,184
104,0,blank,0,-323,-105,451584,451776,192
104,0,blank,0,-323,-105,451776,451956,180
104,0,blank,0,-323,-105,451956,452097,141
104,0,blank,0,-323,-105,452097,452158,61
104,0,blank,0,108.936833333333,261.8171,452192,452366,174
104,31,=,189,113.28345,254.74505,452366,452538,172
104,0,blank,0,154.678833333333,256.323116666667,452538,452710,172
104,31,j,196,164.6408,253.192516666667,452710,452882,172
104,0,blank,0,160.40045,250.61905,452882,453056,174
104,30,comma,183,156.654866666667,242.284366666667,453056,453230,174
104,30,j,184,178.3348,240.89245,453230,453406,176
104,0,blank,0,200.09864,238.24722,453406,453551,145
104,0,blank,0,-323,-105,453580,453634,54
104,0,blank,0,186.9235,425.6962,453660,453685,25
104,0,blank,0,189.433657142857,225.969428571429,453743,453932,189
104,0,blank,0,113.625416666667,302.125933333333,453932,454108,176
104,33,[,208,138.675133333333,296.12005,454108,454283,175
104,33,j,204,150.014266666667,304.592633333333,454283,454456,173
104,33,>=,206,192.014833333333,306.51885,454456,454631,175
104,0,blank,0,-323,-105,454660,454764,104
104,33,],210,154.0193,311.1737,454796,454841,45
104,0,blank,0,152.420228571429,312.806457142857,454905,455100,195
104,0,blank,0,160.512083333333,312.380233333333,455100,455275,175
104,33,[,208,136.809133333333,311.646133333333,455275,455449,174
104,33,b,207,124.776883333333,293.435566666667,455449,455622,173
104,0,blank,0,137.598842857143,326.675442857143,455622,455821,199
104,0,blank,0,143.24775,336.7966,455821,455993,172
104,0,blank,0,121.43875,290.603083333333,455993,456166,173
104,0,blank,0,127.36495,263.9242,456166,456339,173
104,31,;,195,149.458666666667,247.962983333333,456339,456512,173
104,30,=,181,124.61485,238.308483333333,456512,456685,173
104,0,blank,0,109.911633333333,251.01215,456685,456860,175
104,30,max,180,107.23904,243.17206,456860,457007,147
104,0,blank,0,-323,-105,457036,457140,104
104,0,blank,0,169.050028571429,238.866242857143,457165,457353,188
104,31,<=,193,203.423683333333,252.527833333333,457353,457527,174
104,33,>=,206,190.191466666667,292.644766666667,457527,457701,174
104,33,>=,206,186.717216666667,301.992983333333,457701,457874,173
104,0,blank,0,178.715333333333,319.3832,457874,458045,171
104,0,blank,0,184.205483333333,325.726383333333,458045,458217,172
104,0,blank,0,-323,-105,458275,458449,174
104,0,blank,0,-323,-105,458449,458640,191
104,0,blank,0,-323,-105,458640,458825,185
104,0,blank,0,-323,-105,458825,459004,179
104,0,blank,0,-323,-105,459004,459187,183
104,0,blank,0,-323,-105,459187,459379,192
104,33,(,201,120.92045,296.840016666667,459469,459643,174
104,0,blank,0,166.113985714286,299.480128571429,459643,459842,199
104,33,>=,206,177.121533333333,304.720716666667,459842,460015,173
104,0,blank,0,107.626316666667,290.75615,460015,460187,172
104,0,blank,0,114.12735,309.4997,460187,460245,58
104,0,blank,0,-323,-105,460274,460414,140
104,0,blank,0,168.913033333333,287.987833333333,460440,460635,195
104,33,>=,206,176.9227,296.575883333333,460635,460809,174
104,0,blank,0,197.744083333333,302.32,460809,460984,175
104,33,>=,206,188.98785,306.050383333333,460984,461158,174
104,0,blank,0,134.741066666667,335.451766666667,461158,461332,174
104,0,blank,0,133.5937,328.618666666667,461332,461506,174
104,0,blank,0,130.66036,323.42792,461506,461651,145
104,0,blank,0,-323,-105,461680,461759,79
104,0,blank,0,194.9054,296.8449,461784,461818,34
104,0,blank,0,193.8283,288.412085714286,461880,462076,196
104,0,blank,0,139.966633333333,328.711433333333,462076,462250,174
104,35,max,213,128.752916666667,342.990266666667,462250,462424,174
104,0,blank,0,-323,-105,462482,462634,152
104,0,blank,0,-323,-105,462634,462780,146
104,0,blank,0,-323,-105,462780,462978,198
104,0,blank,0,-323,-105,462978,463163,185
104,0,blank,0,-323,-105,463163,463278,115
104,0,blank,0,-323,-105,463278,463444,166
104,0,blank,0,-323,-105,463444,463594,150
104,0,blank,0,-323,-105,463594,463788,194
104,0,blank,0,-323,-105,463788,463961,173
104,0,blank,0,-323,-105,463961,464130,169
104,0,blank,0,-323,-105,464130,464311,181
104,0,blank,0,-323,-105,464311,464509,198
104,0,blank,0,-323,-105,464509,464686,177
104,0,blank,0,-323,-105,464686,464858,172
104,0,blank,0,-323,-105,464858,465052,194
104,0,blank,0,-323,-105,465052,465232,180
104,0,blank,0,-323,-105,465232,465382,150
104,0,blank,0,-323,-105,465382,465566,184
104,0,blank,0,-323,-105,465566,465755,189
104,0,blank,0,-323,-105,465755,465907,152
104,0,blank,0,192.49735,498.05695,466312,466499,187
104,0,blank,0,179.382525,511.119,466583,466760,177
104,0,blank,0,150.67745,509.61985,466760,466849,89
104,0,blank,0,206.1537,537.6725,466889,466932,43
104,0,blank,0,-323,-105,466975,467036,61
104,0,blank,0,113.7224,576.4199,467069,467232,163
104,0,blank,0,135.741775,543.704825,467232,467419,187
104,0,blank,0,45.8696333333333,665.787,467419,467583,164
104,0,blank,0,54.57738,648.89978,467583,467770,187
104,49,},292,46.864,662.5892,467770,467801,31
104,0,blank,0,115.115,575.470333333333,467833,468020,187
104,45,findmax,261,162.865516666667,563.546666666667,468020,468208,188
104,45,findmax,261,161.5848,562.26285,468208,468271,63
104,0,blank,0,-323,-105,468335,468533,198
104,0,blank,0,-323,-105,468533,468710,177
104,0,blank,0,-323,-105,468710,468882,172
104,0,blank,0,-323,-105,468882,469059,177
104,0,blank,0,-323,-105,469059,469234,175
104,0,blank,0,-323,-105,469234,469369,135
104,0,blank,0,-323,-105,469369,469531,162
104,0,blank,0,-323,-105,469531,469572,41
104,0,blank,0,-323,-105,469572,469733,161
104,0,blank,0,-323,-105,469733,469885,152
104,0,blank,0,-323,-105,469885,470163,278
104,0,blank,0,-323,-105,470163,470334,171
104,0,blank,0,-323,-105,470334,470519,185
104,0,blank,0,-323,-105,470519,470705,186
104,0,blank,0,-323,-105,470705,470975,270
104,0,blank,0,-323,-105,470975,471262,287
104,0,blank,0,-323,-105,471262,471637,375
104,0,blank,0,-323,-105,471637,471820,183
104,0,blank,0,-323,-105,471820,471971,151
104,0,blank,0,-323,-105,471971,472099,128
104,0,blank,0,-323,-105,472099,472194,95
104,0,blank,0,-323,-105,472194,472405,211
104,0,blank,0,-323,-105,472405,472766,361
104,0,blank,0,-323,-105,472766,472938,172
104,0,blank,0,-323,-105,472938,473064,126
104,0,blank,0,-323,-105,473064,473209,145
104,0,blank,0,-323,-105,473209,473365,156
104,0,blank,0,-323,-105,473365,473476,111
104,0,blank,0,-323,-105,473476,473613,137
104,0,blank,0,-323,-105,473613,473789,176
104,0,blank,0,-323,-105,473789,473987,198
104,0,blank,0,-323,-105,473987,474179,192
104,0,blank,0,-323,-105,474179,474352,173
104,0,blank,0,-323,-105,474352,474517,165
104,0,blank,0,-323,-105,474517,474662,145
104,0,blank,0,-323,-105,474662,474759,97
104,0,blank,0,-323,-105,474759,475277,518
104,0,blank,0,-323,-105,475277,475471,194
104,0,blank,0,-323,-105,475471,475646,175
104,0,blank,0,-323,-105,475646,475744,98
104,0,blank,0,-323,-105,475744,475948,204
104,0,blank,0,-323,-105,475948,476056,108
104,0,blank,0,-323,-105,476056,476242,186
104,0,blank,0,-323,-105,476242,476428,186
104,0,blank,0,-323,-105,476428,476558,130
104,0,blank,0,-323,-105,476558,476721,163
104,0,blank,0,-323,-105,476721,476883,162
104,0,blank,0,-323,-105,476883,477143,260
104,0,blank,0,-323,-105,477143,477320,177
104,0,blank,0,-323,-105,477320,477496,176
104,0,blank,0,-323,-105,477496,477628,132
104,0,blank,0,-323,-105,477628,477747,119
104,0,blank,0,-323,-105,477747,477867,120
104,0,blank,0,-323,-105,477867,478078,211
104,0,blank,0,-323,-105,478078,478276,198
104,0,blank,0,-323,-105,478276,478363,87
104,0,blank,0,-323,-105,478363,478484,121
104,0,blank,0,-323,-105,478484,478607,123
104,0,blank,0,-323,-105,478607,478698,91
104,0,blank,0,-323,-105,478698,478807,109
104,0,blank,0,-323,-105,478807,478967,160
104,0,blank,0,-323,-105,478967,479150,183
104,0,blank,0,-323,-105,479150,479269,119
104,0,blank,0,-323,-105,479269,479365,96
104,0,blank,0,-323,-105,479365,479550,185
104,0,blank,0,-323,-105,479550,479645,95
104,0,blank,0,-323,-105,479645,479861,216
104,0,blank,0,-323,-105,479861,480079,218
104,0,blank,0,-323,-105,480079,480159,80
104,0,blank,0,-323,-105,480159,480397,238
104,0,blank,0,-323,-105,480397,480573,176
104,0,blank,0,-323,-105,480573,480745,172
104,0,blank,0,-323,-105,480745,480864,119
104,0,blank,0,-323,-105,480864,481059,195
104,0,blank,0,-323,-105,481059,481249,190
104,0,blank,0,-323,-105,481249,481440,191
104,0,blank,0,-323,-105,481440,481466,26
104,0,blank,0,-323,-105,481466,481794,328
104,0,blank,0,-323,-105,481794,482128,334
104,0,blank,0,-323,-105,482128,482284,156
104,0,blank,0,-323,-105,482284,482452,168
104,0,blank,0,-323,-105,482452,482624,172
104,0,blank,0,-323,-105,482624,482813,189
104,0,blank,0,-323,-105,482813,482972,159
104,0,blank,0,-323,-105,482972,483108,136
104,0,blank,0,-323,-105,483108,483276,168
104,0,blank,0,-323,-105,483276,483442,166
104,0,blank,0,-323,-105,483442,483562,120
104,0,blank,0,-323,-105,483562,483681,119
104,0,blank,0,-323,-105,483681,483788,107
104,0,blank,0,-323,-105,483788,483986,198
104,0,blank,0,-323,-105,483986,484173,187
104,0,blank,0,-323,-105,484173,484321,148
104,0,blank,0,-323,-105,484321,484502,181
104,0,blank,0,-323,-105,484502,484676,174
104,0,blank,0,-323,-105,484676,484843,167
104,0,blank,0,-323,-105,484843,485058,215
104,0,blank,0,-323,-105,485058,485166,108
104,0,blank,0,-323,-105,485166,485289,123
104,0,blank,0,-323,-105,485289,485481,192
104,0,blank,0,-323,-105,485481,485645,164
104,0,blank,0,-323,-105,485645,485807,162
104,0,blank,0,-323,-105,485807,485878,71
104,0,blank,0,-323,-105,485878,486133,255
104,0,blank,0,-323,-105,486133,486962,829
104,0,blank,0,-323,-105,486962,487368,406
104,0,blank,0,-323,-105,487368,487554,186
104,0,blank,0,-323,-105,487554,487696,142
104,0,blank,0,-323,-105,487696,487825,129
104,0,blank,0,-323,-105,487825,487936,111
104,0,blank,0,-323,-105,487936,488108,172
104,0,blank,0,-323,-105,488108,488158,50
104,0,blank,0,-323,-105,488158,488351,193
104,0,blank,0,-323,-105,488351,488525,174
104,0,blank,0,-323,-105,488525,488648,123
104,0,blank,0,-323,-105,488648,488846,198
104,0,blank,0,-323,-105,488846,489043,197
104,0,blank,0,-323,-105,489043,489221,178
104,0,blank,0,-323,-105,489221,489380,159
104,0,blank,0,-323,-105,489380,489568,188
104,0,blank,0,-323,-105,489568,489719,151
104,0,blank,0,-323,-105,489719,489769,50
104,0,blank,0,-323,-105,489769,489947,178
104,0,blank,0,-323,-105,489947,490013,66
104,0,blank,0,-323,-105,490013,490166,153
104,0,blank,0,-323,-105,490166,490254,88
104,0,blank,0,-323,-105,490254,490419,165
104,0,blank,0,-323,-105,490419,490612,193
104,0,blank,0,-323,-105,490612,490787,175
104,0,blank,0,-323,-105,490787,490895,108
104,0,blank,0,-323,-105,490895,491066,171
104,0,blank,0,-323,-105,491066,491096,30
104,0,blank,0,-323,-105,491096,491273,177
104,0,blank,0,-323,-105,491273,491453,180
104,0,blank,0,-323,-105,491453,491640,187
104,0,blank,0,-323,-105,491640,491815,175
104,0,blank,0,-323,-105,491815,491963,148
104,0,blank,0,-323,-105,491963,492065,102
104,0,blank,0,-323,-105,492065,492234,169
104,0,blank,0,-323,-105,492234,492378,144
104,0,blank,0,-323,-105,492378,492559,181
104,0,blank,0,-323,-105,492559,492716,157
104,0,blank,0,-323,-105,492716,492883,167
104,0,blank,0,-323,-105,492883,493036,153
104,0,blank,0,-323,-105,493036,493172,136
104,0,blank,0,-323,-105,493172,493320,148
104,0,blank,0,-323,-105,493320,493466,146
104,0,blank,0,-323,-105,493466,493635,169
104,0,blank,0,-323,-105,493635,493808,173
104,0,blank,0,-323,-105,493808,493984,176
104,0,blank,0,-323,-105,493984,494180,196
104,0,blank,0,-323,-105,494180,494301,121
104,0,blank,0,-323,-105,494301,494488,187
104,0,blank,0,-323,-105,494488,494683,195
104,0,blank,0,-323,-105,494683,494793,110
104,0,blank,0,-323,-105,494793,494974,181
104,0,blank,0,-323,-105,494974,495182,208
104,0,blank,0,-323,-105,495182,495362,180
104,0,blank,0,-323,-105,495362,495489,127
104,0,blank,0,-323,-105,495489,495624,135
104,0,blank,0,-323,-105,495624,495758,134
104,0,blank,0,-323,-105,495758,495949,191
104,0,blank,0,-323,-105,495949,496124,175
104,0,blank,0,-323,-105,496124,496263,139
104,0,blank,0,-323,-105,496263,496440,177
104,0,blank,0,-323,-105,496440,496630,190
104,0,blank,0,-323,-105,496630,496740,110
104,0,blank,0,-323,-105,496740,496937,197
104,0,blank,0,-323,-105,496937,497114,177
104,0,blank,0,-323,-105,497114,497226,112
104,0,blank,0,-323,-105,497226,497419,193
104,0,blank,0,-323,-105,497419,497599,180
104,0,blank,0,-323,-105,497599,497761,162
104,0,blank,0,-323,-105,497761,497874,113
104,0,blank,0,-323,-105,497874,498070,196
104,0,blank,0,-323,-105,498070,498250,180
104,0,blank,0,-323,-105,498250,498421,171
104,0,blank,0,-323,-105,498421,498456,35
104,0,blank,0,-323,-105,498456,498782,326
104,0,blank,0,-323,-105,498782,498847,65
104,0,blank,0,-323,-105,498847,499516,669
104,0,blank,0,-323,-105,499516,499909,393
104,0,blank,0,-323,-105,499909,500096,187
104,0,blank,0,-323,-105,500096,500268,172
104,0,blank,0,-323,-105,500268,500297,29
104,0,blank,0,-323,-105,500297,500563,266
104,0,blank,0,-323,-105,500563,500823,260
104,0,blank,0,-323,-105,500823,501187,364
104,0,blank,0,-323,-105,501187,501363,176
104,0,blank,0,-323,-105,501363,501521,158
104,0,blank,0,-323,-105,501521,501623,102
104,0,blank,0,-323,-105,501623,501872,249
104,0,blank,0,-323,-105,501872,502056,184
104,0,blank,0,-323,-105,502056,502235,179
104,0,blank,0,-323,-105,502235,502368,133
104,0,blank,0,-323,-105,502368,502664,296
104,0,blank,0,-323,-105,502664,502833,169
104,0,blank,0,-323,-105,502833,503515,682
104,0,blank,0,-323,-105,503515,503791,276
104,0,blank,0,-323,-105,503791,503970,179
104,0,blank,0,-323,-105,503970,504024,54
104,0,blank,0,-323,-105,504024,504209,185
104,0,blank,0,-323,-105,504209,504390,181
104,0,blank,0,-323,-105,504390,504735,345
104,0,blank,0,-323,-105,504735,504977,242
104,0,blank,0,-323,-105,504977,505175,198
104,0,blank,0,-323,-105,505175,505475,300
104,0,blank,0,-323,-105,505475,505584,109
104,0,blank,0,-323,-105,505584,506170,586
104,0,blank,0,-323,-105,506170,506383,213
104,0,blank,0,-323,-105,506383,506529,146
104,0,blank,0,-323,-105,506529,506621,92
104,0,blank,0,-323,-105,506621,506842,221
104,0,blank,0,-323,-105,506842,507132,290
104,0,blank,0,-323,-105,507132,508037,905
104,0,blank,0,-323,-105,508037,508218,181
104,0,blank,0,-323,-105,508218,508265,47
104,0,blank,0,-323,-105,508265,508636,371
104,0,blank,0,-323,-105,508636,508803,167
104,0,blank,0,-323,-105,508803,509516,713
104,0,blank,0,-323,-105,509516,510064,548
104,0,blank,0,-323,-105,510064,510255,191
104,0,blank,0,-323,-105,510255,510426,171
104,0,blank,0,-323,-105,510426,510683,257
104,0,blank,0,-323,-105,510683,510776,93
104,0,blank,0,-323,-105,510776,510910,134
104,0,blank,0,-323,-105,510910,511026,116
104,42,temp,239,127.37908,498.63734,511687,511865,178
104,42,comma,242,136.1479,499.404966666667,511865,512052,187
104,40,10,231,214.593,446.48175,512052,512236,184
104,0,blank,0,226.86505,428.8627,512236,512297,61
104,0,blank,0,-323,-105,512328,512385,57
104,0,blank,0,149.0388,744.1996,512411,512436,25
104,0,blank,0,171.707233333333,487.313333333333,512501,512587,86
104,0,blank,0,104.14736,261.77418,512616,512771,155
104,42,big,241,174.602466666667,503.427716666667,512802,512991,189
104,42,temp,239,118.022683333333,502.258533333333,512991,513176,185
104,0,blank,0,122.803183333333,538.691483333333,513176,513365,189
104,45,=,260,133.57295,558.50065,513365,513554,189
104,45,=,260,131.180933333333,561.435566666667,513554,513741,187
104,45,=,260,131.735033333333,568.036266666667,513741,513835,94
104,0,blank,0,143.4586,468.520266666667,513867,513960,93
104,0,blank,0,-323,-105,514022,514049,27
104,0,blank,0,172.5716,537.9907,514075,514101,26
104,0,blank,0,159.228483333333,480.78615,514153,514327,174
104,42,temp,239,113.67336,505.28048,514327,514483,156
104,0,blank,0,142.092816666667,227.609683333333,514513,514698,185
104,0,blank,0,142.0669,222.60785,514698,514761,63
104,45,findmax,261,159.753433333333,560.426133333333,514791,514975,184
104,45,findmax,261,155.68625,565.34975,514975,515035,60
104,0,blank,0,-323,-105,515066,515249,183
104,0,blank,0,-323,-105,515249,515428,179
104,0,blank,0,-323,-105,515428,515607,179
104,0,blank,0,-323,-105,515607,515784,177
104,0,blank,0,-323,-105,515784,515852,68
104,0,blank,0,-323,-105,515852,516307,455
104,0,blank,0,-323,-105,516307,516766,459
104,0,blank,0,-323,-105,516766,516964,198
104,0,blank,0,-323,-105,516964,517080,116
104,0,blank,0,-323,-105,517080,517437,357
104,0,blank,0,-323,-105,517437,517599,162
104,0,blank,0,-323,-105,517599,517759,160
104,0,blank,0,-323,-105,517759,517948,189
104,0,blank,0,-323,-105,517948,518131,183
104,0,blank,0,-323,-105,518131,518269,138
104,0,blank,0,-323,-105,518269,518440,171
104,0,blank,0,-323,-105,518440,518478,38
104,0,blank,0,-323,-105,518478,518670,192
104,0,blank,0,-323,-105,518670,518860,190
104,0,blank,0,-323,-105,518860,518891,31
104,0,blank,0,-323,-105,518891,519108,217
104,0,blank,0,-323,-105,519108,519299,191
104,0,blank,0,-323,-105,519299,519400,101
104,0,blank,0,-323,-105,519400,519570,170
104,0,blank,0,-323,-105,519570,519750,180
104,0,blank,0,-323,-105,519750,520040,290
104,0,blank,0,-323,-105,520040,520075,35
104,0,blank,0,-323,-105,520075,520306,231
104,0,blank,0,-323,-105,520306,520530,224
104,0,blank,0,-323,-105,520530,520708,178
104,0,blank,0,-323,-105,520708,520897,189
104,0,blank,0,-323,-105,520897,521070,173
104,0,blank,0,-323,-105,521070,521224,154
104,0,blank,0,-323,-105,521224,521415,191
104,0,blank,0,-323,-105,521415,521584,169
104,0,blank,0,-323,-105,521584,521687,103
104,0,blank,0,-323,-105,521687,521873,186
104,0,blank,0,-323,-105,521873,522031,158
104,0,blank,0,-323,-105,522031,522226,195
104,0,blank,0,-323,-105,522226,522406,180
104,0,blank,0,-323,-105,522406,522589,183
104,0,blank,0,-323,-105,522589,522656,67
104,0,blank,0,-323,-105,522656,522845,189
104,0,blank,0,-323,-105,522845,522949,104
104,0,blank,0,-323,-105,522949,523158,209
104,0,blank,0,-323,-105,523158,523332,174
104,0,blank,0,-323,-105,523332,523446,114
104,0,blank,0,-323,-105,523446,523628,182
104,0,blank,0,-323,-105,523628,523817,189
104,0,blank,0,-323,-105,523817,523923,106
104,0,blank,0,-323,-105,523923,524051,128
104,0,blank,0,-323,-105,524051,524241,190
104,0,blank,0,-323,-105,524241,524413,172
104,0,blank,0,-323,-105,524413,524587,174
104,0,blank,0,-323,-105,524587,524673,86
104,0,blank,0,-323,-105,524673,524871,198
104,0,blank,0,-323,-105,524871,525053,182
104,0,blank,0,-323,-105,525053,525119,66
104,0,blank,0,-323,-105,525119,525494,375
104,0,blank,0,-323,-105,525494,525864,370
104,0,blank,0,-323,-105,525864,526043,179
104,0,blank,0,-323,-105,526043,526218,175
104,0,blank,0,-323,-105,526218,526387,169
104,0,blank,0,-323,-105,526387,526535,148
104,0,blank,0,-323,-105,526535,526699,164
104,0,blank,0,-323,-105,526699,526890,191
104,0,blank,0,-323,-105,526890,527061,171
104,0,blank,0,-323,-105,527061,527170,109
104,0,blank,0,-323,-105,527170,527476,306
104,0,blank,0,-323,-105,527476,527644,168
104,0,blank,0,-323,-105,527644,527827,183
104,0,blank,0,-323,-105,527827,528004,177
104,0,blank,0,-323,-105,528004,528192,188
105,0,blank,0,-323,-105,528300,528454,154
105,0,blank,0,-323,-105,528454,528633,179
105,0,blank,0,-323,-105,528633,528691,58
105,0,blank,0,-323,-105,528691,528944,253
105,0,blank,0,-323,-105,528944,529368,424
105,0,blank,0,-323,-105,529368,529551,183
105,0,blank,0,-323,-105,529551,529609,58
