Frameno_fix,lineno_fix,Tokenname_fix,tokens_id,gaze_X_fix,gaze_Y_fix,timestamp_fix_start,timestamp_fix_end,time_duration
100,0,blank,0,36.28564,-74.04752,3341,3527,186
100,0,blank,0,24.9617,-61.15535,3527,3651,124
100,0,blank,0,49.1911666667,-62.0652,3682,3775,93
100,0,blank,0,176.4916166667,-2.3641833333,3916,4101,185
100,0,blank,0,130.0451833333,-30.4974833333,4101,4286,185
100,0,blank,0,76.0402166667,-10.4232166667,4286,4472,186
100,0,blank,0,82.62925,-10.7209,4472,4658,186
100,0,blank,0,79.2691,1.3658,4658,4721,63
100,0,blank,0,-350,-105,4753,4834,81
100,1,Bubble,3,31.4339,4.5001,4864,4918,54
100,1,Bubble,3,63.2425333333,9.6831166667,4983,5157,174
100,1,Bubble,3,65.2959166667,4.6175333333,5157,5346,189
100,2,include,6,16.1814666667,41.3309,5346,5437,91
100,0,blank,0,-350,-105,5468,5645,177
100,0,blank,0,139.5969166667,380.8919666667,5671,5845,174
100,17,comma,110,181.5430166667,372.2544,5845,6031,186
100,0,blank,0,184.5205,370.7397,6031,6092,61
100,3,displayList,13,72.62375,48.8361833333,6124,6304,180
100,3,displayList,13,80.9343666667,52.8399166667,6304,6482,178
100,2,<,7,95.09486,37.90968,6482,6630,148
101,1,Sort,4,97.1418,14.096,6690,6869,179
101,0,blank,0,87.6048833333,12.015,6869,7048,179
101,0,blank,0,16.02375,-4.0061833333,7048,7231,183
101,0,blank,0,75.9335666667,-0.28845,7231,7414,183
101,0,blank,0,-350,-105,7445,7628,183
101,0,blank,0,-350,-105,7628,7827,199
101,0,blank,0,-350,-105,7827,8022,195
101,0,blank,0,-350,-105,8022,8118,96
101,0,blank,0,-350,-105,8118,8520,402
101,0,blank,0,-350,-105,8520,8936,416
101,0,blank,0,-350,-105,8936,9130,194
101,0,blank,0,-350,-105,9130,9304,174
101,0,blank,0,-350,-105,9304,9481,177
101,0,blank,0,-350,-105,9481,9643,162
101,0,blank,0,-350,-105,9643,9840,197
102,0,blank,0,-350,-105,10099,10292,193
102,0,blank,0,-350,-105,10292,10471,179
102,0,blank,0,-350,-105,10471,10563,92
102,0,blank,0,-350,-105,10563,10856,293
102,0,blank,0,-350,-105,10856,11087,231
102,0,blank,0,-350,-105,11087,11268,181
102,0,blank,0,-350,-105,11268,11433,165
102,0,blank,0,-350,-105,11433,11593,160
102,0,blank,0,-350,-105,11593,11749,156
102,0,blank,0,-350,-105,11749,11905,156
102,0,blank,0,-350,-105,11905,12094,189
102,0,blank,0,-350,-105,12094,12266,172
102,0,blank,0,-350,-105,12266,12629,363
102,0,blank,0,-350,-105,12629,12813,184
102,0,blank,0,-350,-105,12813,12988,175
102,0,blank,0,-350,-105,12988,13154,166
102,0,blank,0,-350,-105,13154,13225,71
103,0,blank,0,-350,-105,13342,13413,71
103,0,blank,0,-350,-105,13413,13626,213
103,0,blank,0,-350,-105,13626,13816,190
103,0,blank,0,-350,-105,13816,13933,117
103,0,blank,0,-350,-105,13933,14108,175
103,0,blank,0,-350,-105,14108,14213,105
103,0,blank,0,-350,-105,14213,14389,176
103,0,blank,0,-350,-105,14389,14734,345
103,0,blank,0,-350,-105,14734,14872,138
103,0,blank,0,-350,-105,14872,15011,139
103,0,blank,0,-350,-105,15011,15161,150
103,0,blank,0,-350,-105,15161,15308,147
103,0,blank,0,-350,-105,15308,15364,56
103,0,blank,0,-350,-105,15364,15537,173
103,0,blank,0,-350,-105,15537,15672,135
103,0,blank,0,-350,-105,15672,15910,238
103,0,blank,0,-350,-105,15910,16158,248
103,0,blank,0,-350,-105,16158,16351,193
103,0,blank,0,-350,-105,16351,16481,130
104,0,blank,0,-350,-105,16949,17044,95
104,0,blank,0,-350,-105,17044,17234,190
104,0,blank,0,-350,-105,17234,17347,113
104,0,blank,0,-350,-105,17347,17475,128
104,0,blank,0,-350,-105,17475,17670,195
104,0,blank,0,-350,-105,17670,17833,163
104,0,blank,0,-350,-105,17833,17903,70
104,3,void,12,43.6598,52.0242,17970,18083,113
104,0,blank,0,70.186575,25.806225,18183,18333,150
104,2,include,6,19.0754,40.0094,18333,18535,202
104,0,blank,0,58.65165,24.30605,18535,18715,180
104,2,<,7,100.1762,40.9927,18715,18746,31
104,0,blank,0,-350,-105,18776,18883,107
104,2,include,6,81.8103,36.3803,18908,18943,35
104,0,blank,0,91.8352333333,29.7320166667,19014,19186,172
104,2,include,6,29.2570166667,27.2457166667,19186,19368,182
104,2,include,6,36.3766333333,29.4475833333,19368,19548,180
104,2,include,6,54.62705,37.0223166667,19548,19730,182
104,2,stdio,8,107.1290666667,26.1646333333,19730,19821,91
105,1,Bubble,3,68.7977166667,21.3545666667,19882,20065,183
105,2,include,6,25.9039666667,31.1561,20065,20156,91
105,0,blank,0,-350,-105,20216,20319,103
105,0,blank,0,72.8906666667,25.5633166667,20369,20543,174
105,2,stdio,8,104.21815,36.61875,20543,20729,186
105,3,displayList,13,139.5599666667,49.5258333333,20729,20915,186
105,2,h,10,169.3704333333,37.6130166667,20915,21099,184
105,2,stdio,8,130.77585,36.0549166667,21099,21284,185
105,3,displayList,13,81.4738666667,65.0583333333,21284,21376,92
105,0,blank,0,-350,-105,21406,21463,57
105,2,>,11,176.34455,37.6691833333,21592,21768,176
105,2,>,11,179.204,41.2899166667,21768,21958,190
105,0,blank,0,206.1127166667,46.9596166667,21958,22149,191
105,0,blank,0,195.13445,41.9470666667,22149,22339,190
105,0,blank,0,190.6559833333,46.3843666667,22339,22527,188
105,0,blank,0,199.1049,22.24315,22527,22590,63
105,0,blank,0,334.8895,30.8564333333,22621,22715,94
105,0,blank,0,-350,-105,22746,22827,81
105,0,blank,0,247.8994,30.9168,22856,22906,50
105,0,blank,0,255.76636,22.77086,22975,23123,148
106,0,blank,0,201.6551,27.2417,23187,23250,63
106,0,blank,0,321.21975,32.2135333333,23281,23464,183
106,0,blank,0,319.6791,27.5972,23464,23495,31
106,0,blank,0,207.667575,27.44605,23555,23670,115
106,3,displayList,13,85.2245333333,54.0781666667,23702,23887,185
106,3,displayList,13,89.7897333333,56.5025833333,23887,24070,183
106,0,blank,0,46.1989,66.9991,24070,24100,30
106,3,displayList,13,95.3084,50.60352,24131,24318,187
106,3,displayList,13,78.371675,67.011725,24318,24438,120
106,0,blank,0,-350,-105,24467,24498,31
106,0,blank,0,94.5130571429,81.4817428571,24598,24797,199
106,0,blank,0,64.24195,91.5724833333,24797,24980,183
106,5,int,23,40.0029,101.4359,24980,25070,90
106,0,blank,0,-350,-105,25100,25181,81
106,6,Listis:,28,107.854,119.6078,25207,25256,49
106,0,blank,0,133.26625,80.55555,25324,25497,173
106,0,blank,0,105.27615,45.1477166667,25497,25679,182
106,0,blank,0,132.5207,89.68978,25679,25832,153
106,0,blank,0,-350,-105,25891,26029,138
106,5,0,25,95.3322666667,100.8950666667,26057,26231,174
106,0,blank,0,112.9581,100.7763333333,26231,26409,178
106,0,blank,0,152.6083,100.6147,26409,26439,30
106,0,blank,0,-350,-105,26469,26575,106
106,0,blank,0,118.2477,112.5821,26606,26650,44
106,6,Listis:,28,144.26745,116.6516333333,26719,26892,173
106,6,Listis:,28,130.33545,113.3285833333,26892,27075,183
106,0,blank,0,53.9872333333,88.6396333333,27075,27163,88
106,3,int,19,182.1298166667,51.0294166667,27194,27379,185
106,5,ctr,24,74.9639166667,107.7181166667,27411,27601,190
106,5,ctr,24,74.191,100.0108166667,27601,27793,192
106,0,blank,0,49.7049666667,82.4347,27793,27981,188
106,0,blank,0,108.8241166667,84.2496166667,27981,28171,190
106,0,blank,0,149.4339333333,79.9519833333,28171,28360,189
106,5,int,23,46.7341166667,95.2949666667,28360,28547,187
106,0,blank,0,-350,-105,28578,28659,81
106,5,int,23,46.5101,109.2967,28692,28731,39
106,0,blank,0,62.8758666667,108.71835,28800,28979,179
106,6,printf,26,56.9643833333,119.5023833333,28979,29167,188
106,0,blank,0,46.6999833333,82.6568166667,29167,29356,189
106,3,displayList,13,61.6408,51.7919833333,29356,29544,188
106,0,blank,0,145.52945,76.18485,29544,29732,188
106,6,Listis:,28,102.67355,117.1666833333,29732,29920,188
106,0,blank,0,121.6554,111.6471333333,29920,30109,189
106,6,Listis:,28,136.0592333333,124.9293666667,30109,30205,96
106,0,blank,0,-350,-105,30235,30424,189
106,0,blank,0,-350,-105,30424,30570,146
106,0,blank,0,-350,-105,30570,30709,139
106,0,blank,0,-350,-105,30709,30894,185
106,0,blank,0,257.1581666667,107.5455666667,30926,31010,84
106,0,blank,0,-350,-105,31074,31209,135
106,0,blank,0,183.4697833333,110.5432666667,31238,31413,175
106,7,ctr,41,66.0445333333,141.9774833333,31445,31634,189
106,7,ctr,41,69.1784666667,144.6519333333,31634,31824,190
106,7,0,35,123.7232,147.6106833333,31824,32017,193
106,8,(,49,109.2565,166.7067666667,32017,32110,93
106,0,blank,0,-350,-105,32173,32203,30
106,0,blank,0,204.2962857143,152.3041428571,32312,32511,199
106,0,blank,0,187.0528333333,156.5906166667,32511,32702,191
106,0,blank,0,184.62085,166.3614833333,32702,32891,189
106,8,%d\t,46,161.5790666667,161.7815833333,32891,33080,189
106,7,ctr,41,163.2268,149.6739333333,33080,33268,188
106,7,ctr,41,157.8714,154.0685333333,33268,33458,190
106,3,int,19,189.8173,64.627275,33458,33586,128
106,3,(,14,169.1048,56.0099,33806,33970,164
106,0,blank,0,178.24286,46.6021,33970,34162,192
106,0,blank,0,-350,-105,34193,34379,186
106,0,blank,0,-350,-105,34379,34572,193
106,0,blank,0,-350,-105,34572,34758,186
106,0,blank,0,185.949,156.8110833333,34790,34968,178
106,0,blank,0,-350,-105,34999,35133,134
106,0,blank,0,192.3674,146.6373,35163,35204,41
106,0,blank,0,200.81045,156.8191833333,35270,35448,178
106,7,size,39,241.8593666667,149.596,35448,35541,93
106,0,blank,0,-350,-105,35573,35654,81
106,0,blank,0,364.0494,540.7521,35679,35705,26
106,0,blank,0,184.8714833333,142.3135666667,35755,35924,169
106,7,=,34,112.4873666667,149.3234833333,35924,36110,186
106,0,blank,0,209.12905,153.6703,36110,36296,186
106,7,size,39,214.91255,141.4985333333,36296,36481,185
106,7,size,39,223.5038166667,149.5453833333,36481,36667,186
106,7,size,39,244.52995,142.8121,36667,36730,63
106,0,blank,0,-350,-105,36793,36827,34
106,0,blank,0,113.9738,269.4698,36852,36877,25
106,6,Listis:,28,100.7413833333,117.4843666667,36939,37117,178
106,6,Listis:,28,151.0200666667,133.0939333333,37117,37307,190
106,7,ctr,41,167.0170833333,142.3762166667,37307,37495,188
106,7,ctr,41,183.0524,143.94385,37495,37684,189
106,7,ctr,41,155.14935,137.5256,37684,37873,189
106,0,blank,0,122.5566333333,134.2546166667,37873,38063,190
106,0,blank,0,-350,-105,38094,38201,107
106,2,>,11,176.7979,34.6556,38229,38268,39
106,2,stdio,8,144.2123166667,35.8829666667,38338,38523,185
106,0,blank,0,221.5622666667,25.8691,38523,38713,190
106,0,blank,0,192.84955,25.5643,38713,38899,186
106,3,int,19,178.0031,67.0635,38899,38930,31
106,0,blank,0,-350,-105,38960,39042,82
106,0,blank,0,194.5059,16.5461,39077,39148,71
106,0,blank,0,188.5818666667,30.8187166667,39216,39392,176
106,0,blank,0,188.8363,34.89535,39392,39520,128
106,0,blank,0,-350,-105,39583,39666,83
106,0,blank,0,185.6586,164.753,39692,39722,30
106,8,comma,47,181.7348833333,164.1776833333,39791,39968,177
106,8,comma,47,180.38392,159.44724,39968,40125,157
106,0,blank,0,185.19635,43.7973333333,40156,40343,187
106,2,>,11,180.6777166667,41.5146,40343,40531,188
106,0,blank,0,194.0203333333,44.7806,40531,40625,94
106,0,blank,0,-350,-105,40656,40737,81
106,7,<,38,193.3287,136.7939,40776,40833,57
106,7,size,39,227.4839,149.3286,40898,41076,178
106,0,blank,0,100.4104333333,148.80205,41108,41296,188
106,7,=,34,113.0964166667,150.3308833333,41296,41483,187
106,7,0,40,135.2511666667,143.81055,41483,41669,186
106,0,blank,0,118.7890833333,143.3922833333,41669,41857,188
106,0,blank,0,122.7752333333,142.06455,41857,42041,184
106,7,0,35,131.7256,142.272,42041,42073,32
106,0,blank,0,-350,-105,42104,42160,56
106,0,blank,0,193.1292,495.1945,42185,42210,25
106,0,blank,0,100.8086,149.1437166667,42260,42434,174
106,7,0,35,124.5943333333,135.2388333333,42434,42622,188
106,7,=,34,107.1217666667,138.5480166667,42622,42810,188
106,7,0,35,124.1029666667,146.141,42810,42996,186
106,0,blank,0,-350,-105,43058,43139,81
106,7,=,34,109.623,144.0781,43166,43228,62
106,7,=,34,105.9916166667,142.4885333333,43291,43466,175
106,0,blank,0,100.5826333333,140.1945,43466,43655,189
106,0,blank,0,94.5632166667,139.3854166667,43655,43844,189
106,0,blank,0,-350,-105,43874,44006,132
106,8,printf,44,85.2353,170.6373,44044,44095,51
106,0,blank,0,33.3524166667,161.0542166667,44163,44343,180
106,0,blank,0,31.5608,165.8917333333,44343,44532,189
106,8,printf,44,79.927,173.4946333333,44532,44718,186
106,0,blank,0,32.3709166667,176.5540833333,44718,44906,188
106,0,blank,0,21.1731666667,206.6403333333,44906,45097,191
106,11,int,62,24.1545,226.538675,45097,45223,126
106,13,12,73,159.62495,276.2961333333,45255,45446,191
106,13,=,71,128.74045,268.9652666667,45446,45637,191
106,0,blank,0,136.3345333333,215.60815,45637,45826,189
106,7,ctr,41,172.7569166667,155.1666166667,45826,46015,189
106,8,a,50,221.3106666667,160.6655,46015,46202,187
106,0,blank,0,141.10315,108.9529833333,46202,46389,187
106,3,int,19,177.5515333333,47.10565,46389,46576,187
106,0,blank,0,199.2094166667,38.4664,46576,46765,189
106,0,blank,0,-350,-105,46797,46910,113
106,0,blank,0,250.7291666667,42.5444166667,46962,47145,183
106,0,blank,0,188.4825666667,43.2933333333,47145,47241,96
106,0,blank,0,211.4264,262.7475,47272,47460,188
106,0,blank,0,213.2845,199.0770833333,47460,47648,188
106,8,a,50,217.7140833333,158.143,47648,47838,190
106,7,size,39,219.1680333333,154.9449,47838,48026,188
106,7,<,38,195.3705166667,151.0135833333,48026,48212,186
106,7,ctr,41,173.3433666667,147.4857333333,48212,48403,191
106,7,ctr,41,171.2716166667,144.3366333333,48403,48594,191
106,7,size,39,215.0365166667,149.2648166667,48594,48788,194
106,0,blank,0,192.6228,148.28005,48788,48979,191
106,7,ctr,41,179.5788166667,142.4509666667,48979,49172,193
106,7,ctr,41,179.0651333333,140.0634833333,49172,49370,198
106,7,ctr,41,174.6638,141.2196,49370,49402,32
106,0,blank,0,271.23495,263.3262333333,49434,49631,197
106,0,blank,0,-350,-105,49664,49854,190
106,0,blank,0,-350,-105,49854,50053,199
106,0,blank,0,190.3380666667,255.5272,50107,50195,88
106,0,blank,0,-28.0817,253.79376,50229,50398,169
106,0,blank,0,15.33526,209.33352,50398,50567,169
106,11,int,62,19.944275,226.2429,50567,50696,129
106,0,blank,0,-350,-105,50761,50944,183
106,0,blank,0,-350,-105,50944,50976,32
106,0,blank,0,-350,-105,51127,51215,88
106,11,main,63,52.9306,238.1159,51258,51312,54
106,0,blank,0,17.0892666667,266.5544333333,51422,51516,94
106,0,blank,0,-350,-105,51548,51723,175
106,0,blank,0,126.374,262.6924666667,51772,51868,96
106,0,blank,0,128.501,261.5807,51903,51966,63
106,14,list,91,203.9566,298.499125,52066,52191,125
106,0,blank,0,36.593925,255.98685,52257,52386,129
106,0,blank,0,-350,-105,52417,52525,108
106,0,blank,0,172.5316,249.247,52550,52581,31
106,0,blank,0,180.13695,255.2244333333,52652,52835,183
106,0,blank,0,148.5607833333,260.6045666667,52835,53025,190
106,0,blank,0,166.7543333333,266.3645,53025,53216,191
106,13,comma,82,181.8412833333,270.3075,53216,53405,189
106,0,blank,0,215.380825,262.720525,53405,53531,126
106,0,blank,0,-350,-105,53563,53646,83
106,0,blank,0,202.0688,252.4071,53672,53698,26
106,0,blank,0,194.88245,256.4137833333,53763,53942,179
106,0,blank,0,189.1398,259.93675,53942,54029,87
106,0,blank,0,152.07735,262.7676,54029,54228,199
106,0,blank,0,177.1747,256.9162,54228,54390,162
106,0,blank,0,193.11932,263.22334,54390,54558,168
106,0,blank,0,207.6730666667,262.88575,54558,54748,190
106,0,blank,0,186.8429166667,263.4269666667,54748,54940,192
106,0,blank,0,149.3575166667,263.7045833333,54940,55126,186
106,14,sizeof,94,130.92485,303.69175,55126,55191,65
106,0,blank,0,-350,-105,55219,55353,134
106,0,blank,0,160.0785,251.6688,55378,55404,26
106,0,blank,0,177.3138,245.3821333333,55458,55634,176
106,0,blank,0,194.1191166667,253.2834666667,55634,55824,190
106,0,blank,0,198.0270166667,260.3560833333,55824,56011,187
106,0,blank,0,219.0382833333,261.6563,56011,56201,190
106,0,blank,0,227.60405,254.2432,56201,56391,190
106,0,blank,0,243.7624333333,252.1987333333,56391,56583,192
106,0,blank,0,231.82545,252.80775,56583,56646,63
106,0,blank,0,-350,-105,56678,56760,82
106,0,blank,0,260.1912,253.3508,56805,56860,55
106,0,blank,0,281.3289333333,257.1198833333,56927,57108,181
106,0,blank,0,268.29135,262.29765,57108,57301,193
106,0,blank,0,243.4045,258.7402,57301,57333,32
106,0,blank,0,132.1622666667,251.2139,57365,57552,187
106,0,blank,0,38.271125,242.2576,57614,57745,131
106,13,int,67,23.4738333333,282.0399333333,57806,57994,188
106,12,{,66,10.1953,262.7558,57994,58024,30
106,0,blank,0,-0.4167333333,267.8448,58086,58179,93
106,13,{,72,144.32525,287.811875,58211,58335,124
106,0,blank,0,-350,-105,58366,58552,186
106,0,blank,0,-350,-105,58552,58725,173
106,0,blank,0,-350,-105,58725,58916,191
106,0,blank,0,-350,-105,58916,59101,185
106,0,blank,0,40.4223,246.5826,59329,59486,157
106,11,main,63,81.1346,242.2417333333,59551,59742,191
106,0,blank,0,146.71262,246.6141,59742,59926,184
106,0,blank,0,192.5687,257.32235,59926,60013,87
106,0,blank,0,339.06675,244.337,60099,60185,86
106,0,blank,0,94.17535,266.9477,60379,60467,88
106,0,blank,0,-350,-105,60511,60686,175
106,0,blank,0,-350,-105,60686,60865,179
106,0,blank,0,-350,-105,60865,61039,174
106,0,blank,0,-350,-105,61039,61178,139
106,0,blank,0,-350,-105,61178,61368,190
106,0,blank,0,-350,-105,61368,61537,169
106,0,blank,0,-350,-105,61537,61728,191
106,0,blank,0,-350,-105,61728,62085,357
106,0,blank,0,-350,-105,62085,62135,50
106,0,blank,0,-350,-105,62135,62611,476
106,0,blank,0,-350,-105,62611,63077,466
106,0,blank,0,-350,-105,63077,63147,70
106,0,blank,0,-350,-105,63147,63312,165
106,0,blank,0,-350,-105,63312,63501,189
106,0,blank,0,-350,-105,63501,63528,27
106,0,blank,0,-350,-105,63528,64190,662
106,0,blank,0,-350,-105,64190,64847,657
106,0,blank,0,-350,-105,64847,65016,169
106,0,blank,0,-350,-105,65016,65100,84
106,0,blank,0,-350,-105,65100,65299,199
106,0,blank,0,-350,-105,65299,65493,194
106,0,blank,0,-350,-105,65493,65688,195
106,0,blank,0,-350,-105,65688,65849,161
106,0,blank,0,-350,-105,65849,66021,172
106,0,blank,0,-350,-105,66021,66136,115
106,0,blank,0,-350,-105,66136,66239,103
106,0,blank,0,-350,-105,66239,66346,107
106,0,blank,0,-350,-105,66346,66519,173
106,0,blank,0,-350,-105,66519,66709,190
106,0,blank,0,-350,-105,66709,66874,165
106,0,blank,0,-350,-105,66874,67014,140
106,0,blank,0,-350,-105,67014,67272,258
106,0,blank,0,-350,-105,67272,67676,404
106,0,blank,0,-350,-105,67676,67708,32
106,14,int,96,39.1596,306.9645333333,67742,67894,152
106,15,j,102,87.83765,316.621775,67936,68110,174
106,15,j,102,88.303525,316.41515,68110,68289,179
106,15,j,102,87.98795,329.47395,68289,68469,180
106,0,blank,0,47.1501,317.29215,68469,68558,89
106,0,blank,0,-350,-105,68605,68715,110
106,15,int,99,31.7365,322.4042,68748,68791,43
106,15,int,99,13.6327166667,328.88475,68859,69041,182
106,0,blank,0,-4.6195166667,328.3405333333,69041,69228,187
106,0,blank,0,1.0674,338.78015,69228,69413,185
106,15,int,99,22.1657166667,328.6324833333,69413,69595,182
106,0,blank,0,44.125,325.1059,69595,69777,182
106,15,int,99,42.5047833333,330.2634666667,69777,69961,184
106,0,blank,0,47.5690166667,327.39095,69961,70147,186
106,0,blank,0,49.0369333333,329.3808,70147,70240,93
106,0,blank,0,-350,-105,70271,70433,162
106,0,blank,0,-350,-105,70433,70475,42
106,16,int,104,41.7148333333,334.37285,70507,70686,179
106,15,int,99,25.2708,330.8473666667,70686,70877,191
106,0,blank,0,-2.4445,316.2019166667,70877,71068,191
106,0,blank,0,-1.3297,319.7356166667,71068,71255,187
106,0,blank,0,11.8064833333,318.3242166667,71255,71437,182
106,0,blank,0,12.786225,350.422375,71437,71560,123
106,0,blank,0,-350,-105,71591,71724,133
106,17,displayList,107,44.3256,370.6187,71750,71776,26
106,16,temp,105,60.2619,349.2605833333,71834,72016,182
106,16,temp,105,64.3280166667,351.7287,72016,72204,188
106,16,int,104,42.7746833333,345.21025,72204,72390,186
106,0,blank,0,12.862,351.471,72390,72483,93
106,0,blank,0,-350,-105,72514,72622,108
106,15,int,99,42.8601,314.17,72653,72696,43
106,0,blank,0,44.8123333333,316.2577166667,72761,72937,176
106,0,blank,0,41.0089,288.8869,72937,73123,186
106,13,int,67,43.8814,275.9024666667,73123,73216,93
106,13,12,73,166.4319833333,283.0288833333,73247,73431,184
106,13,[,69,100.7382333333,285.3814166667,73431,73615,184
106,13,int,67,29.36405,283.0535833333,73615,73798,183
106,0,blank,0,-350,-105,73829,73911,82
106,13,int,67,39.8327,273.3602,73942,73989,47
106,0,blank,0,41.09535,266.00675,74054,74231,177
106,0,blank,0,55.081675,267.856575,74231,74358,127
106,0,blank,0,173.93635,262.812,74399,74575,176
106,14,sizeof,94,138.3087,296.29075,74770,74947,177
106,14,sizeof,94,146.5640166667,291.8202333333,74947,75133,186
106,14,sizeof,94,127.9720333333,289.8074333333,75133,75320,187
106,0,blank,0,112.8046833333,286.2812666667,75320,75510,190
106,0,blank,0,68.66385,257.21525,75510,75699,189
106,11,main,63,71.909025,231.84935,75699,75822,123
106,13,5,79,277.78785,287.6111833333,75884,76072,188
106,13,11,77,252.8805,287.9028,76072,76165,93
106,0,blank,0,-350,-105,76196,76361,165
106,13,12,73,159.414,268.5353333333,76412,76592,180
106,0,blank,0,60.4804166667,264.9560333333,76592,76779,187
106,13,list,68,60.0094,268.594225,76779,76904,125
106,0,blank,0,178.16355,261.5938166667,76936,77123,187
106,13,12,73,170.9974,269.5514833333,77123,77309,186
106,13,=,71,126.4706,270.9013,77309,77433,124
106,0,blank,0,-350,-105,77465,77629,164
106,0,blank,0,142.4956833333,278.1736666667,77658,77835,177
106,0,blank,0,127.5731,257.13085,77835,78025,190
106,0,blank,0,135.3558,274.4081,78025,78056,31
106,0,blank,0,265.1445166667,265.5678833333,78089,78278,189
106,13,comma,82,175.4677333333,269.32085,78308,78494,186
106,0,blank,0,240.6684,254.60964,78494,78647,153
106,0,blank,0,-350,-105,78708,78789,81
106,15,i,100,56.9964,322.7545,78817,78865,48
106,15,int,99,22.26505,325.0798333333,78955,79131,176
106,0,blank,0,-350,-105,79192,79351,159
106,0,blank,0,5.6486,331.4087,79388,79434,46
106,16,int,104,29.7735833333,339.4292666667,79507,79684,177
106,16,temp,105,78.2741666667,347.1221333333,79684,79777,93
106,0,blank,0,-350,-105,79840,80033,193
106,0,blank,0,-350,-105,80033,80161,128
106,0,blank,0,-350,-105,80161,80332,171
106,16,int,104,21.0404,350.7339,80358,80534,176
106,17,displayList,107,40.86105,361.7074666667,80534,80714,180
106,16,temp,105,73.60755,351.3674833333,80714,80899,185
106,16,temp,105,73.6565166667,350.3592166667,80899,81080,181
106,0,blank,0,103.6101833333,350.61915,81080,81264,184
106,0,blank,0,128.2772166667,346.1298,81264,81443,179
106,0,blank,0,113.9905166667,353.71015,81443,81627,184
106,17,displayList,107,114.7008666667,356.73855,81627,81812,185
106,17,displayList,107,89.7438,355.4865833333,81812,82000,188
106,17,displayList,107,54.32685,360.77345,82000,82189,189
106,17,displayList,107,120.07345,360.7677666667,82189,82383,194
106,17,displayList,107,84.88935,360.0017666667,82383,82578,195
106,16,temp,105,87.8939333333,351.0677833333,82578,82773,195
106,0,blank,0,114.1307,346.6954,82773,82839,66
106,0,blank,0,-350,-105,82872,83010,138
106,16,temp,105,68.3022833333,346.2735666667,83038,83220,182
106,0,blank,0,45.3259,354.6024833333,83220,83412,192
106,17,displayList,107,64.6182166667,355.9755833333,83412,83603,191
106,17,displayList,107,106.47915,358.2886333333,83603,83790,187
106,0,blank,0,131.41365,353.5371333333,83790,83981,191
106,0,blank,0,192.0696,339.6060333333,83981,84165,184
106,0,blank,0,149.4105666667,352.4366166667,84165,84352,187
106,0,blank,0,-350,-105,84415,84520,105
106,18,for,114,36.4748333333,386.26095,84634,84810,176
106,0,blank,0,11.5972,367.1412333333,84810,84995,185
106,18,(,115,51.7810333333,385.1360333333,84995,85177,182
106,0,blank,0,70.0718166667,383.1290333333,85177,85358,181
106,17,displayList,107,70.9290333333,367.9777666667,85358,85539,181
106,0,blank,0,114.9241,378.1272333333,85539,85719,180
106,18,0,118,94.5966,378.11945,85719,85782,63
106,0,blank,0,-350,-105,85843,85919,76
106,17,list,109,143.8402,372.1504,85944,85970,26
106,17,list,109,136.40975,364.9823833333,86036,86214,178
106,17,comma,110,174.70245,374.6226833333,86214,86403,189
106,0,blank,0,189.4241333333,373.1080333333,86403,86591,188
106,18,size,122,195.0429,382.0808,86591,86653,62
106,18,(,115,52.4800833333,390.3082,86684,86872,188
106,20,for,128,59.4790166667,428.2339333333,86872,87058,186
106,0,blank,0,38.58152,424.56358,87058,87213,155
106,0,blank,0,-350,-105,87245,87351,106
106,17,displayList,107,69.597,362.6415,87382,87426,44
106,0,blank,0,70.2852833333,377.4928,87491,87670,179
106,18,<,121,148.1596333333,379.54125,87670,87860,190
106,0,blank,0,-350,-105,87922,88000,78
106,20,size,136,207.8195166667,438.5585333333,88096,88269,173
106,0,blank,0,245.55865,431.9822666667,88269,88454,185
106,20,size,136,205.15865,425.2153166667,88454,88639,185
106,0,blank,0,197.7912166667,421.0440666667,88639,88825,186
106,0,blank,0,177.59535,422.1165666667,88825,89011,186
106,20,0,132,133.8022,422.3347,89011,89042,31
106,0,blank,0,-350,-105,89074,89207,133
106,0,blank,0,173.3843,398.1699,89275,89353,78
106,18,i,124,131.9356833333,385.7910833333,89419,89599,180
106,0,blank,0,138.6912333333,384.2838666667,89599,89791,192
106,0,blank,0,179.5988166667,420.7660166667,89791,89985,194
106,0,blank,0,238.6716333333,415.9544,89985,90176,191
106,0,blank,0,-350,-105,90208,90317,109
106,0,blank,0,129.4401,443.143,90362,90419,57
106,0,blank,0,77.8643333333,461.5972,90485,90665,180
106,0,blank,0,33.9780166667,459.4321,90665,90854,189
106,0,blank,0,133.83545,459.1516833333,90854,91043,189
106,0,blank,0,182.1484,451.95245,91043,91106,63
106,0,blank,0,97.7177833333,460.98535,91137,91326,189
106,0,blank,0,98.9667333333,463.4155333333,91326,91512,186
106,0,blank,0,82.3375166667,456.1392166667,91512,91702,190
106,0,blank,0,-350,-105,91765,91908,143
106,0,blank,0,115.1845,456.79885,91934,92109,175
106,0,blank,0,191.6228,466.5740333333,92109,92303,194
106,0,blank,0,165.41825,462.0415333333,92303,92496,193
106,22,list,151,133.7014166667,469.0705,92496,92687,191
106,0,blank,0,118.87095,463.3636333333,92687,92876,189
106,22,list,151,105.5367666667,469.7476,92876,93068,192
106,22,],156,158.835275,473.0392,93068,93196,128
106,0,blank,0,-350,-105,93229,93339,110
106,22,list,151,204.2163833333,467.9086833333,93449,93633,184
106,0,blank,0,156.8109666667,455.6606333333,93633,93828,195
106,0,blank,0,134.6960666667,462.1832,93828,94020,192
106,0,blank,0,109.3834666667,461.3373333333,94020,94212,192
106,0,blank,0,112.9953,463.9186833333,94212,94404,192
106,0,blank,0,109.1790166667,464.6026666667,94404,94597,193
106,22,list,151,114.1258,468.2391,94597,94629,32
106,0,blank,0,-350,-105,94694,94802,108
106,0,blank,0,-350,-105,94802,94945,143
106,0,blank,0,147.33575,457.3927,95004,95194,190
106,0,blank,0,129.20854,455.75178,95194,95362,168
106,0,blank,0,88.9542666667,459.0720833333,95362,95560,198
106,22,(,145,86.4689,471.9964,95560,95589,29
106,0,blank,0,-350,-105,95622,95809,187
106,0,blank,0,-350,-105,95809,95950,141
106,22,list,151,102.14894,473.38996,95978,96163,185
106,22,if,144,84.9754,471.087,96163,96194,31
106,0,blank,0,-350,-105,96258,96446,188
106,0,blank,0,-350,-105,96446,96551,105
106,0,blank,0,-350,-105,96551,96646,95
106,0,blank,0,-350,-105,96646,96791,145
106,0,blank,0,58.3084333333,445.1863333333,96836,96943,107
106,0,blank,0,184.797575,466.483775,96975,97103,128
106,0,blank,0,-350,-105,97136,97267,131
106,0,blank,0,-350,-105,97267,97438,171
106,22,list,151,194.8467666667,473.8237166667,97482,97673,191
106,0,blank,0,189.6858,475.5544,97673,97764,91
106,0,blank,0,68.85525,511.9907833333,98029,98219,190
106,0,blank,0,60.52055,514.301,98219,98410,191
106,24,list,161,159.67205,513.4610166667,98410,98597,187
106,24,temp,159,115.79675,520.57,98597,98789,192
106,0,blank,0,70.0997,517.9303833333,98789,98980,191
106,0,blank,0,-350,-105,99043,99150,107
106,0,blank,0,144.4464,417.2264,99188,99238,50
106,0,blank,0,204.4725333333,463.7520333333,99304,99486,182
106,22,list,151,205.6391666667,467.9600333333,99486,99679,193
106,0,blank,0,100.7214166667,493.3453666667,99679,99873,194
106,0,blank,0,82.2451,498.2299333333,99873,100064,191
106,0,blank,0,66.400375,508.976575,100064,100193,129
106,30,displayList,190,30.2635333333,646.22405,100225,100418,193
106,0,blank,0,118.4554,631.9522333333,100418,100611,193
106,0,blank,0,79.45725,639.2321666667,100611,100805,194
106,0,blank,0,70.2255166667,632.8005,100805,100994,189
106,0,blank,0,132.9207666667,619.7650666667,100994,101088,94
106,5,int,23,35.9474333333,95.4346333333,101121,101312,191
106,0,blank,0,42.7848666667,71.02925,101312,101505,193
106,2,include,6,63.7098,38.7127833333,101505,101691,186
106,2,stdio,8,128.5376333333,37.9086333333,101691,101877,186
106,0,blank,0,198.4342166667,44.8461333333,101877,102061,184
106,0,blank,0,263.0813,44.6214,102061,102245,184
106,0,blank,0,-350,-105,102307,102409,102
106,0,blank,0,185.0680166667,633.5602166667,102523,102703,180
106,0,blank,0,194.1346,605.6733,102703,102735,32
106,0,blank,0,77.7891,263.9856333333,102766,102957,191
106,8,printf,44,70.925,157.1404333333,102988,103177,189
106,7,0,40,141.6033166667,151.1481166667,103177,103365,188
106,0,blank,0,203.20982,144.23728,103365,103520,155
106,8,printf,44,59.25855,167.7089166667,103551,103741,190
106,8,printf,44,63.9706,169.92855,103741,103805,64
106,6,Listis:,28,208.5311,126.95495,103837,103965,128
106,6,printf,26,74.11675,113.8081,103997,104190,193
106,5,ctr,24,88.5080833333,104.0776833333,104190,104381,191
106,6,Listis:,28,128.7953833333,119.1080166667,104381,104572,191
106,0,blank,0,149.4816,101.4135,104572,104605,33
106,0,blank,0,268.6939166667,125.9231,104638,104827,189
106,0,blank,0,-350,-105,104860,104991,131
106,0,blank,0,145.6815,530.6913,105035,105091,56
106,25,list,171,101.1871666667,536.2033666667,105160,105342,182
106,0,blank,0,64.105,542.2595,105342,105532,190
106,24,temp,159,82.0754,525.4857,105532,105563,31
106,0,blank,0,-350,-105,105626,105809,183
106,0,blank,0,-350,-105,105809,105983,174
106,0,blank,0,-350,-105,105983,106105,122
106,25,list,171,92.52075,544.90185,106144,106201,57
106,0,blank,0,-350,-105,106229,106413,184
106,0,blank,0,-350,-105,106413,106474,61
106,25,list,171,118.8839833333,550.5967166667,106503,106676,173
106,0,blank,0,128.5639666667,524.63995,106676,106864,188
106,24,list,161,175.4671166667,529.9845666667,106864,107050,186
106,24,=,160,141.1121833333,526.8333,107050,107236,186
106,24,temp,159,96.766,510.2589166667,107236,107420,184
106,24,temp,159,123.92285,514.4315166667,107420,107606,186
106,24,list,161,163.9015,524.409,107606,107636,30
106,0,blank,0,-350,-105,107668,107836,168
106,22,list,151,116.2886333333,474.1675333333,107864,108042,178
106,22,j,153,151.2975166667,468.6930833333,108042,108229,187
106,0,blank,0,182.1091166667,464.2389,108229,108414,185
106,0,blank,0,127.4021166667,462.69425,108414,108598,184
106,0,blank,0,66.7761,461.37255,108598,108659,61
106,0,blank,0,-350,-105,108721,108905,184
106,0,blank,0,-350,-105,108905,109084,179
106,0,blank,0,131.0774833333,419.3245333333,109114,109291,177
106,0,blank,0,75.7011666667,415.7869333333,109291,109483,192
106,0,blank,0,180.1949833333,402.6577333333,109514,109705,191
106,0,blank,0,153.5507,412.3446,109705,109768,63
106,0,blank,0,-350,-105,109799,109907,108
106,0,blank,0,130.5184,411.5384,109935,109975,40
106,0,blank,0,84.5039,387.4652166667,110044,110223,179
106,17,displayList,107,66.1243,363.89965,110223,110416,193
106,0,blank,0,148.6307833333,352.0981833333,110416,110613,197
106,18,=,117,82.35454,380.3949,110613,110777,164
106,0,blank,0,-350,-105,110809,110840,31
106,0,blank,0,186.6264,-103.8474,110866,110891,25
106,0,blank,0,141.6739833333,402.0753666667,110940,111117,177
106,0,blank,0,190.5537,405.3979,111117,111312,195
106,0,blank,0,244.05295,405.0804666667,111312,111506,194
106,0,blank,0,175.0567,406.8896166667,111506,111698,192
106,0,blank,0,118.91545,378.23775,111698,111889,191
106,16,temp,105,79.2918833333,352.3185666667,111889,112079,190
106,20,j,140,101.4739666667,422.3934333333,112079,112270,191
106,0,blank,0,112.427,459.6199333333,112270,112463,193
106,0,blank,0,203.43194,451.97584,112463,112624,161
106,0,blank,0,-350,-105,112689,112749,60
106,0,blank,0,153.8328166667,502.4458333333,112799,112976,177
106,24,temp,159,108.2824833333,516.74545,112976,113166,190
106,0,blank,0,83.45725,535.0614166667,113166,113357,191
106,0,blank,0,99.4519,531.7784333333,113357,113546,189
106,25,list,171,119.56795,550.8870166667,113546,113735,189
106,0,blank,0,145.1551,503.9521166667,113735,113924,189
106,0,blank,0,130.3946333333,513.4513,113924,114113,189
106,0,blank,0,143.9347333333,536.3534166667,114113,114304,191
106,0,blank,0,205.20885,530.246825,114304,114433,129
106,0,blank,0,-350,-105,114495,114576,81
106,0,blank,0,182.2903,501.6143,114613,114660,47
106,0,blank,0,46.0859666667,637.1254666667,114754,114945,191
106,30,displayList,190,96.49284,643.21268,114945,115103,158
106,0,blank,0,81.09575,529.25115,115134,115272,138
106,25,list,171,90.8647,537.1998,115272,115375,103
106,0,blank,0,99.55375,636.9742,115375,115551,176
106,30,displayList,190,98.4466833333,648.1214333333,115551,115747,196
106,30,displayList,190,60.4798833333,645.5182666667,115747,115937,190
106,30,displayList,190,62.5552,653.2053,115937,115969,32
106,0,blank,0,44.0663,398.10645,116033,116224,191
106,17,displayList,107,53.5093,368.40755,116224,116288,64
106,0,blank,0,-350,-105,116352,116512,160
106,17,displayList,107,58.743,366.5065,116560,116629,69
106,18,i,124,124.9447,378.0801333333,116713,116893,180
106,18,for,114,28.56205,377.019475,116893,117022,129
106,0,blank,0,-350,-105,117053,117240,187
106,0,blank,0,-350,-105,117240,117366,126
106,0,blank,0,-350,-105,117366,117471,105
106,0,blank,0,-350,-105,117471,117589,118
106,0,blank,0,-350,-105,117589,117765,176
106,0,blank,0,-350,-105,117765,117886,121
106,0,blank,0,-350,-105,117886,117978,92
106,0,blank,0,-350,-105,117978,118210,232
106,0,blank,0,-350,-105,118210,118398,188
106,0,blank,0,-350,-105,118398,118537,139
106,0,blank,0,-350,-105,118537,118735,198
106,0,blank,0,-350,-105,118735,118884,149
106,0,blank,0,-350,-105,118884,119051,167
106,0,blank,0,-350,-105,119051,119221,170
106,0,blank,0,-350,-105,119221,119403,182
106,0,blank,0,-350,-105,119403,119573,170
106,0,blank,0,-350,-105,119573,119767,194
106,0,blank,0,-350,-105,119767,119964,197
106,0,blank,0,-350,-105,119964,120144,180
106,0,blank,0,-350,-105,120144,120319,175
106,0,blank,0,-350,-105,120319,120446,127
106,0,blank,0,-350,-105,120446,120575,129
106,0,blank,0,-350,-105,120575,120715,140
106,0,blank,0,-350,-105,120715,121113,398
106,0,blank,0,-350,-105,121113,121540,427
106,0,blank,0,-350,-105,121540,121722,182
106,0,blank,0,-350,-105,121722,121917,195
106,0,blank,0,-350,-105,121917,121940,23
106,0,blank,0,-350,-105,121940,122174,234
106,0,blank,0,-350,-105,122174,122197,23
106,0,blank,0,-350,-105,122197,122502,305
106,0,blank,0,-350,-105,122502,122585,83
106,0,blank,0,-350,-105,122585,122751,166
106,0,blank,0,-350,-105,122751,123006,255
106,0,blank,0,-350,-105,123006,123260,254
106,0,blank,0,-350,-105,123260,123428,168
106,0,blank,0,-350,-105,123428,123621,193
106,0,blank,0,-350,-105,123621,123785,164
106,0,blank,0,-350,-105,123785,123951,166
106,0,blank,0,-350,-105,123951,124199,248
106,0,blank,0,-350,-105,124199,124395,196
106,0,blank,0,-350,-105,124395,124578,183
106,0,blank,0,-350,-105,124578,124757,179
106,0,blank,0,-350,-105,124757,124916,159
106,0,blank,0,-350,-105,124916,124963,47
106,0,blank,0,-350,-105,124963,125130,167
106,0,blank,0,-350,-105,125130,125195,65
106,17,displayList,107,85.2626,374.4752,125251,125449,198
106,0,blank,0,181.82305,541.0631,125449,125521,72
106,0,blank,0,-350,-105,125558,125692,134
106,0,blank,0,-350,-105,125692,125887,195
106,0,blank,0,-350,-105,125887,125974,87
106,0,blank,0,-350,-105,125974,126109,135
106,0,blank,0,-350,-105,126109,126292,183
106,0,blank,0,-350,-105,126292,126490,198
106,0,blank,0,-350,-105,126490,126689,199
106,0,blank,0,-350,-105,126689,126884,195
106,0,blank,0,-350,-105,126884,126957,73
106,22,list,151,133.29815,471.7237,126996,127092,96
106,22,j,153,145.91075,476.42085,127148,127211,63
106,0,blank,0,205.775,729.4119,127568,127598,30
106,0,blank,0,-350,-105,127630,127811,181
106,0,blank,0,-350,-105,127811,127998,187
106,0,blank,0,-350,-105,127998,128186,188
106,0,blank,0,-350,-105,128186,128360,174
106,0,blank,0,-350,-105,128360,128551,191
106,0,blank,0,-350,-105,128551,128727,176
106,0,blank,0,-350,-105,128727,128796,69
106,0,blank,0,-350,-105,128796,129142,346
106,0,blank,0,-350,-105,129142,129396,254
106,0,blank,0,-350,-105,129396,129501,105
106,25,],176,150.25668,548.967,129527,129702,175
106,0,blank,0,39.834225,588.63345,129702,129820,118
106,0,blank,0,-350,-105,129940,130082,142
106,0,blank,0,-350,-105,130082,130258,176
106,0,blank,0,-350,-105,130258,130423,165
106,0,blank,0,-350,-105,130423,130610,187
106,0,blank,0,-350,-105,130610,130733,123
106,0,blank,0,-350,-105,130733,130919,186
106,0,blank,0,-350,-105,130919,131104,185
106,0,blank,0,-350,-105,131104,131271,167
106,0,blank,0,-350,-105,131271,131447,176
106,0,blank,0,-350,-105,131447,131549,102
106,0,blank,0,-350,-105,131549,131744,195
106,0,blank,0,-350,-105,131744,131886,142
106,0,blank,0,-350,-105,131886,132066,180
106,0,blank,0,-350,-105,132066,132231,165
106,0,blank,0,-350,-105,132231,132320,89
106,0,blank,0,-350,-105,132320,132496,176
106,0,blank,0,-350,-105,132496,132775,279
106,0,blank,0,-350,-105,132775,132921,146
106,0,blank,0,-350,-105,132921,133099,178
106,0,blank,0,-350,-105,133099,133289,190
106,0,blank,0,-350,-105,133289,133461,172
106,0,blank,0,-350,-105,133461,133651,190
106,0,blank,0,-350,-105,133651,133844,193
106,0,blank,0,-350,-105,133844,134019,175
106,0,blank,0,-350,-105,134019,134204,185
106,0,blank,0,-350,-105,134204,134361,157
106,0,blank,0,-350,-105,134361,134523,162
106,0,blank,0,-350,-105,134523,134709,186
106,0,blank,0,-350,-105,134709,134851,142
106,0,blank,0,-350,-105,134851,134993,142
106,0,blank,0,-350,-105,134993,135153,160
106,0,blank,0,-350,-105,135535,135922,387
106,0,blank,0,-350,-105,135922,135971,49
106,0,blank,0,-350,-105,135971,136126,155
106,20,size,136,228.9913833333,421.3574,136167,136342,175
106,0,blank,0,238.9276,415.40775,136342,136404,62
106,0,blank,0,34.3877333333,483.3975333333,136436,136619,183
106,0,blank,0,23.8543166667,568.6267,136619,136802,183
106,0,blank,0,-350,-105,136834,137033,199
106,0,blank,0,-350,-105,137033,137164,131
106,0,blank,0,-350,-105,137164,137337,173
106,0,blank,0,-350,-105,137337,137457,120
106,0,blank,0,-350,-105,137457,137637,180
106,0,blank,0,-350,-105,137637,137825,188
106,0,blank,0,-350,-105,137825,138018,193
106,0,blank,0,-350,-105,138018,138191,173
106,0,blank,0,-350,-105,138191,138347,156
106,0,blank,0,-350,-105,138347,138428,81
106,0,blank,0,-350,-105,138428,138642,214
106,0,blank,0,-350,-105,138642,138976,334
106,0,blank,0,-350,-105,138976,139154,178
106,0,blank,0,-350,-105,139154,139327,173
106,0,blank,0,-350,-105,139327,139503,176
106,0,blank,0,-350,-105,139503,139668,165
106,0,blank,0,-350,-105,139668,140181,513
106,0,blank,0,-350,-105,140181,140275,94
106,0,blank,0,-350,-105,140275,140438,163
106,0,blank,0,-350,-105,140438,140625,187
106,0,blank,0,-350,-105,140625,140888,263
106,0,blank,0,-350,-105,140888,141245,357
106,0,blank,0,-350,-105,141245,141396,151
106,0,blank,0,-350,-105,141396,141751,355
106,0,blank,0,-350,-105,141751,141880,129
106,0,blank,0,-350,-105,141880,142312,432
106,0,blank,0,-350,-105,142312,142495,183
106,0,blank,0,-350,-105,142495,142557,62
106,0,blank,0,-350,-105,142557,142723,166
106,0,blank,0,-350,-105,142723,142823,100
106,0,blank,0,-350,-105,142823,143004,181
106,0,blank,0,-350,-105,143004,143252,248
106,0,blank,0,-350,-105,143252,143565,313
106,0,blank,0,-350,-105,143565,143740,175
106,0,blank,0,-350,-105,143740,143922,182
106,0,blank,0,-350,-105,143922,144064,142
106,0,blank,0,-350,-105,144064,144222,158
106,0,blank,0,-350,-105,144222,144420,198
106,0,blank,0,-350,-105,144420,144657,237
106,0,blank,0,-350,-105,144657,144845,188
106,0,blank,0,-350,-105,144845,145008,163
106,0,blank,0,-350,-105,145008,145113,105
106,0,blank,0,-350,-105,145113,145504,391
106,0,blank,0,-350,-105,145504,145887,383
106,0,blank,0,-350,-105,145887,145996,109
106,0,blank,0,-350,-105,145996,146149,153
106,0,blank,0,-350,-105,146149,146333,184
106,0,blank,0,-350,-105,146333,146520,187
106,0,blank,0,-350,-105,146520,146607,87
106,30,displayList,190,46.6105,642.6986,146706,146876,170
106,0,blank,0,34.8472,662.6258,146876,146920,44
106,0,blank,0,170.538125,637.14865,146965,147144,179
106,30,displayList,190,96.756525,652.796875,147144,147324,180
106,30,displayList,190,88.2980166667,646.71975,147324,147511,187
106,31,return,197,76.10725,677.5227,147511,147635,124
106,0,blank,0,-350,-105,147667,147802,135
106,0,blank,0,165.7051666667,531.6348666667,147929,148110,181
106,24,list,161,174.0025333333,517.2485833333,148110,148300,190
106,0,blank,0,146.2776166667,489.42045,148300,148485,185
106,22,(,145,86.08845,484.5304,148485,148609,124
106,22,[,152,239.1209,470.915425,148640,148762,122
106,0,blank,0,-350,-105,148795,148958,163
106,0,blank,0,-350,-105,148958,149040,82
106,0,blank,0,106.4915,455.5374,149762,149787,25
106,0,blank,0,84.6112,456.7599,149787,149988,201
106,18,(,115,47.1711,389.0155,149988,150035,47
106,0,blank,0,-350,-105,150145,150327,182
106,0,blank,0,-350,-105,150327,150505,178
106,0,blank,0,-350,-105,150505,150566,61
106,0,blank,0,10.5321,378.2831,150598,150635,37
106,0,blank,0,36.9687333333,662.1790666667,150941,151131,190
106,30,displayList,190,48.9562333333,661.5189,151131,151299,168
106,0,blank,0,434.642,769.6873,151387,151570,183
106,0,blank,0,450.0548,755.2219,151570,151615,45
106,0,blank,0,-350,-105,151663,151851,188
106,0,blank,0,-350,-105,151851,152021,170
106,0,blank,0,-350,-105,152021,152154,133
106,0,blank,0,-350,-105,152154,152344,190
106,0,blank,0,-350,-105,152344,152523,179
106,0,blank,0,-350,-105,152523,152716,193
106,0,blank,0,-350,-105,152716,152835,119
106,0,blank,0,-350,-105,152835,152985,150
106,0,blank,0,-350,-105,152985,153139,154
106,0,blank,0,-350,-105,153139,153270,131
106,0,blank,0,-350,-105,153270,153407,137
106,0,blank,0,-350,-105,153407,153575,168
106,25,list,171,187.6537666667,536.0564,153652,153737,85
106,0,blank,0,120.0735333333,218.2935666667,153799,153983,184
106,6,Listis:,28,122.0263,114.5707833333,153983,154171,188
106,6,Listis:,28,171.19785,131.1714166667,154171,154359,188
106,7,ctr,41,170.9470333333,145.0106,154359,154548,189
106,7,ctr,41,79.1798,147.7342833333,154548,154736,188
106,7,=,34,104.6060666667,143.1606833333,154736,154923,187
106,0,blank,0,118.0184,138.4684,154923,154955,32
106,0,blank,0,-350,-105,154986,155099,113
106,0,blank,0,104.7401,110.5522,155163,155239,76
106,0,blank,0,56.3909166667,2.29845,155304,155479,175
106,1,Sort,4,108.9391333333,10.36775,155479,155665,186
106,0,blank,0,193.1295,28.3755166667,155665,155852,187
106,0,blank,0,226.1311,30.9519,155852,155940,88
106,2,h,10,173.2373,27.00375,155940,156132,192
106,3,displayList,13,59.7473,60.8607666667,156255,156361,106
106,0,blank,0,-350,-105,156422,156504,82
106,5,ctr,24,93.7208,96.7961,156532,156586,54
106,0,blank,0,102.5933,101.6585166667,156649,156825,176
106,6,Listis:,28,208.66995,121.2608666667,156856,157045,189
106,0,blank,0,222.0449666667,127.4576333333,157045,157139,94
106,0,blank,0,109.18655,-19.1217833333,157170,157357,187
106,0,blank,0,72.49805,-18.3461333333,157357,157543,186
106,0,blank,0,53.1141666667,-10.8413333333,157543,157727,184
106,0,blank,0,88.0037,-39.162,157727,157913,186
106,0,blank,0,97.27876,-52.16702,157913,158072,159
106,0,blank,0,460.2975,-44.06644,158104,158261,157
106,0,blank,0,662.0122333333,-4.1194333333,158292,158388,96
106,0,blank,0,-350,-105,158423,158478,55
106,0,blank,0,123.9697,-103.8806,158503,158529,26
106,1,Sort,4,100.3778,12.7831,158937,159134,197
106,5,ctr,24,66.359075,97.4702,159179,159353,174
106,0,blank,0,83.9516,78.8676666667,159353,159490,137
106,0,blank,0,-350,-105,159535,159731,196
106,0,blank,0,-350,-105,159731,159912,181
106,0,blank,0,-350,-105,159912,160095,183
106,0,blank,0,-350,-105,160095,160195,100
106,0,blank,0,-350,-105,160195,160427,232
106,0,blank,0,-350,-105,160427,160529,102
106,0,blank,0,-350,-105,160529,160797,268
106,0,blank,0,-350,-105,160797,161068,271
106,6,Listis:,28,146.7132666667,115.0618,161189,161273,84
106,0,blank,0,-350,-105,161333,161418,85
106,0,blank,0,116.1777333333,111.4270333333,161531,161704,173
106,5,ctr,24,73.27845,105.8302833333,161704,161890,186
106,0,blank,0,105.3771833333,112.8665833333,161951,162132,181
106,0,blank,0,123.8167333333,90.687,162132,162316,184
106,0,blank,0,159.70195,103.8358333333,162316,162501,185
106,0,blank,0,172.8520166667,100.21535,162501,162687,186
106,0,blank,0,178.2813,110.2044,162687,162718,31
106,0,blank,0,94.0688333333,76.5095666667,162781,162874,93
106,0,blank,0,-350,-105,162904,163035,131
106,0,blank,0,37.8604333333,75.0520666667,163202,163376,174
106,3,void,12,29.48898,59.87198,163376,163528,152
106,0,blank,0,238.3768833333,129.6648833333,163559,163731,172
106,0,blank,0,241.86375,94.7125,163731,163791,60
106,3,displayList,13,84.3151,63.0201,163820,163848,28
106,5,int,23,50.5438,109.0134,164019,164100,81
106,0,blank,0,256.596875,120.336625,164192,164372,180
106,0,blank,0,291.405375,115.01225,164372,164549,177
106,0,blank,0,122.68415,147.9986,164594,164683,89
106,0,blank,0,-350,-105,164727,164824,97
106,6,printf,26,76.9196,122.7266,164872,164932,60
106,7,(,32,58.3885,145.912,164998,165023,25
106,0,blank,0,211.12515,146.39435,165051,165240,189
106,7,ctr,41,173.6598833333,151.169,165240,165428,188
106,0,blank,0,206.3923333333,149.8323166667,165428,165615,187
106,7,size,39,225.4742333333,146.4561,165615,165709,94
106,8,printf,44,48.7069833333,169.8133333333,165740,165928,188
106,8,printf,44,63.4685166667,167.9199333333,165928,166118,190
106,8,printf,44,97.2945,165.9442,166118,166182,64
106,0,blank,0,-350,-105,166244,166427,183
106,0,blank,0,-350,-105,166427,166604,177
106,0,blank,0,-350,-105,166604,166732,128
106,0,blank,0,-350,-105,166732,166852,120
106,7,0,40,137.5448666667,149.8252166667,166869,167049,180
106,7,size,39,224.0419,146.2238166667,167049,167238,189
106,0,blank,0,185.8317333333,143.7349666667,167238,167428,190
106,7,ctr,41,175.657875,144.0388,167428,167554,126
106,9,printf,56,42.53685,181.06345,167586,167710,124
106,0,blank,0,-350,-105,167743,167851,108
106,9,printf,56,67.8402,180.0618,167879,167918,39
106,0,blank,0,34.4323166667,173.0261,167988,168168,180
106,8,printf,44,63.95385,173.8999666667,168168,168359,191
106,9,printf,56,77.9957,184.89735,168359,168421,62
106,24,list,161,166.6348833333,527.6587833333,168485,168672,187
106,0,blank,0,143.6962333333,532.8632,168672,168857,185
106,25,list,171,194.67735,535.1877,168857,169047,190
106,0,blank,0,153.0616333333,544.5575166667,169047,169237,190
106,26,list,178,105.7673166667,557.1014,169237,169424,187
106,26,+,181,153.7715333333,558.1170833333,169424,169611,187
106,0,blank,0,154.7132333333,551.4502,169611,169706,95
106,30,displayList,190,39.6204833333,661.4911,169737,169926,189
106,30,displayList,190,42.69808,650.2787,169926,170086,160
106,30,list,192,153.80935,648.35215,170117,170307,190
106,0,blank,0,87.4457,639.89845,170307,170498,191
106,31,return,197,25.01625,665.57285,170498,170623,125
106,0,blank,0,-350,-105,170654,170840,186
106,0,blank,0,-350,-105,170840,171034,194
106,0,blank,0,-350,-105,171034,171180,146
106,0,blank,0,-350,-105,171180,171364,184
106,0,blank,0,-350,-105,171364,171500,136
106,0,blank,0,-350,-105,171500,171667,167
106,0,blank,0,-350,-105,171667,171855,188
106,0,blank,0,-350,-105,171855,171991,136
106,0,blank,0,-350,-105,171991,172143,152
106,0,blank,0,-350,-105,172143,172328,185
106,0,blank,0,-350,-105,172328,172515,187
106,0,blank,0,-350,-105,172515,172660,145
106,0,blank,0,-350,-105,172660,172830,170
106,0,blank,0,-350,-105,172830,173018,188
106,0,blank,0,-350,-105,173018,173205,187
106,0,blank,0,-350,-105,173205,173331,126
106,0,blank,0,-350,-105,173331,173494,163
106,0,blank,0,-350,-105,173494,173540,46
106,0,blank,0,185.2819833333,662.81385,173558,173751,193
106,0,blank,0,163.13582,663.3539,173751,173906,155
106,0,blank,0,-350,-105,173968,174075,107
106,0,blank,0,94.7769,605.9868666667,174281,174460,179
106,0,blank,0,83.2310666667,635.9578333333,174460,174645,185
106,30,(,191,138.4151833333,644.8539333333,174645,174831,186
106,0,blank,0,88.7931166667,636.7183833333,174831,175017,186
106,30,displayList,190,91.47142,654.28282,175017,175199,182
106,0,blank,0,87.6017,638.4336,175199,175385,186
106,0,blank,0,41.2923666667,634.7481666667,175385,175477,92
106,0,blank,0,-350,-105,175508,175618,110
106,7,ctr,41,71.6977,135.8369,175662,175716,54
106,7,(,32,62.6079166667,147.1163666667,175785,175966,181
106,6,printf,26,60.064,118.80582,175966,176141,175
106,6,Listis:,28,147.047,125.9223666667,176141,176277,136
106,0,blank,0,122.461,151.0609,176277,176374,97
106,0,blank,0,187.1602,103.83215,176545,176702,157
106,0,blank,0,-350,-105,176759,176852,93
106,0,blank,0,222.0431666667,29.2701,176892,177011,119
106,30,list,192,169.514075,648.081025,177099,177275,176
106,0,blank,0,148.97674,673.74104,177275,177461,186
106,0,blank,0,196.2927,571.1188666667,177492,177677,185
106,26,j,180,138.9421,562.7712833333,177677,177862,185
106,0,blank,0,121.1147333333,530.7253,177862,177952,90
106,2,include,6,53.5313166667,39.17095,177982,178170,188
106,0,blank,0,205.969975,38.737425,178200,178323,123
106,0,blank,0,-350,-105,178353,178539,186
106,0,blank,0,-350,-105,178539,178688,149
106,0,blank,0,-350,-105,178688,178854,166
106,0,blank,0,-350,-105,178854,178890,36
106,7,size,39,214.2711,142.2345,179071,179288,217
106,7,size,39,236.5528,151.9444,179288,179397,109
106,0,blank,0,-350,-105,179442,179569,127
106,8,comma,47,175.920775,158.660775,179655,179814,159
106,0,blank,0,184.321675,155.35645,179814,179982,168
106,6,Listis:,28,185.0843,132.7578,179982,180118,136
106,0,blank,0,220.3495,94.0908,180118,180204,86
106,0,blank,0,156.2971,203.3616,180290,180320,30
106,7,0,40,257.9856666667,155.9077833333,180349,180531,182
106,7,size,39,231.5195666667,148.1491,180531,180717,186
106,0,blank,0,-350,-105,180746,180851,105
106,7,ctr,41,171.175,135.0187,180898,180956,58
106,0,blank,0,151.5601833333,143.60365,181033,181209,176
106,0,blank,0,149.1998,136.8611666667,181209,181391,182
106,6,Listis:,28,96.5581166667,120.8456666667,181391,181571,180
106,6,Listis:,28,97.6795666667,133.7652,181571,181751,180
106,0,blank,0,57.7614,110.4486,181751,181781,30
106,0,blank,0,-59.57295,115.67395,181846,181905,59
106,2,>,11,174.59,37.7170666667,181965,182055,90
106,0,blank,0,210.5699,27.5257,182087,182116,29
106,3,displayList,13,85.678225,48.85945,182182,182308,126
106,3,displayList,13,105.3507,64.71275,182342,182402,60
106,0,blank,0,176.2274,23.9176,182431,182463,32
106,30,list,192,167.48525,655.8712833333,182615,182800,185
106,0,blank,0,127.67126,662.11804,182800,182984,184
106,30,displayList,190,122.7254333333,657.0327833333,182984,183163,179
106,0,blank,0,167.71085,608.9474333333,183163,183346,183
106,0,blank,0,176.3482333333,552.1205166667,183346,183530,184
106,0,blank,0,201.2382666667,565.7117,183530,183621,91
106,3,displayList,13,161.4381333333,51.7171166667,183683,183868,185
106,0,blank,0,154.6613833333,20.26105,183868,184053,185
106,2,stdio,8,143.8494833333,34.1535833333,184053,184237,184
106,0,blank,0,131.10165,44.87135,184237,184423,186
106,2,include,6,83.8703,34.2977,184423,184518,95
106,0,blank,0,-350,-105,184550,184694,144
106,0,blank,0,188.1138166667,663.5365833333,184720,184896,176
106,30,list,192,170.3287,654.4485833333,184896,185081,185
106,30,list,192,159.67085,642.9094166667,185081,185266,185
106,30,list,192,164.64365,653.29815,185266,185387,121
106,14,list,91,205.7939666667,294.3318166667,185416,185598,182
106,0,blank,0,115.02975,285.8464,185598,185778,180
106,0,blank,0,142.30946,282.59462,185778,185928,150
106,0,blank,0,192.3665,106.3423333333,185957,186142,185
106,6,Listis:,28,164.88868,120.05568,186142,186325,183
106,7,0,35,126.5749333333,145.5981333333,186325,186512,187
106,0,blank,0,167.9919,184.3574,186512,186604,92
106,0,blank,0,-350,-105,186665,186768,103
106,0,blank,0,189.739,156.1206,186802,186849,47
106,8,*,48,196.4733,160.6208666667,186935,187113,178
106,7,ctr,41,170.5307,137.577,187113,187144,31
106,0,blank,0,-350,-105,187176,187362,186
106,0,blank,0,-350,-105,187362,187544,182
106,0,blank,0,-350,-105,187544,187672,128
106,8,comma,47,178.5474666667,175.1928666667,187859,188056,197
106,0,blank,0,178.73192,183.95156,188056,188225,169
106,7,ctr,41,78.579475,144.082925,188255,188377,122
106,0,blank,0,-350,-105,188406,188540,134
106,7,ctr,41,89.4326,142.1176,188579,188629,50
106,0,blank,0,89.05415,-19.9296333333,188693,188872,179
106,0,blank,0,12.6654,1.53755,188934,189124,190
106,2,include,6,59.81264,26.06382,189124,189278,154
106,0,blank,0,-350,-105,189311,189468,157
106,30,displayList,190,35.00375,657.0985333333,189496,189670,174
106,0,blank,0,4.6019,656.781825,189670,189796,126
106,0,blank,0,557.30805,748.934575,189857,189983,126
106,0,blank,0,686.7832,781.34522,190015,190171,156
106,0,blank,0,-350,-105,190235,190427,192
106,0,blank,0,-350,-105,190427,190560,133
106,0,blank,0,-350,-105,190560,190705,145
106,0,blank,0,-350,-105,190705,190838,133
106,0,blank,0,-350,-105,190838,191094,256
106,0,blank,0,-350,-105,191094,191279,185
106,0,blank,0,-350,-105,191279,191313,34
106,0,blank,0,-350,-105,191313,191497,184
106,0,blank,0,-350,-105,191497,191654,157
106,0,blank,0,585.30795,756.76705,191710,191842,132
106,0,blank,0,-350,-105,191906,192014,108
106,31,0,198,99.4478,665.1228,192063,192123,60
106,0,blank,0,89.40975,674.1619833333,192206,192390,184
106,0,blank,0,79.9684,683.933,192390,192422,32
106,3,displayList,13,94.2228,56.0983,192454,192486,32
