Frameno_fix,lineno_fix,Tokenname_fix,tokens_id,gaze_X_fix,gaze_Y_fix,timestamp_fix_start,timestamp_fix_end,time_duration
100,0,blank,0,65.3233333333333,-88.2599166666667,3041,3235,194
100,0,blank,0,66.81335,-85.51445,3235,3432,197
100,0,blank,0,89.6004666666666,-15.491,3432,3630,198
100,0,blank,0,71.00464,-9.88068,3630,3802,172
100,0,blank,0,80.3356333333333,0.403933333333332,3802,4000,198
100,0,blank,0,114.994333333333,-6.9219,4000,4196,196
100,0,blank,0,65.6767166666667,-5.15575,4196,4393,197
100,0,blank,0,17.2354666666667,-3.51648333333333,4393,4589,196
100,0,blank,0,34.58698,-4.3425,4589,4755,166
100,0,blank,0,59.1154,0.5351,4755,4926,171
100,0,blank,0,101.61678,-31.4429,4926,5109,183
100,0,blank,0,96.43214,-18.54348,5109,5282,173
100,0,blank,0,95.81438,2.95136,5282,5461,179
100,0,blank,0,-323,-105,5528,5561,33
100,1,Bubble,3,61.72735,12.4942333333333,5693,5883,190
100,1,Bubble,3,48.5492,5.85595,5883,5952,69
100,17,size,111,199.200566666667,372.850366666667,5985,6111,126
100,0,blank,0,80.9178,596.0428,6227,6335,108
100,0,blank,0,44.3188666666667,631.7067,6335,6526,191
100,0,blank,0,43.56005,640.319225,6526,6658,132
100,2,include,6,83.71546,41.20918,6725,6892,167
100,0,blank,0,57.1896,-16.06845,6892,7091,199
100,0,blank,0,91.69352,-24.11864,7091,7258,167
100,0,blank,0,121.64054,-29.91074,7258,7427,169
100,0,blank,0,76.97762,-17.28204,7427,7601,174
100,0,blank,0,33.9532,-19.32302,7601,7771,170
100,0,blank,0,-323,-105,7840,7898,58
100,0,blank,0,72.2065,-34.1724333333333,8018,8209,191
100,0,blank,0,91.73918,-25.40994,8209,8378,169
100,0,blank,0,136.842516666667,-29.3335,8378,8576,198
100,0,blank,0,102.9784,-33.0313,8576,8772,196
100,0,blank,0,43.1003,-16.1345833333333,8772,8971,199
100,0,blank,0,100.75316,-20.0912,8971,9137,166
100,0,blank,0,110.02084,-24.29,9137,9305,168
100,0,blank,0,115.88724,-45.97146,9305,9471,166
100,0,blank,0,50.57142,-57.66616,9471,9638,167
100,0,blank,0,42.59572,-28.11248,9638,9806,168
100,0,blank,0,61.77412,-21.92892,9806,9978,172
100,0,blank,0,83.9353,-16.80886,9978,10148,170
100,0,blank,0,150.268133333333,-2.91596666666666,10148,10246,98
100,0,blank,0,30.4650833333333,-22.6817333333333,10383,10579,196
100,0,blank,0,29.7224833333333,-13.49945,10579,10776,197
100,0,blank,0,31.8916666666667,-19.4550333333333,10776,10971,195
100,0,blank,0,50.73316,-26.04624,10971,11136,165
100,0,blank,0,-323,-105,11169,11305,136
100,0,blank,0,33.0710833333333,-59.7373666666667,11411,11600,189
100,0,blank,0,55.25456,-43.34454,11600,11776,176
100,0,blank,0,113.71405,-39.612425,11776,11910,134
100,0,blank,0,68.6772833333333,-38.8314666666667,12108,12302,194
100,0,blank,0,69.64266,-30.41378,12302,12472,170
100,0,blank,0,51.13444,-16.45516,12472,12658,186
100,0,blank,0,10.58126,-20.94188,12658,12831,173
100,0,blank,0,69.61308,-20.74248,12831,12999,168
100,0,blank,0,85.6754,-18.306,12999,13167,168
100,0,blank,0,57.7496,-16.74184,13167,13332,165
100,0,blank,0,28.2211,-14.4934,13332,13367,35
100,0,blank,0,-323,-105,13435,13617,182
100,0,blank,0,-323,-105,13617,13744,127
100,0,blank,0,72.1235666666667,-25.8331333333333,13780,13965,185
100,0,blank,0,80.56094,-11.46388,13965,14134,169
100,0,blank,0,84.41986,-5.4671,14134,14302,168
100,0,blank,0,88.11248,-0.577319999999997,14302,14469,167
100,0,blank,0,81.88598,-0.940380000000002,14469,14634,165
100,0,blank,0,55.36316,-8.2807,14634,14803,169
100,0,blank,0,54.4727333333333,-25.3948,14803,15002,199
100,0,blank,0,59.52256,-30.33634,15002,15171,169
100,0,blank,0,38.9678,-20.95844,15171,15344,173
100,0,blank,0,3.28840000000001,-15.36996,15344,15513,169
100,0,blank,0,26.92462,-10.56362,15513,15681,168
100,0,blank,0,6.58835999999999,-0.659300000000002,15681,15849,168
100,0,blank,0,2.25871999999999,0.578120000000001,15849,16017,168
100,0,blank,0,1.64616,-3.80264,16017,16188,171
100,1,Bubble,3,46.61964,5.22734,16188,16358,170
100,0,blank,0,107.1524,1.04638,16358,16527,169
100,0,blank,0,10.8551,25.9237,16527,16695,168
100,2,#,5,8.26232,26.85192,16695,16863,168
100,2,include,6,51.63476,41.47794,16863,17031,168
100,2,<,7,98.81376,38.50904,17031,17196,165
100,3,displayList,13,110.57622,51.59394,17196,17363,167
100,2,.,9,160.66575,34.7871333333333,17363,17562,199
100,2,.,9,158.13236,33.65644,17562,17729,167
100,0,blank,0,186.5719,35.29585,17729,17927,198
100,0,blank,0,194.45274,34.43354,17927,18096,169
100,0,blank,0,227.66276,40.55406,18096,18262,166
100,0,blank,0,238.85656,36.46004,18262,18429,167
100,0,blank,0,263.72666,33.86382,18429,18597,168
100,0,blank,0,268.1608,40.33445,18597,18664,67
100,0,blank,0,-323,-105,18729,18839,110
100,0,blank,0,261.1421,41.562,18865,18892,27
100,0,blank,0,258.370666666667,25.8279,18962,19049,87
100,3,void,12,27.6404,47.50462,19084,19255,171
100,4,{,22,8.58794000000001,70.35274,19255,19422,167
100,0,blank,0,48.40535,91.1556833333333,19422,19621,199
100,0,blank,0,48.5226166666667,85.1721833333333,19621,19817,196
100,0,blank,0,55.4681166666667,92.9517,19817,20013,196
100,0,blank,0,24.96815,82.1381333333333,20013,20210,197
100,0,blank,0,20.0387166666667,87.1427,20210,20405,195
100,0,blank,0,41.71495,85.9183166666667,20405,20602,197
100,0,blank,0,12.15694,118.48048,20602,20768,166
100,5,int,23,38.9519833333333,106.888683333333,20768,20966,198
100,0,blank,0,88.9716833333334,111.902016666667,20966,21163,197
100,6,(,27,87.35225,119.361233333333,21163,21359,196
100,0,blank,0,60.7679,105.904983333333,21359,21555,196
100,6,printf,26,25.8104166666667,114.881766666667,21555,21749,194
100,5,int,23,29.8821166666667,102.73045,21749,21945,196
100,5,int,23,37.4484,105.7269,21945,22141,196
100,5,int,23,44.2563333333333,96.7210833333333,22141,22338,197
100,0,blank,0,60.6749333333333,107.64645,22338,22532,194
100,6,printf,26,60.3351666666667,115.4452,22532,22724,192
100,5,ctr,24,88.8577166666667,107.339216666667,22724,22915,191
100,0,blank,0,113.1013,111.570716666667,22915,23106,191
100,0,blank,0,133.668166666667,109.083866666667,23106,23297,191
100,0,blank,0,143.4013,104.7127,23297,23488,191
100,0,blank,0,56.5765833333333,89.3444666666667,23488,23679,191
100,5,ctr,24,75.1356666666667,104.002983333333,23679,23872,193
100,0,blank,0,180.690833333333,106.83755,23872,24065,193
100,0,blank,0,172.3176,99.2804,24065,24099,34
100,6,printf,26,27.9289666666667,120.19295,24131,24326,195
100,0,blank,0,21.0876333333333,131.890533333333,24326,24520,194
100,7,(,32,58.7242333333333,136.4241,24520,24714,194
100,7,for,31,24.5443,142.9696,24714,24910,196
100,0,blank,0,19.1423166666667,142.9409,24910,25105,195
100,7,for,31,52.9219833333333,136.392083333333,25105,25299,194
100,7,ctr,41,64.25135,151.482066666667,25299,25493,194
100,7,=,34,103.767966666667,154.9454,25493,25687,194
100,7,0,35,125.201233333333,149.8959,25687,25880,193
100,7,ctr,41,162.382033333333,139.348933333333,25880,26073,193
100,7,ctr,41,182.86215,154.547,26073,26265,192
100,7,ctr,41,159.42368,147.71662,26265,26425,160
100,0,blank,0,270.68115,154.1785,26461,26635,174
100,0,blank,0,257.2063,130.2474,26635,26750,115
100,7,size,39,249.29585,145.8148,26750,26936,186
100,0,blank,0,259.8456,123.2058,26936,26969,33
100,7,for,31,47.6787833333333,155.9767,27000,27193,193
100,8,printf,44,72.0401833333333,172.389433333333,27193,27384,191
100,8,printf,44,92.4015666666667,161.45415,27384,27578,194
100,8,(,49,107.975316666667,168.913833333333,27578,27770,192
100,9,"\n",58,109.946916666667,182.20475,27770,27962,192
100,8,printf,44,92.74605,170.3903,27962,28153,191
100,0,blank,0,124.9809,178.955366666667,28153,28344,191
100,8,"%d\t",46,123.246266666667,176.233566666667,28344,28536,192
100,8,"%d\t",46,166.554,168.6482,28536,28728,192
100,8,"%d\t",46,161.5725,163.973766666667,28728,28921,193
100,7,ctr,41,159.1026,152.142983333333,28921,29114,193
100,8,"%d\t",46,160.4721,159.323516666667,29114,29309,195
100,7,ctr,41,183.94985,145.486816666667,29309,29504,195
100,8,"%d\t",46,140.4397,159.753416666667,29504,29699,195
100,7,0,35,129.4323,149.7693,29699,29731,32
100,0,blank,0,-323,-105,29797,29962,165
100,7,=,34,103.8419,149.594,29989,30016,27
100,7,(,32,61.70155,149.346733333333,30076,30267,191
100,7,for,31,47.73006,145.58698,30267,30434,167
100,8,"%d\t",46,163.213816666667,158.678333333333,30434,30629,195
100,0,blank,0,166.293775,156.1716,30629,30758,129
100,7,for,31,48.4737666666667,155.063866666667,30790,30985,195
100,7,(,32,57.5810333333333,155.31115,30985,31176,191
100,7,ctr,41,68.4157666666667,153.838516666667,31176,31372,196
100,7,for,31,50.8419333333333,155.819966666667,31372,31568,196
100,7,ctr,41,72.5395166666667,153.957733333333,31568,31766,198
100,7,ctr,41,70.0216333333333,147.184216666667,31766,31963,197
100,8,printf,44,67.0094666666667,157.3155,31963,32160,197
100,8,printf,44,103.868566666667,158.042983333333,32160,32356,196
100,8,printf,44,101.1257,163.292833333333,32356,32552,196
100,8,(,49,112.657933333333,169.22335,32552,32747,195
100,8,(,49,111.885183333333,166.347566666667,32747,32940,193
100,8,"%d\t",46,119.981283333333,162.4797,32940,33134,194
100,8,"%d\t",46,118.651166666667,162.78955,33134,33330,196
100,8,"%d\t",46,124.131166666667,158.508266666667,33330,33524,194
100,8,(,49,107.780766666667,161.588133333333,33524,33719,195
100,0,blank,0,118.152033333333,155.4637,33719,33915,196
100,8,(,49,112.315066666667,165.36755,33915,34112,197
100,8,printf,44,92.6386666666667,162.1484,34112,34306,194
100,8,printf,44,97.9162666666667,159.17685,34306,34500,194
100,8,"%d\t",46,116.268433333333,163.322933333333,34500,34695,195
100,8,"%d\t",46,116.484383333333,160.723166666667,34695,34891,196
100,7,;,40,134.743733333333,154.536116666667,34891,35085,194
100,8,"%d\t",46,155.1852,168.35185,35085,35279,194
100,8,"%d\t",46,148.514133333333,163.421316666667,35279,35471,192
100,8,..,47,174.17115,161.23285,35471,35664,193
100,0,blank,0,183.776,156.617033333333,35664,35856,192
100,0,blank,0,188.508033333333,160.041016666667,35856,36048,192
100,0,blank,0,187.566416666667,158.428316666667,36048,36242,194
100,0,blank,0,229.816266666667,160.432116666667,36242,36437,195
100,7,size,39,216.926366666667,154.059866666667,36437,36633,196
100,7,ctr,41,171.35752,140.1163,36633,36795,162
100,5,int,23,29.52255,98.8895166666667,36827,37022,195
100,0,blank,0,35.7518,75.0518833333333,37022,37217,195
100,2,include,6,51.79355,39.9025333333333,37217,37412,195
100,0,blank,0,50.0943,46.2599,37412,37476,64
100,2,>,11,177.212083333333,40.6206,37509,37703,194
100,0,blank,0,204.734883333333,30.623,37703,37896,193
100,2,>,11,179.924966666667,33.1326166666667,37896,38089,193
100,0,blank,0,190.4627,36.3340666666667,38089,38283,194
100,0,blank,0,185.51275,45.8998166666667,38283,38477,194
100,2,stdio,8,143.422933333333,41.7178833333333,38477,38672,195
100,0,blank,0,180.74625,46.6032166666667,38672,38866,194
100,3,int,19,184.58945,53.9925666666667,38866,39062,196
100,6,"Listis:",28,196.1009,122.882983333333,39062,39258,196
100,0,blank,0,190.612733333333,140.043933333333,39258,39455,197
100,0,blank,0,185.053566666667,154.020266666667,39455,39653,198
100,7,<,38,195.88735,143.97655,39653,39718,65
100,0,blank,0,196.091466666667,40.9234666666667,39750,39946,196
100,0,blank,0,184.101366666667,36.1795166666667,39946,40142,196
100,0,blank,0,186.1179,110.039033333333,40142,40336,194
100,7,ctr,41,183.0581,152.557683333333,40336,40532,196
100,8,"%d\t",46,170.622166666667,160.1775,40532,40728,196
100,0,blank,0,161.026083333333,156.8883,40728,40920,192
100,8,..,47,180.089116666667,160.266866666667,40920,41112,192
100,8,*,48,202.07152,164.20874,41112,41270,158
100,0,blank,0,-323,-105,41359,41537,178
100,8,(,49,208.79104,158.92552,41703,41877,174
100,8,*,48,197.714066666667,161.738783333333,41877,42069,192
100,8,*,48,201.1912,163.059233333333,42069,42256,187
100,8,a,50,220.353716666667,164.076833333333,42256,42441,185
100,8,a,50,220.0346,167.59285,42441,42627,186
100,0,blank,0,225.508366666667,163.378283333333,42627,42812,185
100,0,blank,0,229.26745,162.6562,42812,42997,185
100,0,blank,0,225.882733333333,160.874716666667,42997,43185,188
100,7,size,39,219.293783333333,152.60705,43185,43373,188
100,0,blank,0,184.041316666667,155.051633333333,43373,43561,188
100,7,<,38,195.829616666667,145.107866666667,43561,43752,191
100,0,blank,0,209.198933333333,142.978616666667,43752,43943,191
100,6,),29,220.7247,132.659625,43943,44070,127
100,5,int,23,36.5208333333333,108.732566666667,44101,44291,190
100,5,int,23,45.0661666666667,100.400616666667,44291,44482,191
100,6,(,27,86.6849833333333,116.623233333333,44482,44671,189
100,6,printf,26,44.1763833333333,125.0585,44671,44861,190
100,6,(,27,88.9632833333333,133.5057,44861,45052,191
100,6,"Listis:",28,142.386416666667,131.02995,45052,45243,191
100,0,blank,0,187.042883333333,138.292833333333,45243,45433,190
100,7,size,39,216.461983333333,144.5134,45433,45623,190
100,0,blank,0,224.023983333333,157.995483333333,45623,45813,190
100,0,blank,0,199.491783333333,102.477533333333,45813,46005,192
100,0,blank,0,146.59855,68.66565,46005,46196,191
100,0,blank,0,181.305316666667,44.7976333333333,46196,46387,191
100,0,blank,0,207.82145,43.0527,46387,46451,64
100,0,blank,0,36.4925166666667,78.7089,46483,46675,192
100,3,void,12,33.6834,65.72326,46675,46837,162
100,3,void,12,17.4814,54.1557,46837,46895,58
100,0,blank,0,57.5303,156.9218,47015,47122,107
100,0,blank,0,16.781325,219.892525,47122,47319,197
100,11,int,62,25.3089333333333,226.992683333333,47319,47511,192
100,0,blank,0,42.8774833333333,241.840166666667,47511,47702,191
100,0,blank,0,42.77574,233.064,47702,47893,191
100,8,printf,44,49.0930333333333,166.615816666667,47893,48077,184
100,8,printf,44,44.3610166666667,166.357516666667,48077,48267,190
100,0,blank,0,17.28105,137.485283333333,48267,48457,190
100,5,int,23,24.58835,96.2394333333333,48457,48645,188
100,5,int,23,51.6143666666667,92.3116833333333,48645,48834,189
100,4,{,22,4.63851666666667,88.21665,48834,49023,189
100,0,blank,0,-0.359800000000007,73.8158,49023,49211,188
100,3,void,12,12.7458833333333,61.6868166666667,49211,49401,190
100,0,blank,0,51.4598333333333,54.6416333333333,49401,49590,189
100,0,blank,0,17.2002833333333,85.1528,49590,49780,190
100,0,blank,0,18.4438666666667,73.3836833333333,49780,49969,189
100,3,void,12,24.46785,58.0895666666667,49969,50160,191
100,3,displayList,13,75.35635,59.5388666666667,50160,50351,191
100,5,ctr,24,88.5150333333333,92.13725,50351,50542,191
100,0,blank,0,17.1681166666667,179.5981,50542,50731,189
100,11,int,62,9.5731,230.816883333333,50731,50921,190
100,0,blank,0,17.5156333333333,195.206383333333,50921,51111,190
100,11,int,62,3.31323333333334,236.003583333333,51111,51302,191
100,0,blank,0,13.57375,256.2484,51302,51366,64
100,0,blank,0,15.5877,259.632983333333,51457,51643,186
100,0,blank,0,5.8073,290.286283333333,51643,51834,191
100,0,blank,0,3.45641666666667,283.97675,51834,52026,192
100,13,int,67,36.3875,282.97155,52026,52217,191
100,14,int,96,32.7487,289.68595,52217,52406,189
100,0,blank,0,-8.68667500000001,292.560775,52406,52602,196
100,0,blank,0,3.828625,299.6708,52602,52728,126
100,0,blank,0,46.4247333333333,281.8971,52728,52870,142
100,13,list,68,55.3719,285.589733333333,52870,53064,194
100,13,list,68,69.799,276.227983333333,53064,53246,182
100,0,blank,0,44.85695,282.451066666667,53246,53433,187
100,13,list,68,60.5161,278.126416666667,53433,53621,188
100,13,list,68,59.1279166666667,281.604866666667,53621,53807,186
100,13,list,68,87.08725,282.179683333333,53807,53992,185
100,0,blank,0,103.147,287.382366666667,53992,54177,185
100,0,blank,0,118.904933333333,291.455033333333,54177,54360,183
100,0,blank,0,172.99706,239.8079,54390,54586,196
100,0,blank,0,201.95585,248.62205,54586,54753,167
100,8,+,51,239.3169,162.9502,54753,54795,42
100,0,blank,0,207.93285,242.668175,54837,55011,174
100,8,ctr,52,271.8011,161.5931,55011,55053,42
100,13,11,77,234.82665,271.450575,55095,55272,177
100,0,blank,0,231.139833333333,286.630916666667,55272,55453,181
100,13,11,77,249.219366666667,284.1431,55453,55633,180
100,0,blank,0,265.963083333333,287.732733333333,55633,55814,181
100,13,..,82,260.7374,271.836833333333,55814,55905,91
100,15,int,99,37.5652,316.8513,55935,56115,180
100,0,blank,0,6.20353333333334,302.3427,56115,56296,181
100,14,size,87,65.66155,298.531016666667,56296,56480,184
100,14,sizeof,94,125.743833333333,295.0545,56480,56665,185
100,14,sizeof,94,149.22375,309.071316666667,56665,56850,185
100,14,(,95,189.491033333333,295.031433333333,56850,57036,186
100,14,/,93,259.59105,294.800033333333,57036,57222,186
100,0,blank,0,299.098083333333,284.0762,57222,57407,185
100,14,sizeof,94,273.4804,293.3215,57407,57596,189
100,14,sizeof,94,283.805116666667,297.262866666667,57596,57782,186
100,0,blank,0,302.722233333333,288.6626,57782,57970,188
100,0,blank,0,141.78024,271.42584,58000,58158,158
100,0,blank,0,5.28038333333333,313.762333333333,58189,58380,191
100,0,blank,0,-6.73733333333333,319.665466666667,58380,58570,190
100,0,blank,0,-8.04938,314.4022,58570,58730,160
100,0,blank,0,-323,-105,58794,58901,107
100,0,blank,0,1.70580000000001,342.3636,58927,58960,33
100,0,blank,0,-2.27303333333334,315.021183333333,59026,59203,177
100,0,blank,0,35.1078166666667,310.80545,59203,59399,196
100,15,int,99,21.1579,317.26015,59399,59588,189
100,0,blank,0,23.0908666666667,333.6533,59588,59773,185
100,0,blank,0,8.64875,353.303566666667,59773,59957,184
100,0,blank,0,5.84218000000001,342.21116,59957,60133,176
100,0,blank,0,12.9166666666667,346.99965,60133,60315,182
100,16,int,104,42.8013333333333,338.1541,60315,60498,183
100,15,int,99,31.9572833333333,323.937433333333,60498,60683,185
100,15,int,99,37.39055,315.9147,60683,60870,187
100,15,int,99,30.6281166666667,331.756116666667,60870,61056,186
100,0,blank,0,5.54856666666666,364.060916666667,61056,61246,190
100,17,displayList,107,24.5311666666667,368.82435,61246,61435,189
100,17,displayList,107,68.171,360.735683333333,61435,61622,187
100,17,displayList,107,113.503833333333,358.991566666667,61622,61811,189
100,17,displayList,107,120.2348,364.8994,61811,62000,189
100,17,list,109,171.5056,366.4814,62000,62189,189
100,17,list,109,168.282933333333,368.382866666667,62189,62284,95
100,0,blank,0,2.64464999999999,359.31785,62317,62507,190
100,0,blank,0,3.35253333333334,367.746866666667,62507,62696,189
100,0,blank,0,12.9240833333333,361.976516666667,62696,62887,191
100,17,displayList,107,44.6264666666667,374.897366666667,62887,63077,190
100,17,displayList,107,93.411,374.648116666667,63077,63268,191
100,0,blank,0,138.282883333333,378.08775,63268,63458,190
100,18,size,122,169.5894,377.8479,63458,63649,191
100,17,list,109,170.070583333333,366.509116666667,63649,63841,192
100,17,(,108,126.7711,368.535716666667,63841,64031,190
100,17,..,110,181.077633333333,366.96935,64031,64219,188
100,17,list,109,152.525533333333,365.1386,64219,64408,189
100,17,list,109,150.8509,366.55095,64408,64597,189
100,0,blank,0,185.438733333333,375.135283333333,64597,64786,189
100,18,size,122,196.029125,381.19715,64786,64912,126
100,0,blank,0,56.2346333333333,412.670533333333,64945,65132,187
100,0,blank,0,63.0933166666667,415.132883333333,65132,65323,191
100,0,blank,0,76.9833333333333,420.249316666667,65323,65513,190
100,0,blank,0,43.96905,403.0127,65513,65712,199
100,18,for,114,40.3485,378.74405,65712,65904,192
100,18,(,115,47.5854,379.985766666667,65904,66099,195
100,17,displayList,107,31.1922666666667,359.668616666667,66099,66291,192
100,17,displayList,107,24.9851,357.0603,66291,66489,198
100,0,blank,0,52.5268333333333,353.231133333333,66489,66683,194
100,17,displayList,107,62.6651666666667,363.108316666667,66683,66877,194
100,17,displayList,107,17.3202166666667,364.87415,66877,67070,193
100,17,displayList,107,26.08612,375.41998,67070,67242,172
100,0,blank,0,-45.2869,367.3675,67242,67425,183
100,18,for,114,37.77455,381.6043,67425,67615,190
100,17,displayList,107,77.3879333333333,373.565383333333,67615,67810,195
100,17,displayList,107,114.972933333333,363.109966666667,67810,68006,196
100,17,list,109,161.995283333333,372.760816666667,68006,68197,191
100,0,blank,0,162.69115,351.8395,68197,68391,194
100,0,blank,0,117.008133333333,301.63045,68391,68582,191
100,14,sizeof,94,134.88985,292.4142,68582,68772,190
100,14,=,88,110.773116666667,299.955266666667,68772,68963,191
100,14,sizeof,94,136.862883333333,299.220833333333,68963,69154,191
100,14,sizeof,94,143.109283333333,299.487716666667,69154,69344,190
100,13,],70,111.52785,280.572683333333,69344,69534,190
100,7,ctr,41,76.3175666666667,155.521866666667,69534,69724,190
100,7,for,31,53.3073333333333,135.64275,69724,69914,190
100,0,blank,0,12.6016833333333,115.155883333333,69914,70100,186
100,0,blank,0,13.1444333333333,112.330866666667,70100,70285,185
100,0,blank,0,20.4277833333333,75.9433666666667,70285,70470,185
100,3,displayList,13,57.6892333333333,60.7128,70470,70656,186
100,3,displayList,13,89.4905833333333,51.3331333333333,70656,70840,184
100,0,blank,0,135.74685,46.1147666666667,70840,71027,187
100,0,blank,0,186.998016666667,44.8650333333333,71027,71215,188
100,0,blank,0,166.394483333333,42.7715,71215,71402,187
100,2,>,11,175.33155,29.6436,71402,71593,191
100,2,h,10,173.3225,40.86745,71593,71782,189
100,0,blank,0,150.9452,42.21525,71782,71972,190
100,2,.,9,160.88875,27.9566833333333,71972,72163,191
100,0,blank,0,187.03035,24.7896666666667,72163,72356,193
100,0,blank,0,222.45315,39.7193666666667,72356,72549,193
100,0,blank,0,241.651133333333,36.1799166666667,72549,72742,193
100,0,blank,0,258.408833333333,33.6934666666667,72742,72935,193
100,0,blank,0,33.4587,84.5059166666667,72968,73160,192
100,0,blank,0,22.0482666666667,90.0160333333333,73160,73352,192
100,0,blank,0,22.8271,102.315316666667,73352,73543,191
100,0,blank,0,5.32823333333333,95.814,73543,73734,191
100,0,blank,0,27.9270833333333,89.7824,73734,73925,191
100,0,blank,0,30.4513,111.1914,73925,74116,191
100,0,blank,0,7.8076,113.6482,74116,74307,191
100,0,blank,0,7.75235000000001,114.27455,74307,74370,63
100,3,int,19,187.7511,63.2573166666667,74402,74593,191
100,0,blank,0,168.205866666667,43.0142333333333,74593,74787,194
100,2,h,10,166.3133,40.7581,74787,74821,34
100,0,blank,0,31.74775,87.90045,74853,75048,195
100,0,blank,0,20.61155,95.8814166666667,75048,75244,196
100,0,blank,0,58.84955,91.7757166666667,75244,75439,195
100,3,displayList,13,136.92315,60.7851833333333,75439,75634,195
100,3,int,19,173.46858,58.34928,75634,75801,167
100,0,blank,0,-4.49988333333333,102.726416666667,75834,76030,196
100,0,blank,0,6.52668333333333,105.370983333333,76030,76228,198
100,0,blank,0,4.51571666666666,112.4051,76228,76425,197
100,6,printf,26,37.4232833333333,114.5667,76425,76620,195
100,0,blank,0,72.0972,111.4973,76620,76651,31
100,0,blank,0,119.976183333333,112.771216666667,76812,77005,193
100,6,"Listis:",28,129.12035,126.23115,77005,77070,65
100,0,blank,0,14.9179,154.798516666667,77102,77296,194
100,0,blank,0,13.4574833333333,157.2189,77296,77484,188
100,7,ctr,41,73.32995,148.4905,77484,77673,189
100,7,=,34,106.231583333333,141.477116666667,77673,77863,190
100,0,blank,0,208.429416666667,146.280883333333,77863,78054,191
100,0,blank,0,209.285816666667,140.369316666667,78054,78243,189
100,7,ctr,41,273.2112,153.118566666667,78243,78434,191
100,8,ctr,52,259.31255,157.039633333333,78434,78625,191
100,7,ctr,41,173.871075,152.62435,78625,78752,127
100,0,blank,0,25.2353333333333,173.697816666667,78783,78974,191
100,8,printf,44,78.0349833333333,165.019816666667,78974,79166,192
100,8,printf,44,92.9067,170.948866666667,79166,79357,191
100,8,(,49,112.103516666667,170.850366666667,79357,79546,189
100,8,"%d\t",46,152.142733333333,172.608116666667,79546,79737,191
100,0,blank,0,186.867133333333,169.12725,79737,79927,190
100,8,"%d\t",46,172.643566666667,166.81825,79927,80118,191
100,8,"%d\t",46,149.63556,174.3828,80118,80276,158
100,0,blank,0,-323,-105,80341,80471,130
100,3,(,14,172.23624,52.21432,80614,80790,176
100,3,int,19,175.78305,62.2930833333333,80790,80983,193
100,7,ctr,41,168.834016666667,139.2128,80983,81172,189
100,8,..,47,181.759616666667,161.20245,81172,81362,190
100,0,blank,0,203.500966666667,156.850533333333,81362,81552,190
100,0,blank,0,207.57615,153.894833333333,81552,81749,197
100,0,blank,0,191.84995,157.05855,81749,81946,197
100,7,size,39,249.2284,145.258616666667,81946,82142,196
100,0,blank,0,259.775416666667,88.5155,82142,82338,196
100,7,ctr,41,171.884716666667,153.584916666667,82338,82536,198
100,7,ctr,41,170.5193,154.519133333333,82536,82735,199
100,7,ctr,41,168.0284,147.8555,82735,82801,66
100,0,blank,0,187.979016666667,46.6089666666667,82833,83031,198
100,0,blank,0,164.658966666667,184.534716666667,83031,83229,198
100,8,(,49,110.9766,157.22924,83229,83396,167
100,8,printf,44,64.63136,166.0509,83396,83566,170
100,0,blank,0,21.63058,175.17544,83566,83734,168
100,8,printf,44,46.12035,158.468566666667,83734,83930,196
100,8,(,49,107.262416666667,158.67975,83930,84125,195
100,8,printf,44,80.6237166666667,161.448383333333,84125,84322,197
100,0,blank,0,29.6123166666667,169.3839,84322,84520,198
100,8,printf,44,43.1147833333333,171.061016666667,84520,84718,198
100,8,printf,44,44.3576166666667,161.724266666667,84718,84917,199
100,0,blank,0,40.00898,165.64526,84917,85084,167
100,8,printf,44,59.3381166666667,161.903066666667,85084,85282,198
100,8,printf,44,78.4473333333333,170.745316666667,85282,85481,199
100,0,blank,0,40.20636,169.44898,85481,85648,167
100,0,blank,0,33.29025,176.747983333333,85648,85844,196
100,0,blank,0,37.4505,212.8594,85844,85876,32
100,0,blank,0,-323,-105,85910,86050,140
100,8,printf,44,45.8946833333333,169.510433333333,86141,86326,185
100,9,printf,56,57.7655333333333,181.597016666667,86326,86523,197
100,9,printf,56,68.4827166666667,199.58215,86523,86714,191
100,9,printf,56,81.83185,190.381916666667,86714,86903,189
100,0,blank,0,80.7754666666667,217.4157,86903,87090,187
100,11,main,63,73.27305,228.06525,87090,87279,189
100,9,(,57,86.4663666666667,186.113283333333,87279,87469,190
100,9,printf,56,58.55976,188.05976,87469,87658,189
100,8,printf,44,87.5299,161.9016,87658,87780,122
100,8,printf,44,88.834,170.4056,87780,87896,116
100,8,"%d\t",46,116.013675,172.407675,87896,88081,185
100,8,"%d\t",46,117.957216666667,170.719633333333,88081,88271,190
100,7,ctr,41,81.4665166666667,155.993116666667,88271,88462,191
100,0,blank,0,16.5736,133.154116666667,88462,88652,190
100,6,printf,26,54.86155,113.147983333333,88652,88842,190
100,6,"Listis:",28,101.5537,116.327916666667,88842,89031,189
100,7,=,34,111.920433333333,139.847483333333,89031,89219,188
100,7,;,40,135.9813,138.22555,89219,89408,189
100,7,ctr,41,166.720016666667,145.34785,89408,89597,189
100,7,;,40,138.67395,143.469333333333,89597,89786,189
100,7,ctr,41,171.117766666667,145.6801,89786,89976,190
100,0,blank,0,206.99465,149.209116666667,89976,90167,191
100,6,"Listis:",28,206.28055,113.757533333333,90167,90357,190
100,0,blank,0,179.782166666667,68.09705,90357,90548,191
100,6,"Listis:",28,176.128716666667,126.697783333333,90548,90739,191
100,0,blank,0,-323,-105,90803,90977,174
100,7,ctr,41,174.23755,147.083516666667,91003,91180,177
100,7,ctr,41,179.585216666667,145.3006,91180,91375,195
100,7,ctr,41,165.18955,155.10545,91375,91565,190
100,8,"%d\t",46,141.41135,173.175833333333,91565,91752,187
100,8,"%d\t",46,171.474866666667,170.878233333333,91752,91940,188
100,8,"%d\t",46,145.500283333333,161.849766666667,91940,92127,187
100,8,"%d\t",46,152.00115,165.120766666667,92127,92316,189
100,8,..,47,178.298833333333,158.231583333333,92316,92503,187
100,0,blank,0,194.6872,156.9231,92503,92692,189
100,0,blank,0,223.056133333333,134.2028,92692,92879,187
100,3,..,18,241.882283333333,56.2689333333333,92879,93069,190
100,0,blank,0,208.006616666667,109.901316666667,93069,93258,189
100,6,"Listis:",28,202.878566666667,130.87255,93258,93449,191
100,0,blank,0,204.102883333333,151.73455,93449,93639,190
100,7,ctr,41,181.058116666667,155.022566666667,93639,93830,191
100,0,blank,0,158.71448,156.39672,93830,93990,160
100,0,blank,0,178.89675,75.6071666666667,94022,94216,194
100,7,ctr,41,164.96085,152.77235,94216,94410,194
100,0,blank,0,192.651483333333,154.325366666667,94410,94604,194
100,8,"%d\t",46,136.936783333333,162.740233333333,94604,94797,193
100,8,"%d\t",46,164.412233333333,161.758166666667,94797,94990,193
100,8,"%d\t",46,153.443016666667,162.483333333333,94990,95182,192
100,8,"%d\t",46,142.616633333333,170.163716666667,95182,95374,192
100,7,ctr,41,164.256966666667,151.305216666667,95374,95566,192
100,8,"%d\t",46,154.418766666667,161.80005,95566,95755,189
100,0,blank,0,143.447416666667,152.1654,95755,95946,191
100,7,;,40,134.696916666667,153.8105,95946,96137,191
100,7,=,34,104.073316666667,155.310216666667,96137,96330,193
100,7,;,40,134.9573,153.762466666667,96330,96522,192
100,8,"%d\t",46,164.8775,159.950666666667,96522,96714,192
100,8,"%d\t",46,161.507983333333,159.087583333333,96714,96905,191
100,8,"%d\t",46,158.124683333333,163.1563,96905,97095,190
100,8,..,47,174.114583333333,158.920166666667,97095,97285,190
100,0,blank,0,161.265633333333,95.1073666666666,97285,97478,193
100,6,"Listis:",28,134.783933333333,129.960966666667,97478,97673,195
100,7,0,35,130.39325,147.124633333333,97673,97865,192
100,7,;,40,139.33765,146.745983333333,97865,98061,196
100,0,blank,0,144.222483333333,155.9306,98061,98256,195
100,8,"%d\t",46,116.521583333333,162.93635,98256,98452,196
100,8,printf,44,78.6362666666667,165.774433333333,98452,98647,195
100,7,for,31,28.1799666666667,148.166633333333,98647,98841,194
100,7,ctr,41,80.7516166666667,150.990366666667,98841,99037,196
100,7,=,34,104.230016666667,144.7798,99037,99232,195
100,7,=,34,113.0638,153.54175,99232,99423,191
100,7,=,34,105.907166666667,151.1133,99423,99612,189
100,8,"%d\t",46,120.2979,157.88275,99612,99801,189
100,0,blank,0,113.3976,164.6628,99801,99992,191
100,8,printf,44,103.159416666667,164.4654,99992,100181,189
100,8,printf,44,94.6629666666667,164.841016666667,100181,100369,188
100,8,printf,44,98.1259333333333,160.562283333333,100369,100558,189
100,8,printf,44,91.62025,157.827116666667,100558,100748,190
100,0,blank,0,103.69115,156.099316666667,100748,100935,187
100,0,blank,0,117.8229,154.932566666667,100935,101124,189
100,0,blank,0,122.426883333333,148.098633333333,101124,101315,191
100,8,"%d\t",46,117.799016666667,164.804716666667,101315,101503,188
100,8,(,49,109.991716666667,160.68285,101503,101692,189
100,8,(,49,112.62085,171.268616666667,101692,101881,189
100,8,"%d\t",46,123.028766666667,170.784866666667,101881,102069,188
100,8,"%d\t",46,128.3875,163.6882,102069,102260,191
100,7,0,35,133.175566666667,152.88915,102260,102453,193
100,0,blank,0,129.451116666667,156.353416666667,102453,102644,191
100,0,blank,0,121.921316666667,154.928133333333,102644,102835,191
100,0,blank,0,118.127083333333,149.4388,102835,103025,190
100,0,blank,0,117.627183333333,154.0353,103025,103216,191
100,8,"%d\t",46,118.170766666667,159.872216666667,103216,103411,195
100,0,blank,0,114.2925,154.344916666667,103411,103605,194
100,8,(,49,106.20605,168.22255,103605,103733,128
100,8,printf,44,99.38775,157.31845,103902,104088,186
100,7,ctr,41,89.42925,146.984316666667,104088,104283,195
100,8,printf,44,96.5366333333333,159.376566666667,104283,104475,192
100,7,=,34,105.792316666667,154.593483333333,104475,104664,189
100,8,(,49,106.93995,162.6886,104664,104852,188
100,8,"%d\t",46,114.870883333333,157.211183333333,104852,105039,187
100,8,"%d\t",46,120.903033333333,164.706883333333,105039,105230,191
100,8,"%d\t",46,126.1689,161.163033333333,105230,105420,190
100,7,0,35,128.238383333333,151.741716666667,105420,105611,191
100,0,blank,0,104.565716666667,162.466633333333,105611,105803,192
100,7,=,34,108.763316666667,154.04165,105803,105996,193
100,7,=,34,109.22065,147.1558,105996,106192,196
100,8,printf,44,83.449,160.030016666667,106192,106388,196
100,8,printf,44,72.0682666666667,162.044233333333,106388,106581,193
100,7,ctr,41,83.3208333333333,145.64695,106581,106774,193
100,0,blank,0,96.84725,147.761666666667,106774,106968,194
100,7,=,34,106.487383333333,146.025816666667,106968,107163,195
100,0,blank,0,99.8131,151.009383333333,107163,107357,194
100,7,ctr,41,88.982,146.736483333333,107357,107551,194
100,7,ctr,41,89.0972166666667,149.596166666667,107551,107746,195
100,7,=,34,104.7042,144.802583333333,107746,107941,195
100,7,ctr,41,82.4988,140.5173,107941,108036,95
100,6,printf,26,76.9444,126.4584,108036,108158,122
100,8,printf,44,96.8182,157.6502,108158,108278,120
100,7,ctr,41,92.37195,141.978025,108278,108466,188
100,0,blank,0,98.4573333333333,142.915133333333,108466,108659,193
100,0,blank,0,114.37385,147.589483333333,108659,108854,195
100,7,=,34,105.982716666667,145.871533333333,108854,109051,197
100,7,0,35,127.56915,145.832033333333,109051,109249,198
100,7,;,40,136.814283333333,154.407733333333,109249,109446,197
100,8,"%d\t",46,169.72815,157.00795,109446,109640,194
100,7,ctr,41,165.492533333333,154.226966666667,109640,109735,95
100,8,(,49,106.755133333333,160.0085,109905,110081,176
100,0,blank,0,116.584916666667,155.730166666667,110081,110271,190
100,9,(,57,85.6151166666667,180.399016666667,110271,110464,193
100,7,=,34,109.796616666667,155.98085,110464,110655,191
100,8,(,49,105.556566666667,166.85635,110655,110845,190
100,8,"%d\t",46,117.5284,163.660483333333,110845,111036,191
100,8,"%d\t",46,114.12175,164.1836,111036,111227,191
100,8,printf,44,96.9936333333333,166.1024,111227,111420,193
100,9,printf,56,76.3158833333333,195.131216666667,111420,111618,198
100,14,size,87,79.4417833333333,298.810933333333,111618,111815,197
100,14,sizeof,94,128.745233333333,305.076983333333,111815,112010,195
100,14,=,88,112.784533333333,294.53735,112010,112203,193
100,13,20,75,193.946516666667,286.17175,112203,112393,190
100,8,printf,44,97.4797166666667,173.053816666667,112393,112584,191
100,8,printf,44,96.3114333333333,158.649366666667,112584,112775,191
100,8,"%d\t",46,119.338633333333,158.445783333333,112775,112966,191
100,8,"%d\t",46,115.626283333333,163.511766666667,112966,113156,190
100,8,"%d\t",46,124.352466666667,157.914516666667,113156,113346,190
100,8,(,49,105.736016666667,160.69295,113346,113537,191
100,0,blank,0,107.249166666667,156.947816666667,113537,113728,191
100,0,blank,0,119.191583333333,147.6734,113728,113922,194
100,7,=,34,108.7652,154.48092,113922,114084,162
100,0,blank,0,-321.874866666667,329.815433333333,114184,114282,98
100,18,<,121,144.938583333333,385.696716666667,114347,114542,195
100,18,i,124,133.4012,380.0578,114542,114575,33
100,17,displayList,107,99.7294,368.9244,114575,114955,380
100,18,i,124,127.09475,378.00445,114955,115146,191
100,18,;,123,107.8957,382.8238,115146,115410,264
100,0,blank,0,120.37685,380.170266666667,115410,115581,171
100,0,blank,0,113.726733333333,401.147866666667,115581,115767,186
100,18,0,118,97.3745166666667,396.636516666667,115767,115957,190
100,0,blank,0,167.168166666667,403.9195,115957,116146,189
100,17,list,109,145.217716666667,372.049566666667,116146,116334,188
100,18,;,123,111.62385,380.555383333333,116334,116522,188
100,18,0,118,95.9950333333333,392.96615,116522,116711,189
100,0,blank,0,134.756533333333,392.9127,116711,116901,190
100,18,<,121,145.868666666667,389.261033333333,116901,117092,191
100,0,blank,0,128.7189,401.6262,117092,117282,190
100,18,;,123,111.339766666667,395.7484,117282,117379,97
100,0,blank,0,-323,-105,117410,117568,158
100,0,blank,0,152.2656,408.1068,117594,117620,26
100,0,blank,0,162.850283333333,390.08295,117673,117851,178
100,0,blank,0,182.929616666667,398.2296,117851,118045,194
100,0,blank,0,211.428366666667,407.618266666667,118045,118234,189
100,0,blank,0,221.272166666667,401.2414,118234,118422,188
100,18,++,125,254.505,394.617433333333,118422,118611,189
100,0,blank,0,270.5861,395.29774,118611,118768,157
100,0,blank,0,119.674983333333,455.194683333333,118800,118992,192
100,0,blank,0,148.3618,454.282733333333,118992,119184,192
100,0,blank,0,121.091716666667,420.970416666667,119184,119376,192
100,20,;,139,148.72615,424.54725,119376,119571,195
100,0,blank,0,192.461233333333,445.974516666667,119571,119764,193
100,0,blank,0,200.32895,437.56145,119764,119958,194
100,0,blank,0,247.4279,448.740483333333,119958,120151,193
100,0,blank,0,275.052833333333,445.1744,120151,120344,193
100,0,blank,0,304.722333333333,445.641283333333,120344,120537,193
100,0,blank,0,306.351866666667,447.344933333333,120537,120731,194
100,18,++,125,253.544,388.851416666667,120731,120922,191
100,0,blank,0,236.992083333333,413.265333333333,120922,121115,193
100,0,blank,0,235.184433333333,420.439966666667,121115,121310,195
100,20,j,140,312.068466666667,436.087533333333,121310,121507,197
100,20,++,141,324.367133333333,437.218633333333,121507,121704,197
100,0,blank,0,353.97018,449.7564,121704,121868,164
100,22,j,153,147.2923,481.993866666667,121935,122129,194
100,0,blank,0,136.979416666667,486.07205,122129,122319,190
100,22,j,153,149.801333333333,483.2738,122319,122513,194
100,0,blank,0,186.0646,480.017266666667,122513,122709,196
100,22,>,150,183.997883333333,481.728883333333,122709,122903,194
100,22,list,151,223.896133333333,481.961366666667,122903,123097,194
100,0,blank,0,256.335333333333,486.575933333333,123097,123292,195
100,22,+,154,269.921016666667,484.665866666667,123292,123489,197
100,0,blank,0,253.9822,489.126616666667,123489,123686,197
100,0,blank,0,237.626516666667,492.383633333333,123686,123882,196
100,22,list,151,222.667,469.9556,123882,123915,33
100,0,blank,0,-323,-105,123981,124064,83
100,0,blank,0,258.7311,-103.9305,124090,124116,26
100,0,blank,0,278.807133333333,490.37425,124169,124349,180
100,0,blank,0,298.78175,487.776066666667,124349,124545,196
100,0,blank,0,315.10834,492.7194,124545,124705,160
100,0,blank,0,176.860383333333,487.226966666667,124739,124930,191
100,24,list,161,157.895366666667,514.0798,124930,125122,192
100,25,],176,148.062266666667,544.348116666667,125122,125316,194
100,0,blank,0,137.29835,530.56405,125316,125511,195
100,0,blank,0,115.6364,452.673,125511,125578,67
100,25,list,171,193.2911,533.01585,125611,125806,195
100,25,list,171,223.593516666667,535.734783333333,125806,126001,195
100,25,j,173,242.118783333333,532.3619,126001,126200,199
100,0,blank,0,235.51016,531.55446,126200,126367,167
100,25,list,171,188.92988,550.48202,126367,126535,168
100,26,+,181,157.117766666667,558.233216666667,126535,126733,198
100,0,blank,0,160.221016666667,543.202116666667,126733,126932,199
100,25,list,171,208.864066666667,544.982216666667,126932,127129,197
100,25,list,171,216.455083333333,547.90455,127129,127327,198
100,0,blank,0,168.716566666667,557.481233333333,127327,127523,196
100,0,blank,0,171.4752,567.988383333333,127523,127722,199
100,26,=,184,211.312,554.766533333333,127722,127918,196
100,26,temp,185,245.984283333333,558.102916666667,127918,128115,197
100,26,;,186,266.0294,560.00685,128115,128312,197
100,0,blank,0,297.96175,560.60975,128312,128403,91
100,0,blank,0,180.6209,586.2411,128517,128637,120
100,0,blank,0,161.69295,602.753725,128637,128833,196
100,0,blank,0,222.640116666667,598.246116666667,128833,129029,196
100,0,blank,0,247.670516666667,588.283733333333,129029,129225,196
100,26,temp,185,242.607866666667,562.886166666667,129225,129421,196
100,0,blank,0,182.198366666667,543.408216666667,129421,129618,197
100,0,blank,0,138.288666666667,621.5832,129618,129815,197
100,0,blank,0,122.707266666667,634.59095,129815,130013,198
100,0,blank,0,107.00464,635.30172,130013,130179,166
100,0,blank,0,115.747075,605.7185,130179,130311,132
100,22,list,151,103.4719,480.86465,130345,130544,199
100,22,j,153,144.842883333333,482.614316666667,130544,130738,194
100,20,0,132,133.165683333333,436.632316666667,130738,130931,193
100,0,blank,0,182.073433333333,436.401866666667,130931,131124,193
100,20,-,137,255.5138,439.099133333333,131124,131316,192
100,0,blank,0,276.2781,413.8447,131316,131348,32
100,0,blank,0,-323,-105,131412,131581,169
100,0,blank,0,250.61165,417.7463,131607,131783,176
100,20,-,137,257.656225,424.836575,131783,131911,128
100,20,j,140,163.944,440.595633333333,131944,132134,190
100,0,blank,0,202.067316666667,443.69,132134,132325,191
100,0,blank,0,203.720075,463.204975,132325,132454,129
100,0,blank,0,150.096,617.09185,132486,132681,195
100,30,displayList,190,110.7865,654.192083333333,132681,132875,194
100,0,blank,0,91.0808666666667,673.7405,132875,133071,196
100,0,blank,0,121.869666666667,684.936666666667,133071,133268,197
100,0,blank,0,149.15285,693.927416666667,133268,133464,196
100,0,blank,0,156.89955,680.9091,133464,133529,65
100,0,blank,0,149.9067,564.68075,133563,133759,196
100,0,blank,0,155.494016666667,506.255033333333,133759,133950,191
100,0,blank,0,180.874683333333,500.368283333333,133950,134148,198
100,0,blank,0,168.553583333333,465.792183333333,134148,134340,192
100,0,blank,0,231.638683333333,446.193683333333,134340,134539,199
100,0,blank,0,226.3887,447.72972,134539,134706,167
100,22,list,151,198.486425,470.455975,134706,134839,133
100,0,blank,0,-323,-105,134871,135059,188
100,0,blank,0,-323,-105,135059,135178,119
100,0,blank,0,152.425966666667,448.552466666667,135211,135397,186
100,0,blank,0,173.78105,429.7244,135397,135586,189
100,0,blank,0,161.84995,424.2752,135586,135774,188
100,22,list,151,206.576216666667,472.779966666667,135774,135961,187
100,22,>,150,183.158,468.36565,135961,136153,192
100,0,blank,0,162.762616666667,438.610066666667,136153,136347,194
100,20,;,139,148.173483333333,422.44625,136347,136546,199
100,20,<,135,187.0635,431.30542,136546,136709,163
100,0,blank,0,-323,-105,136776,136917,141
100,20,size,136,240.9482,429.720566666667,137092,137278,186
100,0,blank,0,263.6137,441.350916666667,137278,137474,196
100,0,blank,0,244.8036,430.748083333333,137474,137665,191
100,0,blank,0,180.481316666667,436.055783333333,137665,137853,188
100,0,blank,0,186.55895,442.589433333333,137853,138048,195
100,0,blank,0,198.497933333333,459.22265,138048,138246,198
100,20,size,136,216.738516666667,430.730733333333,138246,138437,191
100,0,blank,0,250.507,424.5284,138437,138630,193
100,20,size,136,221.176383333333,425.3037,138630,138823,193
100,20,<,135,187.08165,436.351133333333,138823,139015,192
100,0,blank,0,178.27154,488.24336,139015,139181,166
100,0,blank,0,192.281966666667,478.762666666667,139181,139378,197
100,22,list,151,218.727533333333,476.516416666667,139378,139572,194
100,0,blank,0,254.002766666667,482.2203,139572,139766,194
100,22,1,155,289.64445,485.043666666667,139766,139960,194
100,22,1,155,283.3926,477.98695,139960,140155,195
100,0,blank,0,283.487,443.48575,140155,140351,196
100,0,blank,0,249.348066666667,443.9802,140351,140547,196
100,0,blank,0,274.916483333333,462.645716666667,140547,140743,196
100,22,list,151,197.13725,472.362366666667,140743,140936,193
100,0,blank,0,176.17524,453.6632,140936,141100,164
100,22,list,151,205.70684,482.14746,141100,141270,170
100,0,blank,0,282.119383333333,476.970533333333,141270,141467,197
100,0,blank,0,280.234783333333,460.818333333333,141467,141663,196
100,0,blank,0,192.70355,505.287066666667,141663,141859,196
100,0,blank,0,128.94685,416.75725,141859,141923,64
100,0,blank,0,218.71135,505.276483333333,141956,142155,199
100,0,blank,0,164.756866666667,505.052516666667,142155,142353,198
100,0,blank,0,192.155266666667,475.126633333333,142353,142551,198
100,0,blank,0,195.7805,445.324933333333,142551,142749,198
100,0,blank,0,190.70065,443.4599,142749,142945,196
100,20,size,136,213.3097,440.66325,142945,143141,196
100,0,blank,0,218.052875,447.190675,143141,143273,132
100,0,blank,0,-323,-105,143337,143497,160
100,0,blank,0,186.030016666667,498.715233333333,143656,143840,184
100,0,blank,0,164.4432,504.64875,143840,144035,195
100,25,],176,144.31455,539.8534,144035,144228,193
100,0,blank,0,123.42735,505.465483333333,144228,144420,192
100,0,blank,0,123.585566666667,580.912183333333,144420,144612,192
100,25,],176,148.18605,533.902566666667,144612,144807,195
100,0,blank,0,173.45415,489.335533333333,144807,144999,192
100,22,],156,157.4264,485.199933333333,144999,145192,193
100,0,blank,0,180.06464,460.36888,145192,145361,169
100,22,list,151,197.577716666667,481.535516666667,145361,145554,193
100,0,blank,0,241.211416666667,494.963133333333,145554,145749,195
100,0,blank,0,259.10305,491.16065,145749,145814,65
100,22,list,151,132.2032,468.8221,145847,146014,167
100,0,blank,0,132.968766666667,463.392516666667,146014,146208,194
100,0,blank,0,112.205783333333,428.457133333333,146208,146402,194
100,0,blank,0,129.84335,430.6908,146402,146598,196
100,20,;,139,147.8213,423.474166666667,146598,146796,198
100,0,blank,0,164.11825,445.81575,146796,146989,193
100,20,<,135,183.608133333333,434.447266666667,146989,147180,191
100,0,blank,0,198.2512,448.935933333333,147180,147276,96
100,0,blank,0,-323,-105,147339,147518,179
100,20,size,136,236.614216666667,436.281616666667,147629,147806,177
100,0,blank,0,337.39385,445.217333333333,147838,148029,191
100,20,),142,335.5763,440.05725,148029,148219,190
100,0,blank,0,325.716133333333,442.415716666667,148219,148407,188
100,20,j,140,166.809566666667,435.455066666667,148407,148593,186
100,0,blank,0,171.46548,445.50568,148593,148766,173
100,0,blank,0,194.0576,429.6984,148766,148849,83
100,0,blank,0,340.97085,442.87295,148946,149127,181
100,0,blank,0,351.490683333333,436.532833333333,149127,149322,195
100,0,blank,0,357.6041,441.885133333333,149322,149419,97
100,22,>,150,175.250566666667,480.7082,149450,149643,193
100,22,list,151,127.54308,483.25988,149643,149810,167
100,22,j,153,152.685875,478.27975,149810,149948,138
100,22,1,155,290.4152,466.5756,151496,151521,25
100,0,blank,0,166.12005,507.8742,151559,151758,199
100,0,blank,0,157.98746,507.85132,151758,151925,167
100,22,j,153,144.52985,480.342066666667,151925,152121,196
100,0,blank,0,157.090933333333,455.387883333333,152121,152318,197
100,20,<,135,183.19948,432.53662,152318,152485,167
100,0,blank,0,200.64306,435.55924,152485,152652,167
100,20,size,136,213.114766666667,432.620516666667,152652,152848,196
100,0,blank,0,251.08885,432.783216666667,152848,153043,195
100,0,blank,0,247.765266666667,436.210583333333,153043,153238,195
100,20,size,136,209.9438,428.163766666667,153238,153434,196
100,18,0,118,96.477,391.235916666667,153434,153632,198
100,18,<,121,147.608116666667,390.701883333333,153632,153831,199
100,18,size,122,186.869483333333,389.943733333333,153831,154030,199
100,0,blank,0,136.737733333333,380.8463,154030,154227,197
100,0,blank,0,117.95662,379.51446,154227,154390,163
100,0,blank,0,222.334333333333,412.160383333333,154423,154620,197
100,20,size,136,236.42418,439.5251,154620,154787,167
100,20,;,139,290.14432,427.15456,154787,154957,170
100,20,-,137,261.5816,431.33806,154957,155126,169
100,20,-,137,256.64102,429.69162,155126,155291,165
100,20,1,138,278.23374,431.35472,155291,155459,168
100,20,1,138,275.24455,431.038216666667,155459,155655,196
100,20,size,136,241.006233333333,429.19805,155655,155852,197
100,20,j,140,312.748333333333,436.12545,155852,156051,199
100,0,blank,0,346.762616666667,432.505883333333,156051,156248,197
100,20,j,140,311.2977,431.790533333333,156248,156347,99
100,22,list,151,197.022666666667,476.024383333333,156379,156576,197
100,22,j,153,243.2552,479.654866666667,156576,156770,194
100,22,1,155,292.964266666667,479.234016666667,156770,156965,195
100,22,],156,298.478066666667,476.42015,156965,157163,198
100,0,blank,0,278.748816666667,461.446783333333,157163,157361,198
100,0,blank,0,227.964466666667,413.82465,157361,157555,194
100,0,blank,0,217.547783333333,391.48595,157555,157751,196
100,18,size,122,179.183866666667,383.337766666667,157751,157945,194
100,18,++,125,234.463483333333,390.76235,157945,158143,198
100,0,blank,0,273.9274,400.443116666667,158143,158337,194
100,0,blank,0,269.353583333333,426.394966666667,158337,158529,192
100,0,blank,0,246.77395,539.994116666667,158529,158719,190
100,25,+,174,260.088566666667,538.0194,158719,158910,191
100,0,blank,0,292.804366666667,556.98195,158910,159101,191
100,25,+,174,254.815466666667,549.642933333333,159101,159294,193
100,0,blank,0,194.161933333333,567.186133333333,159294,159490,196
100,0,blank,0,172.154133333333,585.9287,159490,159686,196
100,0,blank,0,128.1033,637.684766666667,159686,159884,198
100,0,blank,0,124.7368,664.2195,159884,159917,33
100,22,list,151,133.98285,465.661683333333,159949,160146,197
100,0,blank,0,132.96055,435.618633333333,160146,160344,198
100,0,blank,0,120.609616666667,397.458683333333,160344,160538,194
100,0,blank,0,142.679683333333,389.195083333333,160538,160731,193
100,0,blank,0,153.8122,389.529633333333,160731,160924,193
100,18,size,122,192.303516666667,391.149166666667,160924,161116,192
100,18,i,124,230.811733333333,395.6265,161116,161309,193
100,0,blank,0,220.212433333333,383.739383333333,161309,161501,192
100,18,size,122,180.317733333333,392.84775,161501,161694,193
100,18,++,125,248.996483333333,391.61985,161694,161886,192
100,18,i,124,232.2627,395.832933333333,161886,162078,192
100,0,blank,0,215.146533333333,399.7891,162078,162272,194
100,20,size,136,210.546216666667,435.955016666667,162272,162465,193
100,0,blank,0,142.401416666667,443.6134,162465,162660,195
100,0,blank,0,159.753683333333,444.10435,162660,162854,194
100,0,blank,0,175.93275,437.975133333333,162854,163047,193
100,20,;,139,151.195983333333,434.885866666667,163047,163241,194
100,0,blank,0,141.369316666667,409.1375,163241,163433,192
100,0,blank,0,223.703916666667,399.24025,163433,163626,193
100,0,blank,0,199.4375,406.448683333333,163626,163817,191
100,0,blank,0,159.6139,426.1678,163817,163849,32
100,0,blank,0,-323,-105,163913,164021,108
100,0,blank,0,144.052083333333,449.714283333333,164156,164334,178
100,0,blank,0,152.962,441.509166666667,164334,164521,187
100,0,blank,0,153.726883333333,437.33865,164521,164705,184
100,0,blank,0,175.89775,444.6489,164705,164887,182
100,0,blank,0,196.0605,454.004583333333,164887,165068,181
100,20,<,135,192.011383333333,440.448116666667,165068,165251,183
100,0,blank,0,201.062283333333,454.683616666667,165251,165435,184
100,22,],156,160.507116666667,476.312066666667,165435,165623,188
100,0,blank,0,187.5278,484.5448,165623,165813,190
100,0,blank,0,201.14335,460.23475,165813,166003,190
100,20,size,136,223.046133333333,432.215233333333,166003,166193,190
100,0,blank,0,241.894166666667,446.663766666667,166193,166385,192
100,22,list,151,211.378633333333,476.411783333333,166385,166576,191
100,22,list,151,210.319583333333,476.605083333333,166576,166768,192
100,0,blank,0,196.028316666667,446.704566666667,166768,166959,191
100,20,size,136,209.686733333333,434.2854,166959,167150,191
100,0,blank,0,196.990516666667,407.743566666667,167150,167343,193
100,0,blank,0,181.027233333333,401.25605,167343,167534,191
100,0,blank,0,193.28085,402.559566666667,167534,167726,192
100,0,blank,0,200.76485,415.866166666667,167726,167919,193
100,0,blank,0,180.508933333333,420.7815,167919,168114,195
100,20,j,140,170.2163,425.27015,168114,168309,195
100,20,size,136,209.127583333333,427.080666666667,168309,168505,196
100,20,size,136,243.335433333333,428.221366666667,168505,168699,194
100,20,-,137,258.490816666667,423.26985,168699,168897,198
100,0,blank,0,270.102883333333,424.7578,168897,169093,196
100,0,blank,0,295.85035,418.70715,169093,169202,109
100,0,blank,0,248.4678,455.7411,169202,169316,114
100,0,blank,0,234.9342,454.9694,169316,169515,199
100,0,blank,0,211.094083333333,447.150166666667,169515,169713,198
100,0,blank,0,214.000283333333,458.564583333333,169713,169906,193
100,0,blank,0,217.679666666667,454.4285,169906,170100,194
100,0,blank,0,244.549816666667,448.5947,170100,170294,194
100,0,blank,0,263.216883333333,459.4903,170294,170489,195
100,0,blank,0,296.1931,450.5993,170489,170555,66
100,0,blank,0,176.8025,487.09005,170587,170784,197
100,0,blank,0,211.995783333333,488.17715,170784,170978,194
100,0,blank,0,-323,-105,171044,171199,155
100,25,list,171,216.5294,537.6534,171225,171251,26
100,0,blank,0,213.8331,446.130366666667,171308,171488,180
100,0,blank,0,210.6735,443.0243,171488,171682,194
100,0,blank,0,212.174733333333,444.047016666667,171682,171876,194
100,0,blank,0,207.74615,445.256266666667,171876,172068,192
100,0,blank,0,202.823,439.206466666667,172068,172262,194
100,0,blank,0,226.730933333333,443.2224,172262,172458,196
100,0,blank,0,241.5558,459.391883333333,172458,172653,195
100,0,blank,0,232.131166666667,493.237183333333,172653,172852,199
100,24,list,161,184.2205,524.112266666667,172852,173050,198
100,0,blank,0,193.0904,493.26855,173050,173249,199
100,0,blank,0,184.598716666667,483.687383333333,173249,173446,197
100,0,blank,0,-323,-105,173511,173644,133
100,0,blank,0,198.7627,592.7495,173670,173700,30
100,0,blank,0,192.203316666667,446.87055,173790,173976,186
100,0,blank,0,193.99294,437.30988,173976,174142,166
100,0,blank,0,194.573333333333,439.1288,174142,174337,195
100,0,blank,0,203.669883333333,429.306616666667,174337,174529,192
100,20,size,136,205.954616666667,421.868866666667,174529,174724,195
100,0,blank,0,186.0198,420.906233333333,174724,174918,194
100,0,blank,0,182.858633333333,412.799616666667,174918,175114,196
100,20,size,136,204.5733,431.5859,175114,175310,196
100,0,blank,0,201.740166666667,440.922316666667,175310,175507,197
100,0,blank,0,182.987833333333,437.532333333333,175507,175705,198
100,20,<,135,184.501233333333,435.9531,175705,175900,195
100,20,size,136,207.1138,430.239083333333,175900,176097,197
100,20,size,136,224.203016666667,431.173866666667,176097,176295,198
100,20,size,136,226.87775,421.869666666667,176295,176494,199
100,20,;,139,291.273816666667,432.0516,176494,176693,199
100,20,1,138,275.253266666667,435.85815,176693,176892,199
100,20,-,137,262.765583333333,441.32015,176892,177091,199
100,20,-,137,260.172116666667,441.260433333333,177091,177288,197
100,0,blank,0,268.226716666667,439.607716666667,177288,177486,198
100,0,blank,0,203.0265,427.06195,177486,177683,197
100,0,blank,0,229.3658,444.93016,177683,177851,168
100,20,size,136,229.19555,430.57765,177851,177983,132
100,0,blank,0,-323,-105,178048,178183,135
100,20,<,135,186.25885,422.420583333333,178364,178548,184
100,20,<,135,185.4648,434.842516666667,178548,178743,195
100,0,blank,0,209.2694,443.863816666667,178743,178938,195
100,0,blank,0,203.015466666667,441.516183333333,178938,179130,192
100,0,blank,0,199.458066666667,436.76315,179130,179321,191
100,0,blank,0,179.194483333333,427.991716666667,179321,179516,195
100,0,blank,0,158.639033333333,406.454066666667,179516,179711,195
100,0,blank,0,164.125833333333,400.228583333333,179711,179906,195
100,0,blank,0,165.721766666667,398.652283333333,179906,180100,194
100,18,size,122,177.027616666667,390.2186,180100,180297,197
100,18,size,122,168.375566666667,389.127516666667,180297,180494,197
100,18,size,122,169.97375,390.741416666667,180494,180692,198
100,0,blank,0,-323,-105,180760,180890,130
100,0,blank,0,162.6768,387.149166666667,181012,181201,189
100,18,size,122,165.39066,386.06104,181201,181369,168
100,18,size,122,166.7972,383.648466666667,181369,181567,198
100,0,blank,0,163.211183333333,386.9967,181567,181762,195
100,0,blank,0,158.530266666667,379.599666666667,181762,181956,194
100,18,size,122,178.879766666667,395.62855,181956,182152,196
100,0,blank,0,177.75065,403.836716666667,182152,182350,198
100,0,blank,0,164.756766666667,405.082016666667,182350,182549,199
100,0,blank,0,176.9236,404.7399,182549,182748,199
100,0,blank,0,196.756133333333,406.694666666667,182748,182945,197
100,20,-,137,260.016716666667,432.773016666667,182945,183143,198
100,0,blank,0,297.719483333333,445.3959,183143,183342,199
100,0,blank,0,321.74984,453.80204,183342,183508,166
100,24,list,161,181.504966666667,510.195733333333,183542,183738,196
100,0,blank,0,181.371716666667,547.037733333333,183738,183933,195
100,25,list,171,191.88595,541.6554,183933,184130,197
100,0,blank,0,224.480583333333,549.724166666667,184130,184328,198
100,25,[,172,227.952866666667,544.798666666667,184328,184526,198
100,26,+,181,158.4421,562.239566666667,184526,184725,199
100,26,],183,188.451133333333,558.736766666667,184725,184923,198
100,0,blank,0,236.82304,523.23242,184923,185091,168
100,0,blank,0,248.5849,544.8993,185091,185124,33
100,0,blank,0,-323,-105,185158,185345,187
100,0,blank,0,-323,-105,185345,185497,152
100,0,blank,0,274.17285,529.623316666667,185523,185706,183
100,0,blank,0,248.746083333333,536.998133333333,185706,185905,199
100,25,list,171,223.143766666667,545.618816666667,185905,186103,198
100,24,list,161,172.7499,519.531816666667,186103,186298,195
100,0,blank,0,185.766766666667,489.045616666667,186298,186493,195
100,0,blank,0,223.972883333333,486.613166666667,186493,186691,198
100,22,list,151,197.863116666667,482.132666666667,186691,186888,197
100,22,list,151,233.592683333333,479.853816666667,186888,187083,195
100,0,blank,0,257.338983333333,495.660816666667,187083,187281,198
100,24,;,165,224.114683333333,519.516716666667,187281,187478,197
100,25,list,171,185.108483333333,546.768383333333,187478,187674,196
100,0,blank,0,186.163316666667,552.835016666667,187674,187872,198
100,22,list,151,215.97718,478.36602,187872,188039,167
100,0,blank,0,234.49744,489.88342,188039,188208,169
100,26,;,186,267.11768,557.6289,188208,188375,167
100,0,blank,0,271.4298,531.922916666667,188375,188573,198
100,0,blank,0,265.31688,511.68644,188573,188739,166
100,0,blank,0,-323,-105,188804,188990,186
100,0,blank,0,-323,-105,188990,189156,166
100,26,=,184,210.88195,565.5,189187,189371,184
100,0,blank,0,215.368475,562.78975,189371,189504,133
100,25,list,171,204.715,546.55145,189504,189688,184
100,26,=,184,209.5659,561.3296,189688,189887,199
100,0,blank,0,215.718233333333,558.784433333333,189887,190084,197
100,25,list,171,207.8354,539.6407,190084,190115,31
100,0,blank,0,-323,-105,190180,190365,185
100,0,blank,0,-323,-105,190365,190401,36
100,25,list,171,218.982833333333,539.6019,190431,190614,183
100,22,list,151,202.44612,469.8323,190614,190781,167
100,22,list,151,201.32905,472.531433333333,190781,190979,198
100,0,blank,0,193.022416666667,475.881766666667,190979,191174,195
100,0,blank,0,254.926683333333,480.5223,191174,191369,195
100,0,blank,0,278.36935,476.342166666667,191369,191564,195
100,22,j,153,252.291116666667,481.112933333333,191564,191758,194
100,22,list,151,233.066183333333,476.646966666667,191758,191953,195
100,22,[,152,236.471233333333,480.778916666667,191953,192148,195
100,0,blank,0,277.657533333333,485.504933333333,192148,192342,194
100,0,blank,0,275.686,479.374775,192342,192472,130
100,0,blank,0,-323,-105,192537,192721,184
100,0,blank,0,-323,-105,192721,192763,42
100,0,blank,0,260.830916666667,472.70195,192789,192967,178
100,22,+,154,264.683783333333,466.783266666667,192967,193163,196
100,22,+,154,265.626383333333,470.7652,193163,193356,193
100,22,+,154,263.6409,483.43655,193356,193549,193
100,22,+,154,263.7988,483.89635,193549,193740,191
100,0,blank,0,259.805633333333,480.926983333333,193740,193932,192
100,0,blank,0,262.981,477.114316666667,193932,194126,194
100,0,blank,0,280.83352,464.8328,194126,194291,165
100,0,blank,0,280.16338,464.88138,194291,194459,168
100,0,blank,0,282.56374,457.43796,194459,194626,167
100,22,],156,294.0814,467.93655,194626,194694,68
100,0,blank,0,-323,-105,194762,194922,160
100,22,+,154,272.074083333333,484.813883333333,195036,195226,190
100,0,blank,0,279.07228,488.22752,195226,195395,169
100,22,1,155,284.703516666667,483.345483333333,195395,195592,197
100,22,list,151,201.7533,476.6589,195592,195785,193
100,22,list,151,203.104433333333,481.12235,195785,195978,193
100,0,blank,0,225.57015,449.100633333333,195978,196174,196
100,22,list,151,207.741683333333,468.713866666667,196174,196369,195
100,0,blank,0,234.599566666667,469.401216666667,196369,196565,196
100,0,blank,0,218.998233333333,463.0596,196565,196760,195
100,0,blank,0,191.536533333333,475.302333333333,196760,196956,196
100,22,list,151,230.458766666667,478.58795,196956,197150,194
100,0,blank,0,278.797,471.634333333333,197150,197248,98
100,0,blank,0,-323,-105,197314,197479,165
100,0,blank,0,204.3136,488.546283333333,197599,197782,183
100,0,blank,0,200.440816666667,491.05165,197782,197977,195
100,0,blank,0,210.245116666667,499.665266666667,197977,198174,197
100,22,list,151,201.531766666667,482.995966666667,198174,198368,194
100,20,<,135,184.424216666667,439.580166666667,198368,198562,194
100,0,blank,0,174.210333333333,438.608533333333,198562,198756,194
100,0,blank,0,179.1887,426.491616666667,198756,198951,195
100,0,blank,0,181.777883333333,428.4831,198951,199146,195
100,20,<,135,186.603516666667,434.046283333333,199146,199343,197
100,0,blank,0,248.790716666667,422.9446,199343,199538,195
100,0,blank,0,-323,-105,199605,199786,181
100,0,blank,0,-323,-105,199786,199853,67
100,0,blank,0,105.810033333333,443.307816666667,199887,200067,180
100,0,blank,0,104.6085,445.5288,200067,200263,196
100,0,blank,0,164.373766666667,455.9125,200263,200456,193
100,0,blank,0,196.8485,454.874583333333,200456,200646,190
100,0,blank,0,210.23845,447.606316666667,200646,200840,194
100,0,blank,0,238.417583333333,461.9161,200840,201038,198
100,0,blank,0,236.412216666667,458.676,201038,201236,198
100,0,blank,0,186.270833333333,461.24995,201236,201435,199
100,0,blank,0,131.53636,510.15708,201435,201603,168
100,24,temp,159,122.18366,520.92328,201603,201772,169
100,0,blank,0,73.1943,618.3251,201772,201971,199
100,31,return,197,30.7714,668.260616666667,201971,202170,199
100,0,blank,0,17.3727166666667,657.415733333333,202170,202367,197
100,0,blank,0,18.5580666666667,656.608033333333,202367,202564,197
100,0,blank,0,88.7468833333333,671.100033333333,202564,202757,193
100,30,displayList,190,64.6704,660.452883333333,202757,202950,193
100,30,displayList,190,67.3199333333333,660.537616666667,202950,203144,194
100,30,displayList,190,119.654183333333,661.7928,203144,203337,193
100,0,blank,0,136.07755,668.898433333333,203337,203530,193
100,0,blank,0,180.598233333333,678.657616666667,203530,203724,194
100,31,0,198,98.4777666666667,671.444316666667,203724,203918,194
100,31,0,198,97.4833333333333,669.977833333333,203918,204113,195
100,31,return,197,50.6703166666667,674.171383333333,204113,204306,193
100,31,return,197,38.6092333333333,677.373566666667,204306,204501,195
100,31,return,197,66.5543166666667,669.908216666667,204501,204695,194
100,16,temp,105,77.48004,353.39814,204727,204887,160
100,0,blank,0,90.74645,247.1081,204920,205048,128
100,8,printf,44,95.3933666666667,168.998533333333,205080,205270,190
100,7,0,35,128.417533333333,151.8855,205270,205459,189
100,7,=,34,107.6914,151.417466666667,205459,205646,187
100,0,blank,0,31.3335333333333,157.789383333333,205646,205831,185
100,8,printf,44,45.2057833333333,163.981633333333,205831,206016,185
100,8,printf,44,69.4175333333333,158.5162,206016,206202,186
100,7,=,34,104.477616666667,150.756566666667,206202,206388,186
100,0,blank,0,1087.123,301.4883,206481,206513,32
100,0,blank,0,649.426666666667,100.2663,206674,206771,97
100,0,blank,0,612.720533333333,-29.1285,206802,206899,97
100,0,blank,0,497.996483333333,-35.3471333333333,206931,207125,194
100,0,blank,0,495.0278,-22.2744,207125,207189,64
100,0,blank,0,22.2922833333333,174.61065,207254,207446,192
100,9,printf,56,68.9280833333333,195.6951,207446,207643,197
100,6,"Listis:",28,106.468683333333,117.497766666667,207643,207841,198
100,2,stdio,8,105.878816666667,29.3599,207841,208038,197
100,0,blank,0,150.5923,10.1252666666667,208038,208237,199
100,0,blank,0,180.424133333333,6.44646666666667,208237,208335,98
100,0,blank,0,-323,-105,208501,208695,194
100,0,blank,0,-323,-105,208695,208889,194
100,0,blank,0,-323,-105,208889,209086,197
100,14,sizeof,94,130.3905,294.602633333333,209120,209228,108
100,7,0,35,124.1221,145.56588,209262,209429,167
100,0,blank,0,122.56975,137.920133333333,209429,209623,194
100,7,=,34,110.392216666667,145.95515,209623,209814,191
100,0,blank,0,121.009666666667,140.443066666667,209814,209934,120
100,6,(,27,86.1959,124.2055,209934,210054,120
100,7,=,34,104.771,139.339,210054,210183,129
100,7,0,35,124.5782,142.2107,210183,210382,199
100,6,"Listis:",28,115.1188,131.2197,210382,210417,35
100,0,blank,0,132.088583333333,317.717,210452,210644,192
100,13,12,73,159.7137,283.6638,210644,210745,101
100,0,blank,0,230.7444,285.5474,210745,210942,197
100,0,blank,0,245.346733333333,290.8085,210942,211141,199
100,14,sizeof,94,308.708466666667,292.1469,211141,211340,199
100,0,blank,0,268.577983333333,300.6137,211340,211538,198
100,14,/,93,263.7856,303.73142,211538,211705,167
100,14,sizeof,94,300.73856,307.0497,211705,211871,166
100,0,blank,0,308.5236,317.99416,211871,212038,167
100,0,blank,0,306.830983333333,329.889216666667,212038,212236,198
100,0,blank,0,329.782016666667,321.823133333333,212236,212434,198
100,0,blank,0,339.77786,324.93472,212434,212599,165
100,0,blank,0,347.7315,319.0872,212599,212634,35
100,14,list,91,220.0466,304.93804,212666,212833,167
100,0,blank,0,223.70165,318.86025,212833,212900,67
100,16,;,106,94.40305,342.3486,212934,213133,199
100,16,temp,105,62.3255666666667,339.416366666667,213133,213330,197
100,0,blank,0,60.2722833333333,333.365616666667,213330,213528,198
100,16,temp,105,76.96215,349.78135,213528,213726,198
100,16,temp,105,82.9142,351.454966666667,213726,213824,98
100,18,;,123,205.70745,391.882033333333,213857,214053,196
100,0,blank,0,220.866966666667,396.7265,214053,214250,197
100,0,blank,0,235.327766666667,409.1238,214250,214445,195
100,20,-,137,259.0959,436.781916666667,214445,214642,197
100,0,blank,0,263.7754,444.01035,214642,214838,196
100,0,blank,0,191.19076,413.29734,214838,215002,164
100,0,blank,0,48.0925,408.69005,215036,215235,199
100,19,{,127,31.7781666666667,409.777733333333,215235,215430,195
100,0,blank,0,41.3139,401.075566666667,215430,215627,197
100,20,=,131,120.79495,440.842,215627,215826,199
100,0,blank,0,86.5058333333333,444.980683333333,215826,216021,195
100,0,blank,0,58.978675,443.963125,216021,216151,130
100,22,],156,298.40825,465.300166666667,216184,216382,198
100,0,blank,0,265.970116666667,496.686233333333,216382,216577,195
100,0,blank,0,262.761433333333,492.907833333333,216577,216675,98
100,0,blank,0,115.71766,498.79052,216708,216874,166
100,24,temp,159,113.67014,510.52236,216874,217042,168
100,25,list,171,185.399316666667,548.076983333333,217042,217240,198
100,0,blank,0,217.12912,565.31732,217240,217406,166
100,26,temp,185,251.69678,573.5124,217406,217574,168
100,0,blank,0,219.176816666667,591.894933333333,217574,217772,198
100,0,blank,0,197.4034,592.58065,217772,217838,66
100,0,blank,0,38.5554166666667,630.927416666667,217872,218070,198
100,0,blank,0,40.0993166666667,664.113866666667,218070,218268,198
100,0,blank,0,117.0782,670.5914,218268,218300,32
100,0,blank,0,220.412616666667,688.271866666667,218334,218532,198
100,0,blank,0,209.271966666667,694.166,218532,218632,100
100,0,blank,0,50.70706,684.32312,218665,218831,166
100,0,blank,0,64.71818,692.13374,218831,218997,166
100,0,blank,0,43.37352,696.93768,218997,219165,168
100,0,blank,0,22.3559666666667,690.465566666667,219165,219364,199
100,0,blank,0,61.6616333333333,696.907883333333,219364,219563,199
100,0,blank,0,-21.3841333333333,710.804833333333,219563,219757,194
100,0,blank,0,-21.32215,709.4625,219757,219890,133
100,0,blank,0,17.2748666666667,482.730633333333,219923,220020,97
100,15,int,99,37.1595166666667,317.8056,220053,220249,196
100,0,blank,0,33.4612166666667,177.140333333333,220281,220475,194
100,0,blank,0,30.34745,111.036466666667,220475,220666,191
100,3,void,12,35.4993166666667,51.5819666666667,220666,220855,189
100,3,displayList,13,58.5196833333333,49.7306833333333,220855,221042,187
100,0,blank,0,113.667466666667,42.13435,221042,221230,188
100,3,displayList,13,144.70495,47.1649333333333,221230,221416,186
100,0,blank,0,116.812433333333,42.7689666666667,221416,221605,189
100,2,stdio,8,108.109466666667,37.6380833333333,221605,221794,189
100,0,blank,0,91.4914166666667,35.15645,221794,221982,188
100,2,include,6,20.73845,40.4167166666667,221982,222173,191
100,2,include,6,41.5600833333333,35.7413833333333,222173,222364,191
100,0,blank,0,15.0073166666667,42.7474666666667,222364,222554,190
100,0,blank,0,-6.01116666666667,52.6214333333333,222554,222745,191
100,0,blank,0,27.25215,44.7716333333333,222745,222937,192
100,3,displayList,13,71.0562,56.1622,222937,223125,188
100,3,displayList,13,115.9849,63.3165833333333,223125,223315,190
100,3,(,14,172.2073,58.6838333333333,223315,223506,191
100,3,int,19,198.763616666667,56.9131166666667,223506,223693,187
100,3,int,19,271.181783333333,57.1617333333333,223693,223888,195
100,3,int,19,265.574016666667,52.9621,223888,224080,192
100,3,int,19,203.442566666667,48.5556,224080,224177,97
100,0,blank,0,13.70255,68.0825666666667,224208,224401,193
100,3,void,12,6.58533333333333,62.4115833333333,224401,224595,194
100,0,blank,0,19.7925333333333,77.5506333333333,224595,224789,194
100,0,blank,0,52.31765,83.6891833333333,224789,224986,197
100,5,ctr,24,87.3525666666667,95.75625,224986,225179,193
100,0,blank,0,158.556116666667,111.522533333333,225179,225370,191
100,6,"Listis:",28,180.058433333333,120.746633333333,225370,225562,192
100,6,"Listis:",28,172.713316666667,125.070716666667,225562,225754,192
100,6,"Listis:",28,184.4359,123.608733333333,225754,225946,192
100,6,"Listis:",28,144.612233333333,114.063066666667,225946,226137,191
100,6,printf,26,58.7081833333333,120.128366666667,226137,226328,191
100,6,printf,26,36.54985,117.838166666667,226328,226519,191
100,6,(,27,88.7319833333333,118.9511,226519,226710,191
100,6,"Listis:",28,121.511933333333,119.711633333333,226710,226902,192
100,6,"Listis:",28,143.167233333333,122.079533333333,226902,227095,193
100,6,"Listis:",28,124.8895,124.0193,227095,227160,65
100,0,blank,0,-323,-105,227224,227279,55
100,0,blank,0,164.34925,65.6188,227355,227414,59
100,6,"Listis:",28,170.979616666667,127.825216666667,227446,227640,194
100,6,"Listis:",28,175.4158,128.40445,227640,227769,129
100,6,printf,26,50.46735,124.524833333333,227801,227992,191
100,6,printf,26,49.7127833333333,126.252866666667,227992,228181,189
100,6,printf,26,54.1922333333333,126.1572,228181,228371,190
100,6,"Listis:",28,105.546516666667,115.388733333333,228371,228560,189
100,0,blank,0,174.2003,110.728916666667,228560,228751,191
100,0,blank,0,191.11045,100.6625,228751,228945,194
100,0,blank,0,188.772366666667,101.10845,228945,229141,196
100,0,blank,0,180.713116666667,107.879033333333,229141,229337,196
100,6,"Listis:",28,165.493366666667,116.219366666667,229337,229533,196
100,0,blank,0,121.019083333333,151.908416666667,229533,229727,194
100,8,printf,44,94.6625666666666,166.8341,229727,229922,195
100,8,printf,44,75.0366,170.80755,229922,230115,193
100,8,printf,44,55.41212,169.67968,230115,230301,186
100,8,printf,44,91.765,172.7281,230301,230415,114
100,0,blank,0,104.5635,165.209,230415,230512,97
100,8,"%d\t",46,126.6567,170.942466666667,230512,230701,189
100,8,"%d\t",46,129.3535,174.6904,230701,230893,192
100,8,"%d\t",46,129.185216666667,175.849666666667,230893,231087,194
100,8,"%d\t",46,163.882033333333,176.111316666667,231087,231281,194
100,8,"%d\t",46,151.964133333333,171.095783333333,231281,231476,195
100,8,"%d\t",46,150.771866666667,172.325316666667,231476,231670,194
100,8,..,47,175.635983333333,176.855616666667,231670,231864,194
100,0,blank,0,192.2629,199.21505,231864,231929,65
100,0,blank,0,202.405216666667,344.775516666667,231962,232154,192
100,0,blank,0,203.23135,351.0661,232154,232219,65
100,0,blank,0,-323,-105,232316,232509,193
100,0,blank,0,-323,-105,232509,232610,101
100,0,blank,0,193.05854,467.76874,232683,232855,172
100,0,blank,0,195.9704,463.769966666667,232855,232953,98
