Frameno_fix,lineno_fix,Tokenname_fix,tokens_id,gaze_X_fix,gaze_Y_fix,timestamp_fix_start,timestamp_fix_end,time_duration
100,0,blank,0,36.33192,-44.9901,3868,4017,149
100,0,blank,0,65.95215,-55.65165,4017,4100,83
100,0,blank,0,58.7786,-37.9501,4154,4240,86
100,0,blank,0,204.4151,166.3111,4323,4474,151
100,0,blank,0,141.82535,143.146975,4474,4628,154
100,0,blank,0,159.212333333333,154.386733333333,4628,4803,175
100,0,blank,0,209.1815,144.8097,4803,4828,25
100,0,blank,0,238.4353,221.3981,4939,5022,83
100,1,Program,4,114.8296,20.2952,5047,5076,29
100,0,blank,0,56.0666666666667,-4.75833333333333,5105,5193,88
100,3,string,29,121.7397,52.0506,5224,5384,160
100,4,ctype,36,113.6261,85.0035,5384,5483,99
100,5,stdlib,43,105.8595,100.0295,5483,5865,382
100,0,blank,0,154.8114,223.6782,5980,6055,75
100,10,CHAR_SIZE,70,134.833075,218.930075,6192,6377,185
100,10,CHAR_SIZE,70,158.79498,208.85076,6377,6567,190
100,11,[,79,180.8788,236.1026,6567,6592,25
100,0,blank,0,93.8188166666667,-51.5053666666667,6706,6882,176
100,0,blank,0,73.8306666666667,-64.6804833333333,6882,7080,198
100,0,blank,0,78.9596,-58.3226166666667,7080,7257,177
100,0,blank,0,159.978766666667,-45.2063333333333,7257,7442,185
100,0,blank,0,105.5208,-52.0297,7442,7532,90
100,0,blank,0,130.8699,-6.2848,7558,7590,32
100,0,blank,0,197.736316666667,-26.61295,7650,7822,172
100,0,blank,0,172.1938,51.2567,7822,7856,34
100,0,blank,0,400.4768,288.692975,7920,8044,124
100,10,CHAR_SIZE,70,179.27364,215.51618,8106,8269,163
100,0,blank,0,958.622,255.2925,8360,8511,151
100,0,blank,0,-323,-105,8688,8914,226
100,0,blank,0,-323,-105,8914,8998,84
100,0,blank,0,-323,-105,8998,9114,116
100,0,blank,0,-323,-105,9114,9309,195
100,0,blank,0,-323,-105,9309,9503,194
100,0,blank,0,-323,-105,9503,9702,199
100,0,blank,0,-323,-105,9702,9784,82
100,5,stdlib,43,116.878516666667,107.4153,10001,10177,176
100,0,blank,0,122.36765,165.4633,10177,10236,59
100,10,{,73,258.735,211.9868,10265,10294,29
100,9,str2,62,225.113,184.958533333333,10323,10411,88
100,2,>,25,182.7871,35.3137,10439,10469,30
100,0,blank,0,361.6583,287.238,10502,10563,61
100,0,blank,0,250.2101,140.9198,10622,10653,31
100,0,blank,0,284.0571,63.7825,10814,10845,31
100,0,blank,0,421.494,91.8078,10875,10906,31
100,0,blank,0,262.19582,110.71464,10937,11100,163
100,0,blank,0,252.85905,229.704375,11131,11256,125
100,0,blank,0,270.0814,112.8464,11289,11322,33
100,12,;,87,295.5128,258.7617,11354,11387,33
100,0,blank,0,275.7722,110.9881,11455,11487,32
100,6,CHAR_SIZE,49,150.5345,123.20255,11615,11677,62
100,0,blank,0,286.2275,227.401,11713,11748,35
100,0,blank,0,212.37085,137.442616666667,11779,11964,185
100,0,blank,0,218.5334,138.7524,11964,12121,157
100,0,blank,0,291.1937,205.2036,12155,12185,30
100,9,[,63,242.2704,180.7844,12337,12368,31
100,0,blank,0,322.4391,307.2884,12398,12428,30
100,0,blank,0,340.8065,217.0888,12462,12491,29
100,11,50,80,186.05925,235.0112,12522,12690,168
100,11,str2_rem,78,168.8424,224.6768,12690,12768,78
100,0,blank,0,159.1721,130.77465,13086,13144,58
100,11,str2_rem,78,165.975233333333,243.018366666667,13173,13261,88
100,0,blank,0,177.23836,142.63662,13289,13436,147
100,0,blank,0,120.54805,152.3542,13466,13642,176
100,9,str2,62,201.279825,196.46545,13642,13769,127
100,16,;,113,245.4103,343.1889,13799,13828,29
100,0,blank,0,164.7521,158.29,13859,13921,62
100,0,blank,0,165.6314,200.5009,13952,14043,91
100,10,CHAR_SIZE,70,145.213433333333,218.2921,14074,14256,182
100,10,CHAR_SIZE,70,141.910733333333,208.467233333333,14256,14435,179
100,10,CHAR_SIZE,70,169.515783333333,217.7786,14435,14618,183
100,10,CHAR_SIZE,70,151.5167,214.9176,14618,14649,31
100,10,CHAR_SIZE,70,181.062225,209.2026,14680,14806,126
100,9,str2,62,217.574316666667,196.968383333333,14868,15051,183
100,0,blank,0,220.64725,201.75415,15051,15178,127
100,0,blank,0,281.238766666667,233.175516666667,15207,15392,185
100,0,blank,0,297.79258,224.22458,15392,15546,154
100,0,blank,0,294.859066666667,226.817,15546,15700,154
100,9,50,64,263.12755,196.6292,16011,16069,58
100,0,blank,0,-23.06544,266.28546,16097,16247,150
100,0,blank,0,-323,-105,16694,16797,103
100,0,blank,0,-323,-105,16797,16941,144
100,0,blank,0,-39.4322,275.5108,17015,17083,68
100,0,blank,0,-104.3775,326.244066666667,17139,17335,196
100,0,blank,0,-85.6680333333333,322.2585,17335,17435,100
100,10,CHAR_SIZE,70,180.3449,209.3496,17465,17493,28
100,9,],65,169.806733333333,181.285133333333,17550,17640,90
100,0,blank,0,-323,-105,17747,17936,189
100,0,blank,0,-323,-105,17936,18016,80
100,10,CHAR_SIZE,70,173.77405,210.0054,18046,18227,181
100,0,blank,0,191.987816666667,195.191183333333,18227,18405,178
100,0,blank,0,220.662516666667,175.71035,18405,18583,178
100,10,CHAR_SIZE,70,211.9063,209.01845,18583,18761,178
100,9,str2,62,222.32835,192.981925,18761,18883,122
100,0,blank,0,218.59975,211.16615,18940,19003,63
100,0,blank,0,-323,-105,19062,19142,80
100,9,50,64,246.25015,184.958625,19222,19335,113
100,0,blank,0,237.534133333333,178.736833333333,19396,19573,177
100,0,blank,0,237.95578,179.51586,19573,19722,149
100,9,str1,57,131.467633333333,188.922766666667,19783,19956,173
100,11,str2_rem,78,143.09605,233.717375,19956,20151,195
100,9,50,64,149.664416666667,197.652083333333,20151,20334,183
100,0,blank,0,127.471683333333,223.585383333333,20334,20514,180
100,10,CHAR_SIZE,70,140.661333333333,204.75365,20514,20690,176
100,10,CHAR_SIZE,70,150.004216666667,206.762583333333,20690,20866,176
100,9,comma,61,174.38095,189.647116666667,20866,21044,178
100,0,blank,0,143.0457,191.985766666667,21044,21225,181
100,9,],65,166.545516666667,198.42225,21225,21401,176
100,0,blank,0,221.42415,213.2577,21401,21580,179
100,10,0,74,273.01045,221.562833333333,21580,21756,176
100,10,0,74,270.34748,210.78724,21756,21903,147
100,0,blank,0,261.496725,227.535025,21903,22064,161
100,0,blank,0,260.4817,233.03865,22064,22248,184
100,0,blank,0,336.0566,206.501625,22248,22374,126
100,0,blank,0,301.5987,229.7865,22403,22513,110
100,12,"Enterstring1:",85,259.0932,254.5139,22513,22849,336
100,0,blank,0,292.655233333333,219.298233333333,22941,23027,86
100,0,blank,0,287.639116666667,198.29935,23060,23252,192
100,0,blank,0,289.907316666667,222.652366666667,23252,23435,183
100,10,0,74,273.49695,211.712883333333,23435,23616,181
100,10,{,73,262.518933333333,214.266166666667,23616,23800,184
100,10,CHAR_SIZE,70,173.4904,202.5872,23800,23831,31
100,9,[,63,142.6266,199.081766666667,23893,24076,183
100,10,CHAR_SIZE,70,119.60495,211.574716666667,24076,24259,183
100,11,str2_rem,78,107.895,226.1133,24259,24290,31
100,9,str1,57,94.6947333333333,180.286516666667,24320,24505,185
100,0,blank,0,93.2929,196.9731,24505,24535,30
100,0,blank,0,-323,-105,24598,24704,106
100,9,],65,167.034214285714,185.0014,24821,25019,198
100,9,50,64,161.121166666667,193.671633333333,25019,25198,179
100,9,50,64,160.34342,195.08944,25198,25388,190
100,9,],65,164.116916666667,199.048016666667,25388,25565,177
100,9,str2,62,204.135383333333,195.25545,25565,25761,196
100,10,CHAR_SIZE,70,196.48445,207.749,25761,25948,187
100,0,blank,0,195.935283333333,177.76005,25948,26118,170
100,10,},75,281.857333333333,207.38765,26118,26290,172
100,0,blank,0,381.1513,241.203,26349,26378,29
100,0,blank,0,654.0633,129.5046,26438,26620,182
100,0,blank,0,671.5994,95.8103,26620,26650,30
100,0,blank,0,249.18786,224.75,26784,26972,188
100,0,blank,0,295.4393,239.198,26972,26998,26
100,11,[,79,175.5402,235.5504,27082,27132,50
100,0,blank,0,-323,-105,27182,27333,151
100,9,str2,62,200.17045,197.87055,27358,27408,50
100,9,50,64,154.44,188.265,27408,27608,200
100,9,50,64,153.383133333333,199.195333333333,27608,27807,199
100,10,CHAR_SIZE,70,117.125,215.4331,27807,27882,75
100,12,"Enterstring1:",85,204.4054,252.5579,27961,28192,231
100,12,"Enterstring1:",85,204.4054,252.5579,28192,28217,25
100,0,blank,0,-323,-105,29121,29318,197
100,11,str2_rem,78,133.323,231.441075,29886,30003,117
100,10,CHAR_SIZE,70,134.883333333333,209.520883333333,30034,30219,185
100,11,str2_rem,78,153.9444,231.564716666667,30219,30393,174
100,12,"Enterstring1:",85,205.498325,253.4933,30393,30508,115
100,12,"Enterstring1:",85,247.029866666667,262.1842,30537,30621,84
100,0,blank,0,258.653025,280.480975,30649,30766,117
100,10,CHAR_SIZE,70,206.9016,213.7767,30794,30823,29
100,10,CHAR_SIZE,70,140.63405,214.81445,31210,31370,160
100,10,CHAR_SIZE,70,202.3671,209.793985714286,31478,31675,197
100,0,blank,0,200.37605,174.28585,31675,31734,59
100,12,(,84,107.15975,255.2791,31762,31905,143
100,12,"Enterstring1:",85,154.49605,254.93875,31935,32052,117
100,11,str2_rem,78,167.9547,228.2922,32088,32118,30
100,13,str1,92,186.7413,268.1218,32148,32182,34
100,0,blank,0,259.88326,323.08492,32514,32707,193
100,0,blank,0,294.582,330.035775,32707,32835,128
100,12,"Enterstring1:",85,186.9695,253.5081,32958,33078,120
100,15,),105,210.6361,311.127,33078,33164,86
100,18,"Onremovingcharactersfromsecondstringweget:%s\n",125,231.175,385.7131,33164,33292,128
100,16,a1,111,218.9695,333.81406,33324,33504,180
100,18,"Onremovingcharactersfromsecondstringweget:%s\n",125,236.62154,382.55822,33504,33673,169
100,0,blank,0,232.8531,412.3865,33673,33704,31
100,13,str1,92,180.217433333333,270.903566666667,33772,33862,90
100,0,blank,0,205.28642,340.16672,33925,34083,158
100,0,blank,0,242.19835,413.342675,34146,34276,130
100,16,;,113,249.5291,348.9543,34306,34340,34
100,0,blank,0,273.2363,336.211233333333,34457,34604,147
100,0,blank,0,311.15905,280.82665,34604,34723,119
100,0,blank,0,209.4517,414.255,34749,34898,149
100,17,str2_rem,116,187.485233333333,356.8187,34898,35070,172
100,15,;,106,214.6614,318.9307,35070,35238,168
100,18,"Onremovingcharactersfromsecondstringweget:%s\n",125,156.1304,381.71298,35298,35475,177
100,0,blank,0,139.77755,400.4222,35475,35671,196
100,0,blank,0,135.9457,415.326166666667,35671,35795,124
100,0,blank,0,213.9687,401.1254,35820,35979,159
100,0,blank,0,192.53495,437.953,35979,36068,89
100,0,blank,0,147.1184,418.2529,36068,36184,116
100,18,"Onremovingcharactersfromsecondstringweget:%s\n",125,172.6068,387.1149,36184,36368,184
100,0,blank,0,228.82365,430.233,36368,36559,191
100,18,"Onremovingcharactersfromsecondstringweget:%s\n",125,272.7052,378.4198,36559,37018,459
100,0,blank,0,166.6266,430.527966666667,37066,37206,140
100,0,blank,0,196.047375,401.99765,37317,37486,169
100,17,str2_rem,116,190.4257,365.729616666667,37486,37669,183
100,21,char,137,179.5881,449.88125,37723,37783,60
100,21,),145,344.4504,460.1427,37929,37997,68
100,0,blank,0,1.67290000000003,509.5087,38023,38085,62
100,0,blank,0,379.687,323.6385,38113,38173,60
100,0,blank,0,321.415,331.0612,38298,38392,94
100,0,blank,0,223.82766,288.7009,38517,38670,153
100,0,blank,0,288.95935,288.541016666667,38700,38872,172
100,0,blank,0,289.30305,243.69465,38872,38931,59
100,0,blank,0,-323,-105,39050,39236,186
100,0,blank,0,-323,-105,39236,39392,156
100,0,blank,0,-323,-105,39392,39474,82
100,15,str2,104,201.438983333333,321.53345,39505,39696,191
100,13,;,94,221.559625,275.75025,39696,39812,116
100,0,blank,0,326.60575,365.0554,40083,40142,59
100,0,blank,0,380.46085,370.50555,40207,40270,63
100,18,"Onremovingcharactersfromsecondstringweget:%s\n",125,354.5281,387.3815,40339,40369,30
100,0,blank,0,-55.4162,586.1105,40403,40436,33
100,0,blank,0,-53.9735,571.1675,40561,40592,31
100,0,blank,0,350.2349,430.4774,40622,40652,30
100,0,blank,0,0.863600000000019,532.2706,40747,40777,30
100,0,blank,0,-16.6644,407.6684,40871,40903,32
100,0,blank,0,-35.9339,475.4732,40964,40995,31
100,0,blank,0,239.9026,424.77935,41025,41216,191
100,18,"Onremovingcharactersfromsecondstringweget:%s\n",125,302.9566,385.0216,41216,41254,38
100,0,blank,0,221.726833333333,415.400016666667,41494,41674,180
100,21,str,139,243.6097,463.6372,41674,41708,34
100,0,blank,0,279.5504,411.54994,41835,42014,179
100,0,blank,0,213.8174,413.6241,42014,42043,29
100,0,blank,0,187.632583333333,354.723033333333,42074,42255,181
100,17,str2_rem,116,192.289833333333,362.960666666667,42255,42435,180
100,16,str1,109,182.4837,353.5298,42435,42465,30
100,0,blank,0,262.740966666667,340.8278,42522,42705,183
100,0,blank,0,254.870075,316.538325,42705,42842,137
100,0,blank,0,345.2081,346.6592,43006,43033,27
100,0,blank,0,-237.9768,658.4816,43090,43119,29
100,17,str2,118,230.0293,373.9304,43150,43180,30
100,0,blank,0,246.0402,429.2796,43303,43422,119
100,0,blank,0,249.1161,437.5665,43483,43514,31
100,0,blank,0,-248.62295,660.63205,43551,43610,59
100,0,blank,0,-239.0627,591.1808,43670,43701,31
100,0,blank,0,303.11345,434.0999,43731,43789,58
100,0,blank,0,323.0575,433.8685,44044,44212,168
100,0,blank,0,359.72045,404.04195,44212,44277,65
100,0,blank,0,302.399,442.0524,44401,44429,28
100,18,"Onremovingcharactersfromsecondstringweget:%s\n",125,294.557233333333,390.974066666667,44487,44661,174
100,18,"Onremovingcharactersfromsecondstringweget:%s\n",125,324.6832,387.872,44661,44734,73
100,24,(,161,267.6439,524.91916,44834,45012,178
100,24,str,162,281.68495,516.51535,45012,45079,67
100,0,blank,0,275.943566666667,534.877533333333,45190,45383,193
100,24,strlen,160,262.08515,522.72675,45383,45504,121
100,0,blank,0,-323,-105,45599,45772,173
100,0,blank,0,-323,-105,45772,45815,43
100,0,blank,0,283.7237,506.75965,45937,46109,172
100,0,blank,0,314.9973,596.1344,46109,46154,45
100,0,blank,0,-323,-105,46234,46319,85
100,0,blank,0,-323,-105,46862,47235,373
100,0,blank,0,-323,-105,47235,47399,164
100,0,blank,0,-323,-105,47399,47952,553
100,0,blank,0,-323,-105,47952,48186,234
100,0,blank,0,-323,-105,48186,48356,170
100,0,blank,0,-323,-105,48356,48388,32
100,0,blank,0,-323,-105,48388,49039,651
100,0,blank,0,-323,-105,49039,49369,330
100,0,blank,0,-323,-105,49369,49605,236
100,0,blank,0,-323,-105,49605,49802,197
100,0,blank,0,-323,-105,49802,49989,187
100,0,blank,0,-323,-105,49989,50042,53
100,0,blank,0,-323,-105,50042,50201,159
100,0,blank,0,-323,-105,50201,50360,159
100,0,blank,0,-323,-105,50360,50547,187
100,0,blank,0,-323,-105,50547,50578,31
100,0,blank,0,-323,-105,50578,50841,263
100,0,blank,0,-323,-105,50841,51102,261
100,0,blank,0,-323,-105,51102,51295,193
100,0,blank,0,-323,-105,51295,51478,183
100,0,blank,0,-323,-105,51478,51667,189
100,0,blank,0,-323,-105,51667,51740,73
100,0,blank,0,-323,-105,51740,51995,255
100,0,blank,0,-323,-105,51995,52250,255
100,0,blank,0,-323,-105,52250,52505,255
100,0,blank,0,-323,-105,52505,52689,184
100,0,blank,0,-323,-105,52689,52745,56
100,0,blank,0,-323,-105,52745,52909,164
100,0,blank,0,-323,-105,52909,53055,146
100,0,blank,0,-323,-105,53055,53204,149
100,0,blank,0,-323,-105,53204,53475,271
100,0,blank,0,-323,-105,53475,53710,235
100,0,blank,0,-323,-105,53710,53904,194
100,0,blank,0,-323,-105,53904,53968,64
100,0,blank,0,-323,-105,53968,54266,298
100,0,blank,0,-323,-105,54266,54567,301
100,0,blank,0,-323,-105,54567,54746,179
100,0,blank,0,-323,-105,54746,54937,191
100,0,blank,0,-323,-105,54937,55110,173
100,0,blank,0,-323,-105,55110,55275,165
100,0,blank,0,-323,-105,55275,55353,78
100,0,blank,0,-323,-105,55353,55522,169
100,0,blank,0,-323,-105,55522,55702,180
100,0,blank,0,-323,-105,55702,55829,127
100,0,blank,0,-323,-105,55829,56090,261
100,0,blank,0,-323,-105,56090,56392,302
100,0,blank,0,-323,-105,56392,56499,107
100,0,blank,0,-323,-105,56499,56829,330
100,0,blank,0,-323,-105,56829,57119,290
100,0,blank,0,-323,-105,57119,57464,345
100,0,blank,0,-323,-105,57464,57633,169
100,0,blank,0,-323,-105,57633,57807,174
100,0,blank,0,-323,-105,57807,57998,191
100,0,blank,0,-323,-105,57998,58156,158
100,0,blank,0,-323,-105,58156,58241,85
100,0,blank,0,-323,-105,58241,58420,179
100,0,blank,0,-323,-105,58420,58548,128
100,0,blank,0,-323,-105,58548,58703,155
100,0,blank,0,-323,-105,58703,58890,187
100,0,blank,0,-323,-105,58890,58922,32
100,0,blank,0,-323,-105,58922,59102,180
100,0,blank,0,-323,-105,59102,59274,172
100,0,blank,0,-323,-105,59274,59404,130
100,0,blank,0,-323,-105,59657,59683,26
100,12,"Enterstring1:",85,182.893,253.70145,60284,60353,69
100,0,blank,0,257.637228571429,274.9089,60385,60583,198
100,0,blank,0,273.0833,353.87955,60583,60638,55
100,0,blank,0,295.5538,207.812,60666,60694,28
100,0,blank,0,262.83805,416.68645,60723,60804,81
100,17,a1,120,282.1613,358.3147,60857,60913,56
100,0,blank,0,308.2481,459.111,60967,60997,30
100,16,comma,110,199.0431,346.5047,61024,61140,116
100,14,"Enterstring2:",97,232.0898,302.5377,61167,61196,29
100,11,50,80,186.946833333333,240.7917,61257,61434,177
100,0,blank,0,209.19765,177.99145,61434,61496,62
100,0,blank,0,173.10034,187.84932,61525,61681,156
100,11,50,80,189.40494,227.45736,61681,61857,176
100,12,"Enterstring1:",85,239.938333333333,252.144166666667,61857,62006,149
100,10,],71,232.164466666667,216.424233333333,62036,62134,98
100,0,blank,0,202.928616666667,288.901366666667,62554,62728,174
100,14,"Enterstring2:",97,182.015783333333,308.401283333333,62728,62909,181
100,18,"Onremovingcharactersfromsecondstringweget:%s\n",125,243.94548,385.48396,62909,63058,149
100,0,blank,0,203.8892,333.0556,63058,63121,63
100,0,blank,0,-323,-105,63212,63297,85
100,14,"Enterstring2:",97,218.7657,295.0222,63331,63357,26
100,0,blank,0,-323,-105,63381,63563,182
100,0,blank,0,-323,-105,63563,63741,178
100,0,blank,0,-323,-105,63741,63935,194
100,0,blank,0,-323,-105,63935,64126,191
100,0,blank,0,-323,-105,64126,64287,161
100,27,=,183,145.8484,591.081766666667,64411,64585,174
100,0,blank,0,-323,-105,64994,65035,41
100,0,blank,0,-323,-105,65035,65232,197
100,0,blank,0,-323,-105,65232,65273,41
100,0,blank,0,-323,-105,65273,65457,184
100,0,blank,0,-323,-105,65457,65540,83
100,0,blank,0,-323,-105,65677,65837,160
100,0,blank,0,-323,-105,65837,66035,198
100,0,blank,0,-323,-105,66035,66220,185
100,0,blank,0,-323,-105,66220,66327,107
100,0,blank,0,-323,-105,66327,66509,182
100,0,blank,0,431.16905,518.54175,66607,66675,68
100,23,index,150,160.880566666667,500.708,66782,66976,194
100,0,blank,0,161.7141,477.01795,66976,67059,83
100,13,str1,92,165.756933333333,276.197716666667,67195,67373,178
100,13,"%s",90,136.619771428571,282.039971428571,67373,67569,196
100,11,50,80,192.531133333333,235.673933333333,67569,67653,84
100,13,str1,92,196.801371428571,277.380014285714,67681,67880,199
100,0,blank,0,198.4978,332.23585,67880,67938,58
100,0,blank,0,226.20838,321.11084,68179,68327,148
100,0,blank,0,265.7415,242.4869,68384,68412,28
100,0,blank,0,342.20214,330.12714,68446,68595,149
100,0,blank,0,420.439225,364.4182,68655,68768,113
100,0,blank,0,741.113,369.9421,68861,68889,28
100,18,"Onremovingcharactersfromsecondstringweget:%s\n",125,607.6308,382.592066666667,69005,69100,95
100,0,blank,0,621.91398,426.24506,69133,69279,146
100,0,blank,0,636.3002,451.8498,69307,69334,27
100,0,blank,0,485.771816666667,507.828633333333,69364,69549,185
100,0,blank,0,437.4263,517.9492,69549,69577,28
100,0,blank,0,630.5653,423.4985,69607,69667,60
100,0,blank,0,738.121,221.0905,69698,69730,32
100,0,blank,0,678.147,433.6432,69760,69956,196
100,0,blank,0,734.234166666667,410.34785,69956,70135,179
100,14,"Enterstring2:",97,249.113966666667,306.9045,70218,70302,84
100,0,blank,0,332.7462,302.3021,70332,70361,29
100,0,blank,0,264.308166666667,268.0034,70417,70505,88
100,17,),121,298.964683333333,362.277533333333,70533,70725,192
100,0,blank,0,307.474475,333.53195,70725,70901,176
100,16,),112,238.703875,349.040125,70901,71018,117
100,0,blank,0,247.91502,329.93108,71074,71216,142
100,0,blank,0,182.0472,468.6045,71375,71400,25
100,0,blank,0,-323,-105,71607,71804,197
100,0,blank,0,-323,-105,71804,71995,191
100,0,blank,0,-323,-105,71995,72125,130
100,0,blank,0,-323,-105,72766,72961,195
100,0,blank,0,-323,-105,72961,73009,48
100,0,blank,0,-323,-105,73341,73529,188
100,0,blank,0,-323,-105,73529,73559,30
100,0,blank,0,-323,-105,74050,74245,195
100,0,blank,0,-323,-105,74245,74408,163
100,0,blank,0,-323,-105,74408,74593,185
100,0,blank,0,-323,-105,74593,74742,149
100,0,blank,0,-323,-105,74742,75006,264
100,0,blank,0,-323,-105,75006,75157,151
100,0,blank,0,-323,-105,75157,75333,176
100,0,blank,0,-323,-105,75333,75490,157
100,0,blank,0,-323,-105,75490,75641,151
100,0,blank,0,-323,-105,75641,75948,307
100,0,blank,0,-323,-105,75948,76251,303
100,0,blank,0,-323,-105,76251,76439,188
100,0,blank,0,-323,-105,76439,76465,26
100,0,blank,0,-323,-105,76465,76776,311
100,0,blank,0,-323,-105,76776,76812,36
100,0,blank,0,-323,-105,76812,77002,190
100,0,blank,0,-323,-105,77002,77122,120
100,0,blank,0,-323,-105,77122,77520,398
100,0,blank,0,-323,-105,77520,77633,113
100,0,blank,0,-323,-105,78729,78890,161
100,0,blank,0,-323,-105,78890,79019,129
100,0,blank,0,-323,-105,79019,79206,187
100,0,blank,0,-323,-105,79206,79368,162
100,0,blank,0,-323,-105,79368,79542,174
100,0,blank,0,-323,-105,79542,79724,182
100,0,blank,0,-323,-105,79724,79916,192
100,0,blank,0,-323,-105,79916,80094,178
100,0,blank,0,-323,-105,80094,80258,164
100,0,blank,0,-323,-105,80258,80393,135
100,0,blank,0,-323,-105,80393,80681,288
100,0,blank,0,-323,-105,80681,80862,181
100,0,blank,0,-323,-105,80862,80899,37
100,0,blank,0,-323,-105,80899,81098,199
100,0,blank,0,-323,-105,81098,81474,376
100,0,blank,0,-323,-105,81474,81796,322
100,0,blank,0,-323,-105,81796,81893,97
100,0,blank,0,-323,-105,81893,82155,262
100,0,blank,0,-323,-105,82155,82185,30
100,0,blank,0,-323,-105,82185,82384,199
100,0,blank,0,-323,-105,82384,82557,173
100,0,blank,0,-323,-105,82557,82618,61
100,0,blank,0,-323,-105,82618,82800,182
100,0,blank,0,-323,-105,82800,82990,190
100,0,blank,0,-323,-105,82990,83129,139
100,0,blank,0,-323,-105,83129,83358,229
100,0,blank,0,-323,-105,83358,83401,43
100,0,blank,0,-323,-105,83401,83701,300
100,28,index,195,258.5456,600.1932,83787,83895,108
100,24,strlen,160,215.8318,522.2469,83895,84096,201
100,24,strlen,160,207.6671,516.4119,84096,84120,24
100,0,blank,0,-323,-105,84715,84839,124
100,0,blank,0,-323,-105,84839,85014,175
100,0,blank,0,-323,-105,85014,85110,96
100,0,blank,0,-323,-105,85110,85401,291
100,0,blank,0,-323,-105,85401,85668,267
100,0,blank,0,-323,-105,85668,86014,346
100,0,blank,0,-323,-105,86014,86129,115
100,0,blank,0,-323,-105,86129,86353,224
100,0,blank,0,-323,-105,86353,86379,26
100,0,blank,0,-323,-105,86379,86793,414
100,0,blank,0,-323,-105,86793,87209,416
100,0,blank,0,-323,-105,87894,88076,182
100,0,blank,0,-323,-105,88076,88249,173
100,0,blank,0,-323,-105,88249,88397,148
100,0,blank,0,-323,-105,88397,88730,333
100,0,blank,0,-323,-105,88730,88999,269
100,0,blank,0,-323,-105,88999,89168,169
100,0,blank,0,-323,-105,89168,89280,112
100,0,blank,0,-323,-105,89280,89416,136
100,0,blank,0,-323,-105,89416,89595,179
100,0,blank,0,-323,-105,89595,89785,190
100,0,blank,0,-323,-105,89785,89888,103
100,0,blank,0,-323,-105,89888,90051,163
100,0,blank,0,-323,-105,90051,90229,178
100,0,blank,0,-323,-105,90229,90287,58
100,0,blank,0,-323,-105,90287,90577,290
100,0,blank,0,-323,-105,90577,90887,310
100,0,blank,0,-323,-105,90887,91302,415
100,0,blank,0,-323,-105,91302,91496,194
100,0,blank,0,-323,-105,91496,91627,131
100,0,blank,0,-323,-105,91627,91739,112
100,0,blank,0,-323,-105,91739,91902,163
100,0,blank,0,-323,-105,91902,92090,188
100,0,blank,0,-323,-105,92090,92293,203
100,0,blank,0,-323,-105,92293,92632,339
100,0,blank,0,-323,-105,92632,93077,445
100,0,blank,0,-323,-105,93077,93256,179
100,0,blank,0,-323,-105,93256,93399,143
100,0,blank,0,-323,-105,93399,93551,152
100,0,blank,0,-323,-105,93551,93759,208
100,0,blank,0,-323,-105,93759,93975,216
100,0,blank,0,-323,-105,93975,94157,182
100,0,blank,0,-323,-105,94157,94341,184
100,0,blank,0,-323,-105,94341,94380,39
100,0,blank,0,-323,-105,94648,94721,73
100,0,blank,0,-323,-105,94721,94944,223
100,0,blank,0,-323,-105,94944,95034,90
100,0,blank,0,-323,-105,95034,95227,193
100,0,blank,0,-323,-105,95227,95414,187
100,0,blank,0,-323,-105,95414,95590,176
100,0,blank,0,-323,-105,95590,95758,168
100,0,blank,0,-323,-105,95758,95822,64
100,0,blank,0,-323,-105,95822,95982,160
100,0,blank,0,-323,-105,95982,96171,189
100,0,blank,0,-323,-105,96171,96340,169
100,0,blank,0,-323,-105,96340,96641,301
100,0,blank,0,-323,-105,96641,96943,302
100,0,blank,0,-323,-105,96943,97276,333
100,0,blank,0,-323,-105,97276,97412,136
100,0,blank,0,-323,-105,97412,97669,257
100,0,blank,0,-323,-105,97669,97703,34
100,0,blank,0,-323,-105,97703,98246,543
100,0,blank,0,-323,-105,98246,98787,541
100,0,blank,0,-323,-105,98787,98974,187
100,0,blank,0,-323,-105,98974,99159,185
100,0,blank,0,-323,-105,99159,99255,96
100,0,blank,0,-323,-105,99255,99547,292
100,0,blank,0,-323,-105,99547,99919,372
100,0,blank,0,-323,-105,99919,100108,189
100,0,blank,0,-323,-105,100108,100316,208
100,0,blank,0,-323,-105,100316,100342,26
100,0,blank,0,-323,-105,100342,100868,526
100,0,blank,0,-323,-105,100868,101388,520
100,0,blank,0,-323,-105,101388,101563,175
100,0,blank,0,-323,-105,101563,101589,26
100,0,blank,0,-323,-105,101589,101869,280
100,0,blank,0,-323,-105,101869,102164,295
100,0,blank,0,-323,-105,102164,102341,177
100,0,blank,0,-323,-105,102341,102374,33
100,0,blank,0,-323,-105,102822,103084,262
100,0,blank,0,-323,-105,103084,103283,199
100,0,blank,0,-323,-105,103283,103480,197
100,0,blank,0,-323,-105,103480,104028,548
100,0,blank,0,-323,-105,104028,104154,126
100,0,blank,0,-323,-105,104154,104341,187
100,0,blank,0,-323,-105,104341,104621,280
100,0,blank,0,-323,-105,104621,104912,291
100,0,blank,0,-323,-105,104912,105394,482
100,0,blank,0,-323,-105,105394,105461,67
100,0,blank,0,-323,-105,105461,105889,428
100,0,blank,0,-323,-105,106239,106474,235
100,0,blank,0,-323,-105,106474,106504,30
100,0,blank,0,-323,-105,106504,107037,533
100,0,blank,0,-323,-105,107037,107573,536
100,0,blank,0,-323,-105,107573,107710,137
100,0,blank,0,-323,-105,107710,107967,257
100,0,blank,0,-323,-105,107967,108002,35
100,0,blank,0,-323,-105,108002,108596,594
100,0,blank,0,-323,-105,108596,108747,151
100,0,blank,0,-323,-105,108747,108929,182
100,0,blank,0,-323,-105,108929,108955,26
100,0,blank,0,-323,-105,108955,109375,420
100,0,blank,0,-323,-105,109375,109794,419
100,0,blank,0,-323,-105,110584,110768,184
100,0,blank,0,-323,-105,110768,110845,77
100,0,blank,0,-323,-105,110845,111008,163
100,0,blank,0,-323,-105,111008,111324,316
100,0,blank,0,-323,-105,111324,112601,1277
100,0,blank,0,-323,-105,112601,112782,181
100,0,blank,0,-323,-105,112782,112957,175
100,0,blank,0,-323,-105,112957,113196,239
100,0,blank,0,-323,-105,113196,113269,73
100,0,blank,0,-323,-105,113269,113551,282
100,0,blank,0,-323,-105,113551,113640,89
100,0,blank,0,-323,-105,113640,113906,266
100,0,blank,0,-323,-105,113906,114928,1022
100,0,blank,0,-323,-105,114928,115101,173
100,0,blank,0,-323,-105,115101,115273,172
100,0,blank,0,-323,-105,115273,115431,158
100,0,blank,0,-323,-105,115431,115595,164
100,0,blank,0,-323,-105,115595,115773,178
100,0,blank,0,-323,-105,115773,115836,63
100,0,blank,0,-323,-105,115836,116108,272
100,0,blank,0,-323,-105,116108,116204,96
100,0,blank,0,-323,-105,116204,116523,319
100,0,blank,0,-323,-105,116523,116660,137
100,0,blank,0,-323,-105,116660,116794,134
100,0,blank,0,-323,-105,116794,117293,499
100,0,blank,0,-323,-105,117293,117481,188
100,0,blank,0,128.7832,487.4072,117563,117591,28
100,0,blank,0,-323,-105,118152,118218,66
100,0,blank,0,-323,-105,118218,118436,218
100,0,blank,0,-323,-105,118436,118648,212
100,0,blank,0,-323,-105,118648,118827,179
100,0,blank,0,-323,-105,118827,118889,62
100,0,blank,0,-323,-105,118889,119095,206
100,0,blank,0,-323,-105,119095,119157,62
100,0,blank,0,-323,-105,119518,119774,256
100,0,blank,0,-323,-105,119774,119810,36
100,0,blank,0,-323,-105,119810,120050,240
100,0,blank,0,-323,-105,120050,120169,119
100,0,blank,0,-323,-105,120169,120409,240
100,0,blank,0,-323,-105,120409,120647,238
100,0,blank,0,-323,-105,120647,120672,25
100,0,blank,0,-323,-105,120672,121146,474
100,0,blank,0,-323,-105,121146,121209,63
100,0,blank,0,-323,-105,121209,121502,293
100,0,blank,0,-323,-105,121502,121534,32
100,0,blank,0,-323,-105,121534,122129,595
100,0,blank,0,-323,-105,122129,122719,590
100,0,blank,0,-323,-105,122719,122889,170
100,0,blank,0,-323,-105,122889,123163,274
100,0,blank,0,-323,-105,123163,123211,48
100,0,blank,0,-323,-105,123211,123397,186
100,0,blank,0,-323,-105,123397,123569,172
100,0,blank,0,-323,-105,123569,123865,296
100,0,blank,0,-323,-105,123865,123982,117
100,0,blank,0,-323,-105,123982,124173,191
100,0,blank,0,-323,-105,124173,124504,331
100,0,blank,0,-323,-105,124504,124831,327
100,0,blank,0,-323,-105,124831,124885,54
100,0,blank,0,-323,-105,124885,125200,315
100,0,blank,0,-323,-105,125200,125383,183
100,0,blank,0,-323,-105,125383,125640,257
101,0,blank,0,-323,-105,126462,126516,54
101,0,blank,0,-323,-105,126516,126895,379
101,0,blank,0,-323,-105,126895,126995,100
101,0,blank,0,-323,-105,126995,127184,189
101,0,blank,0,-323,-105,127184,127353,169
101,0,blank,0,-323,-105,127353,127705,352
101,0,blank,0,-323,-105,127705,128107,402
101,0,blank,0,-323,-105,128107,128208,101
101,0,blank,0,-323,-105,128208,128420,212
101,0,blank,0,-323,-105,128420,128498,78
101,0,blank,0,-323,-105,128498,128842,344
101,0,blank,0,-323,-105,128842,129082,240
101,0,blank,0,-323,-105,129082,129148,66
101,0,blank,0,-323,-105,129148,129485,337
101,0,blank,0,-323,-105,129485,129773,288
101,0,blank,0,-323,-105,129858,129957,99
101,0,blank,0,110.335733333333,409.432133333333,129998,130162,164
101,36,char,230,143.7608,427.6147,130162,130205,43
101,0,blank,0,-323,-105,130543,130687,144
101,0,blank,0,-323,-105,130687,130771,84
101,0,blank,0,-323,-105,130771,130963,192
101,34,),219,157.1683,387.51828,131003,131190,187
101,34,"\n",218,146.939066666667,388.286933333333,131190,131309,119
101,0,blank,0,177.5233,415.7656,131309,132151,842
101,0,blank,0,169.24134,437.83592,132151,132342,191
101,0,blank,0,165.7265,430.389733333333,132342,132450,108
101,36,str_rem,226,178.009525,432.3797,132492,132641,149
101,0,blank,0,159.3095,403.547,132641,133093,452
101,0,blank,0,134.06124,419.5846,133093,133280,187
101,0,blank,0,133.4189,413.265775,133280,133428,148
101,0,blank,0,174.3413,414.7972,133428,133777,349
101,28,"in=%d",193,183.172133333333,248.936683333333,133854,134021,167
101,0,blank,0,162.76304,406.92614,134109,134302,193
101,0,blank,0,153.573733333333,403.619766666667,134302,134416,114
101,0,blank,0,160.3868,408.9409,134416,134806,390
101,34,"\n",218,143.930666666667,399.585733333333,134806,134930,124
101,0,blank,0,142.51785,422.997,134930,135125,195
101,39,strlen,258,212.384,509.1208,135125,135250,125
101,0,blank,0,164.1745,421.534866666667,135250,135422,172
101,0,blank,0,147.98615,406.6672,135422,135584,162
101,36,char,230,152.808325,428.760175,135584,135739,155
101,0,blank,0,152.6751,421.916825,135739,135899,160
101,36,char,230,155.37762,424.51244,135899,136094,195
101,0,blank,0,170.03878,419.46574,136094,136283,189
101,0,blank,0,142.0228,411.23998,136283,136481,198
101,0,blank,0,189.39046,377.81936,136481,136671,190
101,0,blank,0,181.5044,374.10638,136671,136870,199
101,36,char,230,156.65882,424.48876,136870,137063,193
101,36,str_rem,226,180.1533,439.975733333333,137063,137223,160
101,0,blank,0,158.13655,401.386475,137223,137379,156
101,0,blank,0,175.72286,406.08668,137424,137621,197
101,0,blank,0,195.45755,392.011125,137621,137780,159
101,0,blank,0,172.94895,427.9759,137780,137859,79
101,0,blank,0,144.82342,417.84776,137903,138100,197
101,0,blank,0,148.833025,421.3501,138100,138259,159
101,0,blank,0,173.874,418.1814,138259,138458,199
101,36,str_rem,226,191.474,432.7298,138458,138654,196
101,34,;,220,166.9176,391.839833333333,138654,138781,127
101,34,"\n",218,148.79655,385.478925,138781,138967,186
101,34,;,220,165.455,395.278633333333,138967,139091,124
101,36,char,230,160.49645,423.4261,139091,139284,193
101,0,blank,0,190.81316,411.37802,139284,139482,198
101,0,blank,0,206.87084,416.91736,139482,139677,195
101,36,str_rem,226,205.351425,424.418275,139677,139836,159
101,36,str_rem,226,204.51125,432.18495,139836,139994,158
101,0,blank,0,184.085833333333,407.952666666667,139994,140155,161
101,0,blank,0,168.6852,408.49914,140155,140354,199
101,0,blank,0,169.64026,431.53312,140354,140547,193
101,0,blank,0,164.95075,425.641625,140547,140704,157
101,36,char,230,148.684,429.30305,140704,140862,158
101,0,blank,0,134.252775,464.44545,140862,141061,199
101,0,blank,0,125.09678,502.58734,141061,141251,190
101,0,blank,0,125.058366666667,526.0747,141251,141374,123
101,0,blank,0,132.0825,464.0245,141374,141453,79
101,34,),219,158.65438,397.49838,141528,141724,196
101,0,blank,0,194.737125,445.686075,141724,141880,156
101,0,blank,0,166.992025,432.150525,141880,142039,159
101,0,blank,0,186.284475,409.278825,142039,142199,160
101,0,blank,0,175.103925,418.22425,142199,142355,156
101,0,blank,0,191.4675,422.912125,142355,142514,159
101,0,blank,0,169.6347,422.2742,142514,142799,285
101,0,blank,0,212.5682,413.55912,142799,142991,192
101,0,blank,0,200.32665,400.184425,142991,143151,160
101,0,blank,0,214.8074,400.30515,143151,143272,121
101,0,blank,0,206.0938,353.503,143272,143462,190
101,0,blank,0,204.1569,373.7169,143462,143505,43
101,0,blank,0,202.6636,391.483,143505,143818,313
101,0,blank,0,150.573675,407.7544,143818,143977,159
101,26,tolower,174,208.897566666667,212.824616666667,144010,144191,181
101,28,"in=%d",193,197.0136,254.9121,144191,144223,32
101,0,blank,0,181.09198,395.63402,144290,144464,174
101,0,blank,0,199.56225,389.33465,144464,144551,87
101,0,blank,0,232.1423,354.6635,144551,145141,590
101,0,blank,0,226.048325,419.049575,145141,145300,159
101,0,blank,0,219.410225,400.0675,145300,145499,199
101,0,blank,0,236.8592,396.618675,145499,145661,162
101,0,blank,0,228.41938,419.60632,145661,145859,198
101,0,blank,0,232.4725,415.90395,145859,146016,157
101,0,blank,0,220.2704,416.6874,146016,146213,197
101,0,blank,0,241.49475,393.308825,146213,146370,157
101,0,blank,0,201.5217,411.7162,146370,146567,197
101,0,blank,0,171.04985,400.011225,146567,146725,158
101,0,blank,0,176.693775,381.53645,146725,146886,161
101,34,;,220,167.322425,396.59145,146886,147050,164
101,0,blank,0,193.8611,224.5902,147092,147128,36
101,21,comma,140,260.50275,111.818,147188,147347,159
101,0,blank,0,250.784566666667,77.6864,147347,147541,194
101,21,comma,140,260.899725,112.59455,147541,147665,124
101,27,str,184,179.35795,230.2052,147758,147955,197
101,26,i,178,124.0064,222.8973,147955,148120,165
101,27,index,182,111.577233333333,232.093533333333,148120,148242,122
101,0,blank,0,-323,-105,148284,148409,125
101,0,blank,0,205.983566666667,392.153366666667,148488,148646,158
101,0,blank,0,169.30925,405.05855,148646,148803,157
101,0,blank,0,162.5728,398.6823,148803,148958,155
101,36,char,230,140.543475,443.50175,149035,149222,187
101,34,"\n",218,145.653666666667,385.421866666667,149222,149378,156
101,26,tolower,174,176.23286,214.68582,149419,149603,184
101,0,blank,0,185.684,225.11195,149603,149784,181
101,28,"in=%d",193,181.3239,252.6623,149784,149954,170
101,26,tolower,174,237.4985,204.9881,149954,150041,87
101,0,blank,0,122.42735,525.9468,150148,150204,56
101,34,"\n",218,139.0214,399.9455,150269,150384,115
101,0,blank,0,192.7833,365.0511,150652,150750,98
101,0,blank,0,343.99585,592.2023,150977,151048,71
101,0,blank,0,402.1439,324.6165,151543,151580,37
101,36,list,236,444.52345,432.82685,151693,151748,55
101,0,blank,0,441.30825,618.53515,151901,152012,111
101,36,],238,376.78655,431.8518,152686,152875,189
101,0,blank,0,313.3708,414.513,152875,153221,346
101,36,char,230,316.359,423.753,153221,153378,157
101,0,blank,0,-323,-105,153857,154013,156
101,0,blank,0,-323,-105,154064,154220,156
101,0,blank,0,-323,-105,154220,154417,197
101,0,blank,0,-323,-105,154417,154607,190
101,0,blank,0,143.226,376.71905,154666,154738,72
101,0,blank,0,-323,-105,154772,154955,183
101,0,blank,0,-323,-105,154955,155134,179
101,0,blank,0,-323,-105,155134,155303,169
101,0,blank,0,-323,-105,155303,155340,37
101,0,blank,0,-323,-105,155340,155771,431
101,0,blank,0,-323,-105,155771,156068,297
101,0,blank,0,-323,-105,156068,156157,89
101,0,blank,0,-323,-105,156157,156356,199
101,0,blank,0,-323,-105,156356,156546,190
101,0,blank,0,-323,-105,156546,156732,186
101,0,blank,0,-323,-105,156732,156924,192
101,0,blank,0,-323,-105,156924,156956,32
101,0,blank,0,-323,-105,156956,157172,216
101,0,blank,0,-323,-105,157172,157384,212
101,0,blank,0,-323,-105,157384,157640,256
101,0,blank,0,-323,-105,157640,158084,444
101,0,blank,0,-323,-105,158084,158276,192
101,0,blank,0,-323,-105,158276,158486,210
101,0,blank,0,-323,-105,158486,158517,31
101,0,blank,0,-323,-105,158517,159117,600
101,0,blank,0,-323,-105,159117,159715,598
101,0,blank,0,-323,-105,159715,159904,189
101,0,blank,0,-323,-105,159904,160085,181
101,0,blank,0,-323,-105,160085,160282,197
101,0,blank,0,-323,-105,160282,160307,25
101,0,blank,0,-323,-105,160307,160878,571
101,0,blank,0,-323,-105,160878,161443,565
101,0,blank,0,-323,-105,161443,161634,191
101,0,blank,0,-323,-105,161634,161673,39
101,0,blank,0,-323,-105,161673,161838,165
101,0,blank,0,-323,-105,161838,161876,38
101,0,blank,0,-323,-105,161876,162109,233
101,0,blank,0,-323,-105,162109,162295,186
101,0,blank,0,-323,-105,162295,162609,314
101,0,blank,0,-323,-105,162609,162935,326
101,0,blank,0,-323,-105,162935,163386,451
101,0,blank,0,-323,-105,163386,163745,359
101,0,blank,0,-323,-105,163745,163905,160
101,0,blank,0,-323,-105,163905,164135,230
101,0,blank,0,-323,-105,164135,164263,128
101,0,blank,0,-323,-105,164263,164363,100
101,0,blank,0,-323,-105,164363,164627,264
101,0,blank,0,-323,-105,164627,164958,331
101,0,blank,0,-323,-105,164958,165337,379
101,0,blank,0,-323,-105,165337,165491,154
101,0,blank,0,-323,-105,165491,165691,200
101,0,blank,0,-323,-105,165691,166029,338
101,0,blank,0,-323,-105,166029,166117,88
101,0,blank,0,-323,-105,166117,166387,270
101,0,blank,0,-323,-105,166387,166535,148
101,0,blank,0,-323,-105,166535,166873,338
101,0,blank,0,-323,-105,166873,167096,223
101,0,blank,0,-323,-105,167096,167335,239
101,0,blank,0,-323,-105,167335,167367,32
101,0,blank,0,-323,-105,167367,167869,502
101,0,blank,0,-323,-105,167869,168116,247
101,0,blank,0,-323,-105,168116,168243,127
101,0,blank,0,-323,-105,168243,168383,140
101,0,blank,0,-323,-105,168383,168488,105
101,0,blank,0,-323,-105,168488,168598,110
101,0,blank,0,-323,-105,168598,168904,306
101,0,blank,0,-323,-105,168904,169032,128
101,0,blank,0,-323,-105,169032,169197,165
101,0,blank,0,-323,-105,169197,169512,315
101,0,blank,0,-323,-105,169512,169683,171
101,0,blank,0,-323,-105,169683,169900,217
101,0,blank,0,-323,-105,169900,170062,162
101,0,blank,0,-323,-105,170062,170227,165
101,0,blank,0,-323,-105,170227,170354,127
101,0,blank,0,-323,-105,170354,170547,193
101,0,blank,0,-323,-105,170547,170749,202
101,0,blank,0,-323,-105,170749,170817,68
101,0,blank,0,-323,-105,170817,171172,355
101,0,blank,0,-323,-105,171172,171339,167
101,0,blank,0,-323,-105,171339,171564,225
101,0,blank,0,-323,-105,171564,171683,119
101,0,blank,0,-323,-105,171683,171783,100
101,0,blank,0,-323,-105,171783,172000,217
101,0,blank,0,-323,-105,172000,172182,182
101,0,blank,0,-323,-105,172182,172236,54
101,0,blank,0,-323,-105,172236,172452,216
101,0,blank,0,-323,-105,172452,172674,222
101,0,blank,0,-323,-105,172674,172845,171
101,0,blank,0,-323,-105,172845,173030,185
101,0,blank,0,-323,-105,173030,173192,162
101,0,blank,0,-323,-105,173192,173303,111
101,0,blank,0,-323,-105,173303,173473,170
101,0,blank,0,-323,-105,173473,173645,172
101,0,blank,0,-323,-105,173645,173980,335
101,0,blank,0,-323,-105,173980,174222,242
101,0,blank,0,220.1588,655.8802,174250,174275,25
101,0,blank,0,-323,-105,174773,174881,108
101,0,blank,0,-323,-105,174881,175100,219
101,0,blank,0,-323,-105,175100,175126,26
101,0,blank,0,-323,-105,175126,175477,351
101,0,blank,0,-323,-105,175477,175662,185
101,0,blank,0,-323,-105,175662,176089,427
101,0,blank,0,-323,-105,176089,176288,199
101,0,blank,0,-323,-105,176288,176419,131
101,0,blank,0,-323,-105,176419,176613,194
101,0,blank,0,-323,-105,176613,176873,260
101,0,blank,0,-323,-105,176873,177056,183
101,0,blank,0,-323,-105,177056,177193,137
101,0,blank,0,-323,-105,177193,177447,254
101,0,blank,0,-323,-105,177447,177759,312
101,0,blank,0,-323,-105,177759,178101,342
101,0,blank,0,-323,-105,178101,178165,64
101,0,blank,0,-323,-105,178165,178322,157
101,0,blank,0,-323,-105,178322,178507,185
101,0,blank,0,-323,-105,178507,178661,154
101,0,blank,0,-323,-105,178661,178859,198
101,0,blank,0,-323,-105,178859,178982,123
101,0,blank,0,-323,-105,178982,179130,148
101,0,blank,0,-323,-105,179130,179308,178
101,0,blank,0,-323,-105,179308,179470,162
101,0,blank,0,-323,-105,179470,179655,185
101,0,blank,0,-323,-105,179655,179845,190
101,0,blank,0,-323,-105,179845,180282,437
101,0,blank,0,-323,-105,180282,180312,30
101,0,blank,0,-323,-105,180312,180616,304
101,0,blank,0,-323,-105,180616,180977,361
101,0,blank,0,-323,-105,180977,181174,197
101,0,blank,0,-323,-105,181174,181222,48
101,0,blank,0,-323,-105,181222,181494,272
101,0,blank,0,-323,-105,181494,181640,146
101,0,blank,0,-323,-105,181640,181835,195
101,0,blank,0,-323,-105,181835,181901,66
101,0,blank,0,-323,-105,181901,182113,212
101,0,blank,0,-323,-105,182113,182323,210
101,0,blank,0,-323,-105,182323,182911,588
101,0,blank,0,-323,-105,182911,183096,185
101,0,blank,0,-323,-105,183096,183277,181
101,0,blank,0,-323,-105,183277,183400,123
101,0,blank,0,-323,-105,183400,184091,691
101,0,blank,0,-323,-105,184091,184237,146
101,0,blank,0,-323,-105,184237,184361,124
101,0,blank,0,-323,-105,184361,184512,151
101,0,blank,0,-323,-105,184512,184655,143
101,0,blank,0,-323,-105,184655,184999,344
102,0,blank,0,-323,-105,185653,185806,153
102,0,blank,0,-323,-105,185806,186083,277
102,0,blank,0,-323,-105,186083,186165,82
102,0,blank,0,-323,-105,186165,186290,125
102,0,blank,0,-323,-105,186290,186433,143
102,0,blank,0,-42.9694,394.8951,186712,186828,116
102,0,blank,0,74.5165,544.0069,186891,186916,25
102,0,blank,0,-323,-105,186947,187131,184
102,0,blank,0,-323,-105,187131,187310,179
102,0,blank,0,-323,-105,187310,187409,99
102,0,blank,0,-323,-105,187409,187717,308
102,0,blank,0,-323,-105,187717,188022,305
102,0,blank,0,-323,-105,188022,188080,58
102,0,blank,0,-323,-105,188080,188233,153
102,0,blank,0,-323,-105,188233,188393,160
102,0,blank,0,-323,-105,188393,188577,184
102,0,blank,0,-323,-105,188577,188765,188
102,0,blank,0,-323,-105,188765,188869,104
102,0,blank,0,-323,-105,188869,189066,197
102,0,blank,0,-323,-105,189066,189213,147
102,0,blank,0,-323,-105,189379,189586,207
102,0,blank,0,-323,-105,189586,189758,172
102,0,blank,0,-323,-105,189758,190108,350
102,0,blank,0,-323,-105,190108,190468,360
102,0,blank,0,-323,-105,190468,190663,195
102,0,blank,0,-323,-105,190663,190825,162
102,0,blank,0,-323,-105,190825,190969,144
102,0,blank,0,-323,-105,190969,191153,184
102,0,blank,0,-323,-105,191153,191321,168
102,0,blank,0,-323,-105,191321,191426,105
102,0,blank,0,-323,-105,191426,191604,178
102,0,blank,0,-323,-105,191604,191766,162
102,0,blank,0,-323,-105,191766,192054,288
102,0,blank,0,-323,-105,192054,192304,250
102,0,blank,0,-323,-105,192304,192467,163
102,0,blank,0,-323,-105,192467,192659,192
102,0,blank,0,-323,-105,192659,192838,179
102,0,blank,0,-323,-105,192838,193033,195
102,0,blank,0,-323,-105,193033,193064,31
102,0,blank,0,-323,-105,193064,193516,452
102,0,blank,0,-323,-105,193516,193587,71
102,0,blank,0,-323,-105,193587,193761,174
102,0,blank,0,-323,-105,193761,193835,74
102,0,blank,0,-323,-105,193835,194008,173
102,0,blank,0,-323,-105,194008,194236,228
102,0,blank,0,-323,-105,194236,194405,169
102,0,blank,0,-323,-105,194405,194601,196
102,0,blank,0,-323,-105,194601,194791,190
102,0,blank,0,-323,-105,194791,194934,143
102,0,blank,0,-323,-105,194934,195112,178
102,0,blank,0,-323,-105,195112,195294,182
102,0,blank,0,-323,-105,195294,195469,175
102,0,blank,0,-323,-105,195469,195645,176
102,0,blank,0,-323,-105,195645,195822,177
102,0,blank,0,-323,-105,195822,195957,135
102,0,blank,0,-323,-105,195957,196135,178
102,0,blank,0,-323,-105,196135,196997,862
102,0,blank,0,-323,-105,196997,197285,288
102,0,blank,0,-323,-105,197285,197471,186
102,0,blank,0,-323,-105,197471,197653,182
102,0,blank,0,-323,-105,197653,197828,175
102,0,blank,0,-323,-105,197828,198014,186
102,0,blank,0,-323,-105,198014,198368,354
102,0,blank,0,-323,-105,198368,198643,275
102,0,blank,0,-323,-105,198643,198837,194
102,0,blank,0,-323,-105,198837,198968,131
102,0,blank,0,-323,-105,198968,199160,192
102,0,blank,0,-323,-105,199160,199191,31
102,0,blank,0,-323,-105,199191,199375,184
102,0,blank,0,-323,-105,199375,199575,200
102,0,blank,0,-323,-105,199575,199749,174
102,0,blank,0,-323,-105,199749,199877,128
102,0,blank,0,-323,-105,199877,199967,90
102,0,blank,0,-323,-105,199967,200196,229
102,0,blank,0,-323,-105,200196,200435,239
102,0,blank,0,-323,-105,200435,200761,326
102,0,blank,0,-323,-105,200761,200959,198
102,0,blank,0,-323,-105,200959,201232,273
102,0,blank,0,-323,-105,201232,201258,26
102,0,blank,0,-323,-105,201258,201523,265
102,0,blank,0,-323,-105,201523,201781,258
102,0,blank,0,-323,-105,201781,201969,188
102,0,blank,0,-323,-105,201969,202185,216
102,0,blank,0,-323,-105,202185,202287,102
102,0,blank,0,-323,-105,202287,202549,262
102,0,blank,0,-323,-105,202549,202743,194
102,0,blank,0,-323,-105,202743,202920,177
102,0,blank,0,-323,-105,202920,203040,120
102,0,blank,0,-323,-105,203040,203199,159
102,0,blank,0,-323,-105,203199,203334,135
102,0,blank,0,-323,-105,203334,203656,322
102,0,blank,0,-323,-105,203656,203801,145
102,0,blank,0,-323,-105,203801,204089,288
102,0,blank,0,-323,-105,204089,204172,83
102,0,blank,0,-323,-105,204172,204370,198
102,0,blank,0,-323,-105,204370,204573,203
102,0,blank,0,-323,-105,204573,204713,140
102,0,blank,0,-323,-105,204713,204843,130
