Frameno_fix,lineno_fix,Tokenname_fix,tokens_id,gaze_X_fix,gaze_Y_fix,timestamp_fix_start,timestamp_fix_end,time_duration
100,0,blank,0,129.5898,-105.0022,3351,3459,108
100,0,blank,0,131.90075,-31.9603,3459,3635,176
100,0,blank,0,89.45714,-76.66854,3635,3787,152
100,0,blank,0,506.2379,-53.30155,3919,3994,75
100,0,blank,0,614.6886,-84.8117,4019,4044,25
100,0,blank,0,858.66,-42.8658166666667,4126,4318,192
100,0,blank,0,855.4076,-41.3956,4318,4506,188
100,0,blank,0,834.264833333333,-34.5159,4536,4714,178
100,0,blank,0,842.828,-24.75704,4714,4895,181
100,0,blank,0,836.561,-11.6127,4895,4920,25
100,2,.,23,155.657375,31.689225,5058,5213,155
100,0,blank,0,153.568733333333,-16.3043,5213,5314,101
100,0,blank,0,168.1898,8.4727,5314,5449,135
100,0,blank,0,40.533125,-11.296325,5498,5653,155
100,0,blank,0,45.118,-7.51455,5653,5836,183
100,0,blank,0,36.6601,-13.176825,5836,5980,144
100,1,/,18,8.14600000000002,0.00830000000000553,6043,6069,26
100,0,blank,0,-323,-105,6266,6428,162
100,0,blank,0,-323,-105,6428,6607,179
100,0,blank,0,-323,-105,6607,6783,176
100,0,blank,0,-323,-105,6783,6960,177
100,0,blank,0,-323,-105,6960,6999,39
100,0,blank,0,39.4684,-46.2768,7370,7395,25
100,0,blank,0,-323,-105,7594,7881,287
100,0,blank,0,-323,-105,7881,8043,162
100,0,blank,0,-323,-105,8043,8243,200
100,0,blank,0,632.8193,-103.84455,8313,8389,76
100,0,blank,0,455.7785,541.4562,8414,8487,73
100,0,blank,0,-323,-105,8508,8706,198
100,0,blank,0,-323,-105,8706,8901,195
100,0,blank,0,-323,-105,8901,9076,175
100,0,blank,0,-323,-105,9076,9252,176
100,0,blank,0,-323,-105,9252,9430,178
100,0,blank,0,-323,-105,9430,9520,90
100,0,blank,0,73.88692,-6.11918,9759,9932,173
100,0,blank,0,94.8794714285714,-4.61202857142857,9932,10131,199
100,0,blank,0,104.107516666667,-7.75535,10131,10306,175
100,1,Program,4,99.5855666666667,9.81683333333334,10306,10479,173
100,2,<,21,102.9299,27.98145,10479,10653,174
100,1,*,17,16.9781666666667,19.5519,10653,10827,174
100,1,*,17,14.6673833333333,11.1229666666667,10827,11005,178
100,1,Program,4,74.3041333333333,22.4105666666667,11005,11185,180
100,2,stdio,22,104.856916666667,29.9096333333333,11185,11364,179
100,3,<,28,100.979866666667,48.7921,11364,11541,177
100,3,string,29,107.710633333333,58.1616,11541,11715,174
100,2,h,24,168.5663,39.095,11715,11743,28
100,0,blank,0,-323,-105,11802,11906,104
100,0,blank,0,38.19726,571.07274,12007,12189,182
100,0,blank,0,30.5347,567.16965,12189,12303,114
100,0,blank,0,53.5001428571429,558.158757142857,12359,12554,195
100,0,blank,0,59.50874,553.8674,12554,12695,141
100,0,blank,0,52.50158,592.51558,12802,12976,174
100,0,blank,0,119.424,707.4713,12976,13002,26
100,0,blank,0,58.4454666666667,559.89975,13032,13215,183
100,0,blank,0,38.1673,511.5486,13215,13241,26
100,0,blank,0,71.2691166666667,612.712783333333,13275,13462,187
100,0,blank,0,91.0774166666667,641.99305,13462,13635,173
100,31,index,209,175.19785,670.0844,13635,13691,56
100,29,!,200,127.6646,622.0906,13718,13745,27
100,0,blank,0,86.884,757.6727,13832,13859,27
100,0,blank,0,104.5135,685.8425,13887,13914,27
100,0,blank,0,101.160675,641.19825,13941,14055,114
100,0,blank,0,40.5861714285714,594.711542857143,14082,14280,198
100,0,blank,0,43.3254166666667,573.081483333333,14280,14453,173
100,28,printf,191,113.5234,604.50804,14515,14694,179
100,28,printf,191,108.838133333333,616.726283333333,14694,14875,181
100,31,a,207,125.4748,668.3199,14904,14935,31
100,27,index,182,107.17014,581.4172,14968,15128,160
100,0,blank,0,74.658,593.7605,15128,15191,63
100,0,blank,0,30.51816,594.4215,15312,15465,153
100,0,blank,0,36.654525,596.372775,15465,15630,165
100,0,blank,0,79.17992,615.5595,15692,15842,150
100,0,blank,0,137.8244,735.6776,15899,15929,30
100,0,blank,0,60.8269,578.644,15960,15988,28
100,0,blank,0,63.2622,610.6155,16047,16075,28
100,27,index,182,126.501333333333,583.0744,16137,16224,87
100,28,printf,191,85.9249,612.5998,16292,16318,26
100,26,str,176,106.101966666667,569.307416666667,16383,16582,199
100,0,blank,0,60.8689,536.0782,16582,16619,37
100,0,blank,0,102.2242,737.4681,16680,16710,30
100,0,blank,0,-323,-105,16744,16858,114
100,0,blank,0,-323,-105,16858,16963,105
100,5,stdlib,43,145.230557142857,93.6040285714286,16998,17192,194
100,5,stdlib,43,154.29962,96.0465,17192,17365,173
100,0,blank,0,32.7216666666667,112.941733333333,17396,17575,179
100,6,define,48,34.85065,117.849133333333,17575,17756,181
100,6,define,48,18.6964166666667,114.10225,17756,17936,180
100,6,define,48,46.0008,118.282816666667,17936,18115,179
100,0,blank,0,31.1243,162.9356,18115,18295,180
100,0,blank,0,39.78252,168.87836,18295,18446,151
100,0,blank,0,111.365014285714,158.670171428571,18506,18701,195
100,0,blank,0,94.4079714285714,163.517614285714,18701,18898,197
100,0,blank,0,109.133883333333,176.873033333333,18898,19070,172
100,9,str1,57,122.275,189.269016666667,19070,19251,181
100,0,blank,0,171.93994,160.6382,19281,19455,174
100,0,blank,0,190.143916666667,162.53675,19455,19629,174
100,0,blank,0,-323,-105,19661,19793,132
100,0,blank,0,126.8896,164.2887,19837,19898,61
100,0,blank,0,140.814283333333,177.730933333333,19972,20135,163
100,0,blank,0,143.537083333333,161.093716666667,20164,20336,172
100,10,CHAR_SIZE,70,152.6454,206.3928,20336,20423,87
100,0,blank,0,124.6414,177.419983333333,20450,20623,173
100,0,blank,0,100.1294,160.7721,20623,20802,179
100,0,blank,0,161.894033333333,171.357416666667,20832,21007,175
100,0,blank,0,183.935333333333,171.609566666667,21007,21125,118
100,0,blank,0,184.4949,152.8852,21125,21312,187
100,0,blank,0,208.9497,171.8035,21312,21506,194
100,0,blank,0,222.032866666667,167.368816666667,21506,21688,182
100,0,blank,0,213.183416666667,167.509016666667,21688,21868,180
100,0,blank,0,139.21835,168.413716666667,21868,22043,175
100,0,blank,0,121.29255,171.255033333333,22043,22218,175
100,0,blank,0,158.6118,176.485666666667,22218,22390,172
100,0,blank,0,178.246783333333,175.32925,22390,22564,174
100,9,str2,62,207.56105,180.7392,22564,22737,173
100,0,blank,0,163.2914,146.965983333333,22737,22910,173
100,0,blank,0,149.27645,139.25405,22910,23025,115
100,0,blank,0,106.00272,166.81684,23053,23227,174
100,9,char,56,60.0327,192.27825,23227,23407,180
100,0,blank,0,40.2066666666667,198.221066666667,23407,23580,173
100,9,char,56,63.47485,189.365983333333,23580,23755,175
100,10,a1,68,98.7113166666667,207.175316666667,23755,23928,173
100,0,blank,0,92.1437,199.9762,23928,23956,28
100,0,blank,0,91.3325833333333,194.356766666667,24042,24215,173
100,0,blank,0,138.388933333333,171.187283333333,24215,24390,175
100,0,blank,0,136.94234,160.81086,24390,24537,147
100,0,blank,0,292.0202,261.8145,24566,24595,29
100,0,blank,0,195.823233333333,147.431633333333,24624,24800,176
100,4,ctype,36,124.3804,84.8149166666667,24800,24977,177
100,4,<,35,93.6889666666667,87.4794333333333,24977,25149,172
100,0,blank,0,91.61705,94.23865,25149,25322,173
100,6,define,48,28.9451,123.5778,25322,25521,199
100,0,blank,0,36.66185,151.989483333333,25521,25695,174
100,0,blank,0,88.5749833333333,156.818083333333,25695,25867,172
100,10,CHAR_SIZE,70,116.0262,206.828042857143,25867,26065,198
100,0,blank,0,128.316166666667,163.970616666667,26065,26243,178
100,0,blank,0,171.589316666667,158.612783333333,26243,26416,173
100,0,blank,0,194.861616666667,162.094616666667,26416,26588,172
100,10,CHAR_SIZE,70,131.034716666667,214.3576,26588,26762,174
100,0,blank,0,75.2014666666667,200.382,26762,26940,178
100,9,char,56,64.1255833333333,180.507216666667,26940,27113,173
100,0,blank,0,40.7992333333333,177.684766666667,27113,27285,172
100,9,char,56,54.2580333333333,185.15865,27285,27458,173
100,9,char,56,65.083,195.55346,27458,27603,145
100,0,blank,0,50.7626666666667,469.82835,27632,27808,176
100,0,blank,0,26.4989666666667,436.92375,27808,27984,176
100,0,blank,0,32.51105,478.5721,27984,28158,174
100,23,int,147,49.9352166666667,491.014516666667,28158,28332,174
100,0,blank,0,138.4869,438.5945,28332,28361,29
100,0,blank,0,-323,-105,28389,28518,129
100,9,str2,62,223.1797,187.879128571429,28544,28731,187
100,9,str2,62,209.189616666667,194.622416666667,28731,28905,174
100,0,blank,0,176.630116666667,177.506866666667,28905,29078,173
100,0,blank,0,138.812916666667,177.522983333333,29078,29250,172
100,12,"Enterstring1:",85,139.321433333333,256.532566666667,29314,29403,89
100,0,blank,0,166.9138,201.5289,29431,29460,29
100,0,blank,0,84.41455,188.53855,29517,29693,176
100,0,blank,0,106.658075,175.511875,29693,29807,114
100,0,blank,0,99.9615,177.643533333333,29835,29919,84
100,0,blank,0,663.376216666667,173.8688,29975,30150,175
100,0,blank,0,636.20025,192.50435,30150,30208,58
100,0,blank,0,978.43975,317.44235,30264,30380,116
100,0,blank,0,1031.866,231.5183,30435,30610,175
100,0,blank,0,1007.139,250.6853,30610,30742,132
100,0,blank,0,1036.13266666667,233.619466666667,30767,30943,176
100,0,blank,0,1030.645,251.4644,30943,31068,125
100,0,blank,0,1012.5475,262.75305,31068,31243,175
100,0,blank,0,1032.69733333333,250.297466666667,31243,31368,125
100,0,blank,0,1026.39833333333,214.433233333333,31368,31547,179
100,0,blank,0,1022.458,247.63615,31547,31597,50
100,0,blank,0,1031.359,280.7717,31597,31779,182
100,0,blank,0,1011.64725,305.267825,31779,31953,174
100,0,blank,0,1016.632,247.373575,31953,32092,139
100,0,blank,0,1041.014,264.2975,32092,32273,181
100,0,blank,0,1028.21866666667,283.486866666667,32273,32456,183
100,0,blank,0,1034.65225,286.600325,32456,32591,135
101,0,blank,0,1010.0385,601.9479,34389,34446,57
101,0,blank,0,125.80126,639.55412,34528,34689,161
101,0,blank,0,151.812566666667,629.442466666667,34689,34818,129
101,0,blank,0,141.3465,637.1107,34818,34972,154
101,0,blank,0,995.676,588.9857,35278,35303,25
101,0,blank,0,964.136,506.4267,35364,35419,55
101,0,blank,0,87.5284666666667,290.123233333333,35627,35727,100
101,36,create,223,113.4947,441.423,35845,35884,39
101,0,blank,0,30.26085,454.0937,35924,36114,190
101,0,blank,0,19.7823,481.8383,36114,36313,199
101,0,blank,0,33.1844571428571,463.676828571429,36313,36512,199
101,36,void,222,33.4654,440.23465,36512,36685,173
101,36,create,223,55.2039714285714,432.602714285714,36685,36884,199
101,36,create,223,56.8361,424.230283333333,36884,37056,172
101,36,void,222,39.5811,442.234014285714,37056,37255,199
101,0,blank,0,-7.255,424.113466666667,37255,37340,85
101,0,blank,0,9.83028571428571,92.7910285714286,37394,37592,198
101,0,blank,0,21.4010142857143,63.3061428571429,37592,37784,192
101,19,return,130,49.3249142857143,57.5107714285714,37784,37978,194
101,0,blank,0,54.923,87.80995,37978,38034,56
101,0,blank,0,72.9151714285714,549.617028571429,38091,38288,197
101,0,blank,0,63.0596,538.0373,38288,38317,29
101,47,str_rem,298,52.8769,680.038957142857,38344,38539,195
101,47,str_rem,298,60.737775,682.831375,38539,38652,113
101,36,create,223,64.2525285714286,432.426514285714,38681,38880,199
101,36,create,223,94.4662428571429,443.905614285714,38880,39078,198
101,0,blank,0,129.865471428571,444.955542857143,39078,39276,198
101,0,blank,0,179.448957142857,444.4741,39276,39473,197
101,36,str_rem,226,176.238971428571,431.057471428571,39473,39671,198
101,36,str_rem,226,220.078714285714,434.881842857143,39671,39868,197
101,0,blank,0,258.171971428571,454.219828571429,39868,40067,199
101,0,blank,0,275.043914285714,445.197828571429,40067,40265,198
101,36,char,230,318.110428571429,425.307757142857,40265,40463,198
101,0,blank,0,365.703271428571,444.490971428571,40463,40660,197
101,0,blank,0,392.374014285714,444.960414285714,40660,40854,194
101,0,blank,0,416.013275,459.7856,40854,40966,112
101,39,for,250,72.9580857142857,496.735585714286,41022,41218,196
101,0,blank,0,79.280425,509.37825,41218,41329,111
101,47,str_rem,298,56.448925,670.0996,41358,41487,129
101,0,blank,0,965.5565,551.6306,41764,41935,171
101,0,blank,0,984.9574,444.91162,42035,42219,184
101,0,blank,0,991.4238,421.68028,42219,42359,140
101,0,blank,0,979.999,455.8198,42386,42442,56
101,0,blank,0,999.79425,427.852625,42470,42631,161
101,21,alphacheck,135,137.57455,108.060825,42707,42865,158
101,21,alphacheck,135,123.624,102.4918,42865,43041,176
101,21,alphacheck,135,139.9675,102.329366666667,43041,43116,75
102,0,blank,0,971.633,6.43389999999999,45366,45422,56
102,4,ctype,36,126.416183333333,88.7722666666667,45498,45687,189
102,5,stdlib,43,117.482016666667,96.8990333333333,45687,45886,199
102,9,char,56,81.4977333333333,186.296983333333,45886,46063,177
102,0,blank,0,86.802775,200.6466,46063,46210,147
102,0,blank,0,766.8688,174.47538,46262,46432,170
102,0,blank,0,765.111,143.2767,46432,46486,54
102,0,blank,0,969.99625,145.70835,46562,46665,103
102,0,blank,0,990.951,149.2488,46693,46751,58
102,0,blank,0,-323,-105,46809,46984,175
102,0,blank,0,-323,-105,46984,47163,179
102,0,blank,0,-323,-105,47163,47331,168
102,0,blank,0,-323,-105,47331,47524,193
102,0,blank,0,-323,-105,47524,47704,180
102,5,<,42,80.1337833333333,107.138416666667,47742,47933,191
102,6,CHAR_SIZE,49,114.9328,129.758883333333,47933,48114,181
102,0,blank,0,137.1775,135.5761,48114,48145,31
102,0,blank,0,-323,-105,48204,48282,78
102,0,blank,0,-16.0291,124.1544,48307,48346,39
102,6,define,48,6.59685714285714,126.806914285714,48411,48601,190
102,7,int,51,31.6155833333333,135.141816666667,48601,48779,178
102,0,blank,0,42.0972333333333,139.431266666667,48779,48869,90
102,0,blank,0,24.87258,196.56516,48931,49102,171
102,0,blank,0,25.0249142857143,203.2874,49102,49301,199
102,9,char,56,64.4279,181.12745,49301,49473,172
102,0,blank,0,57.65045,162.60725,49473,49529,56
102,10,int,67,49.6155,208.414,49588,49616,28
102,11,char,77,70.9987666666667,232.9822,49677,49762,85
102,10,a1,68,99.5329333333333,207.112033333333,49852,49939,87
102,0,blank,0,-323,-105,49970,50168,198
102,0,blank,0,37.01235,632.95235,50198,50255,57
102,9,char,56,52.1806428571428,184.133757142857,50614,50813,199
102,0,blank,0,85.2396166666667,177.298066666667,50813,50985,172
102,0,blank,0,91.4843333333333,175.549466666667,50985,51159,174
102,9,str1,57,95.2777,180.08185,51159,51333,174
102,0,blank,0,91.4348,190.107366666667,51333,51417,84
102,0,blank,0,134.55674,188.25496,51474,51618,144
102,6,define,48,34.9472833333333,122.127116666667,51650,51821,171
102,0,blank,0,19.8604,131.9412,51821,51850,29
102,0,blank,0,131.98835,166.572533333333,51879,52054,175
102,0,blank,0,177.2641,159.5302,52054,52225,171
102,0,blank,0,173.139,182.427566666667,52225,52398,173
102,0,blank,0,214.029928571429,170.771985714286,52398,52596,198
102,0,blank,0,233.78924,173.6756,52596,52738,142
102,0,blank,0,145.561016666667,176.8884,52767,52936,169
102,10,int,67,53.00645,216.8558,52968,53150,182
102,9,char,56,72.5403,195.6258,53150,53181,31
102,0,blank,0,41.871175,190.7047,53239,53360,121
102,10,int,67,66.4736666666667,202.03915,53391,53575,184
102,0,blank,0,126.39995,201.28565,53575,53687,112
102,9,char,56,77.4674833333333,192.3962,53741,53911,170
102,0,blank,0,35.3590333333333,227.038533333333,53911,54092,181
102,10,int,67,57.7474333333333,209.760233333333,54092,54277,185
102,0,blank,0,82.9688833333333,209.40255,54277,54461,184
102,10,CHAR_SIZE,70,116.60825,215.102966666667,54490,54670,180
102,12,"Enterstring1:",85,119.7423,260.0042,54670,54701,31
102,0,blank,0,-323,-105,54732,54835,103
102,0,blank,0,179.5775,139.54,54860,54886,26
102,0,blank,0,131.941316666667,166.4255,54949,55110,161
102,0,blank,0,154.1813,176.0369,55138,55167,29
102,0,blank,0,111.876466666667,175.832633333333,55252,55338,86
102,10,CHAR_SIZE,70,200.678528571429,205.088685714286,55369,55565,196
102,9,str2,62,206.3602,190.897983333333,55565,55740,175
102,9,str2,62,221.1866,181.751233333333,55740,55924,184
102,0,blank,0,224.19728,159.05222,55924,56076,152
102,9,str1,57,100.690866666667,189.219633333333,56107,56282,175
102,11,char,77,65.8381166666667,240.65325,56282,56457,175
102,0,blank,0,87.3353166666667,189.22735,56457,56636,179
102,12,"Enterstring1:",85,209.4075,264.6112,56722,56752,30
102,10,a1,68,97.3433833333333,221.733433333333,56781,56960,179
102,10,int,67,62.55134,207.58642,56960,57115,155
102,4,ctype,36,100.9933,82.0026,57145,57325,180
102,4,ctype,36,109.668183333333,85.3751333333333,57325,57506,181
102,5,stdlib,43,110.408733333333,107.6071,57506,57684,178
102,5,stdlib,43,112.917016666667,92.3553833333333,57684,57865,181
102,6,CHAR_SIZE,49,85.24225,118.983783333333,57865,58043,178
102,9,char,56,71.2167333333333,199.875366666667,58043,58226,183
102,9,char,56,79.28344,191.91678,58226,58410,184
102,11,char,77,77.7375666666667,234.982516666667,58410,58586,176
102,10,int,67,71.5035166666667,202.441533333333,58586,58765,179
102,10,CHAR_SIZE,70,143.9824,219.50184,58765,58940,175
102,11,str2_rem,78,162.891733333333,239.7636,58940,59027,87
102,10,],71,229.360016666667,215.0482,59084,59260,176
102,0,blank,0,233.195666666667,223.154283333333,59260,59436,176
102,10,CHAR_SIZE,70,199.937914285714,208.992357142857,59436,59635,199
102,0,blank,0,216.30332,200.69208,59635,59776,141
102,10,{,73,256.8866,219.545,59803,59832,29
102,0,blank,0,-323,-105,59860,60038,178
102,0,blank,0,208.183433333333,201.584,60134,60315,181
102,9,str2,62,226.3853,190.008966666667,60315,60404,89
102,9,],65,169.899033333333,192.606166666667,60465,60557,92
102,11,str2_rem,78,121.751383333333,229.160133333333,60588,60777,189
102,0,blank,0,85.80825,239.178283333333,60777,60961,184
102,10,int,67,61.9523,205.174133333333,60961,61142,181
102,0,blank,0,41.6155666666667,248.662883333333,61142,61322,180
102,0,blank,0,42.3279166666667,228.418316666667,61322,61506,184
102,12,printf,83,75.1810666666667,246.507466666667,61506,61687,181
102,11,char,77,74.62946,235.81582,61687,61838,151
102,11,str2_rem,78,105.3645,230.1831,61838,61981,143
102,11,str2_rem,78,104.9602,240.2457,61981,62177,196
102,12,"Enterstring1:",85,127.0105,246.685225,62177,62357,180
102,11,str2_rem,78,131.206016666667,238.087466666667,62357,62538,181
102,12,"Enterstring1:",85,127.2109,251.9636,62538,62629,91
102,0,blank,0,33.3189166666667,243.664983333333,62658,62835,177
102,0,blank,0,20.8606833333333,230.4986,62835,63009,174
102,0,blank,0,28.4756333333333,214.092133333333,63009,63190,181
102,0,blank,0,36.9632,241.0895,63190,63221,31
102,9,char,56,49.21358,186.10338,63440,63621,181
102,10,int,67,49.3144,215.368533333333,63621,63721,100
102,10,int,67,53.4650833333333,218.314983333333,63886,64067,181
102,0,blank,0,68.3867666666667,266.6233,64067,64155,88
102,0,blank,0,-323,-105,64211,64316,105
102,11,char,77,70.00675,224.567066666667,64445,64607,162
102,0,blank,0,33.6333666666667,236.5752,64607,64764,157
102,10,int,67,73.6014666666667,208.538866666667,64814,64985,171
102,0,blank,0,77.6426833333333,203.275883333333,64985,65156,171
102,10,a1,68,101.6235,212.718116666667,65156,65330,174
102,11,str2_rem,78,104.387266666667,237.8225,65330,65416,86
102,0,blank,0,81.8496,203.4422,65445,65530,85
102,10,int,67,55.6822666666667,203.940533333333,65586,65758,172
102,0,blank,0,55.9625333333333,222.912016666667,65758,65936,178
102,10,int,67,46.1879333333333,217.6565,65936,66021,85
102,0,blank,0,-323,-105,66050,66105,55
102,9,char,56,55.2289428571429,180.678471428571,66208,66399,191
102,9,char,56,51.38965,198.185266666667,66399,66575,176
102,10,int,67,71.2134666666667,203.530733333333,66575,66749,174
102,0,blank,0,92.2970333333333,199.859933333333,66749,66923,174
102,0,blank,0,97.1082833333333,223.164166666667,66923,67095,172
102,0,blank,0,96.0977666666667,171.743416666667,67095,67269,174
102,0,blank,0,99.51445,164.595966666667,67269,67442,173
102,9,str1,57,100.100816666667,187.2853,67442,67619,177
102,0,blank,0,101.452033333333,158.74555,67619,67793,174
102,9,str1,57,100.873866666667,192.146366666667,67793,67966,173
102,0,blank,0,104.82965,213.811483333333,67966,68139,173
102,10,CHAR_SIZE,70,131.912683333333,204.941366666667,68139,68315,176
102,11,str2_rem,78,138.17105,232.1023,68315,68490,175
102,12,"Enterstring1:",85,140.66535,250.70845,68490,68605,115
102,11,str2_rem,78,135.611433333333,242.239183333333,68634,68808,174
102,10,CHAR_SIZE,70,157.200585714286,203.650857142857,68808,69007,199
102,0,blank,0,234.95365,217.26845,69007,69065,58
102,11,char,77,63.3505166666667,237.8708,69094,69275,181
102,11,char,77,68.95238,243.99624,69275,69419,144
102,12,"Enterstring1:",85,118.110733333333,246.9657,69476,69649,173
102,11,str2_rem,78,149.492483333333,238.803983333333,69649,69823,174
102,12,"Enterstring1:",85,174.292383333333,250.422933333333,69823,69997,174
102,12,"Enterstring1:",85,194.80995,247.806616666667,69997,70170,173
102,11,;,82,217.589833333333,243.415433333333,70170,70346,176
102,13,"%s",90,136.4189,268.0168,70346,70520,174
102,12,"Enterstring1:",85,117.670583333333,261.420016666667,70520,70696,176
102,13,"%s",90,126.663371428571,270.803928571429,70696,70895,199
102,12,"Enterstring1:",85,137.430633333333,263.881366666667,70895,71066,171
102,12,"Enterstring1:",85,168.812583333333,256.957216666667,71066,71239,173
102,10,CHAR_SIZE,70,152.847916666667,217.123133333333,71239,71410,171
102,0,blank,0,123.0404,152.899025,71410,71530,120
102,0,blank,0,200.203,223.97865,71591,71651,60
102,0,blank,0,134.733366666667,195.0739,71708,71890,182
102,12,"Enterstring1:",85,193.4703,249.6165,71890,72062,172
102,0,blank,0,163.204933333333,287.726033333333,72062,72234,172
102,13,"%s",90,139.943616666667,284.448983333333,72234,72406,172
102,13,"%s",90,109.907483333333,281.0202,72406,72579,173
102,12,"Enterstring1:",85,206.257383333333,257.8802,72579,72753,174
102,0,blank,0,233.8275,229.4904,72753,72782,29
102,14,"Enterstring2:",97,129.9055,295.31155,72810,72871,61
102,14,"Enterstring2:",97,133.237383333333,302.8614,72929,73101,172
102,14,"Enterstring2:",97,126.605166666667,290.066666666667,73101,73187,86
102,0,blank,0,158.26554,316.49068,73215,73358,143
102,0,blank,0,143.541825,327.07685,73387,73510,123
102,9,50,64,149.683716666667,192.102116666667,73539,73716,177
102,0,blank,0,131.853316666667,169.070933333333,73716,73890,174
102,0,blank,0,191.9406,166.993483333333,73890,74064,174
102,0,blank,0,182.763766666667,155.0281,74064,74239,175
102,9,str1,57,111.789633333333,189.85035,74239,74415,176
102,0,blank,0,162.934366666667,311.210983333333,74444,74623,179
102,0,blank,0,168.66774,288.84684,74623,74767,144
102,16,alphacheck,107,92.7643666666667,336.871166666667,74796,74975,179
102,15,scanf,100,69.6714833333333,330.325633333333,74975,75149,174
102,16,alphacheck,107,83.1295333333333,336.32035,75149,75322,173
102,17,create,114,72.1801666666667,361.283033333333,75322,75502,180
102,16,alphacheck,107,85.9768833333333,344.366733333333,75502,75677,175
102,16,alphacheck,107,130.060366666667,336.072083333333,75677,75853,176
102,17,create,114,102.216616666667,360.858183333333,75853,76031,178
102,17,create,114,102.07145,370.171166666667,76031,76200,169
102,15,scanf,100,88.91835,329.292866666667,76200,76379,179
102,16,alphacheck,107,134.182666666667,350.662533333333,76379,76466,87
102,11,char,77,72.6139166666667,235.18545,76495,76680,185
102,10,a1,68,89.2685833333333,217.388566666667,76680,76865,185
102,11,char,77,78.48055,229.368716666667,76865,77040,175
102,9,char,56,73.7463,191.1991,77040,77069,29
102,13,(,89,102.736083333333,275.412433333333,77128,77302,174
102,17,create,114,67.6177,356.2424,77302,77330,28
102,16,alphacheck,107,89.4662833333333,348.365466666667,77390,77567,177
102,16,alphacheck,107,63.7329,352.24,77567,77598,31
102,16,alphacheck,107,69.4779166666667,341.3877,77627,77806,179
102,16,alphacheck,107,53.61555,335.73385,77806,77991,185
102,16,alphacheck,107,115.43328,349.17154,77991,78170,179
102,0,blank,0,172.2363,472.784,78170,78200,30
102,15,scanf,100,88.35465,330.723716666667,78228,78409,181
102,16,alphacheck,107,113.4599,345.501866666667,78409,78595,186
102,16,(,108,149.3403,346.541433333333,78595,78767,172
102,16,(,108,152.446733333333,342.680266666667,78767,78939,172
102,15,str2,104,195.7911,311.266683333333,78939,79116,177
102,15,str2,104,194.7191,330.102466666667,79116,79208,92
102,12,printf,83,102.6902,252.924316666667,79297,79475,178
102,11,str2_rem,78,103.94806,237.82728,79475,79654,179
102,11,str2_rem,78,129.7169,225.4238,79654,79842,188
102,10,CHAR_SIZE,70,140.2345,213.8726,79842,79903,61
102,0,blank,0,124.21725,223.193583333333,79934,80114,180
102,10,CHAR_SIZE,70,127.63032,204.15558,80114,80289,175
102,10,CHAR_SIZE,70,129.8591,214.832433333333,80289,80467,178
102,9,str1,57,132.374083333333,189.16555,80467,80640,173
102,11,str2_rem,78,164.245983333333,235.7972,80640,80812,172
102,17,str2_rem,116,180.1272,356.4042,80812,80844,32
102,16,str1,109,193.17365,333.09995,80899,80959,60
102,16,alphacheck,107,129.2169,351.6809,81015,81044,29
102,0,blank,0,143.2435,328.0172,81072,81271,199
102,16,str1,109,157.22215,337.190733333333,81271,81446,175
102,16,str1,109,167.134533333333,338.972516666667,81446,81620,174
102,16,comma,110,195.465166666667,340.638766666667,81680,81769,89
102,16,alphacheck,107,86.3623666666667,353.483933333333,81799,81889,90
102,15,scanf,100,81.060275,324.188275,81980,82100,120
102,16,alphacheck,107,67.1633,343.6055,82157,82185,28
102,14,"Enterstring2:",97,175.88755,297.04465,82216,82337,121
102,15,str2,104,185.4547,330.3699,82337,82447,110
102,10,CHAR_SIZE,70,187.74282,210.5296,82555,82749,194
102,12,"Enterstring1:",85,173.842666666667,247.524133333333,82749,82835,86
102,10,CHAR_SIZE,70,127.129533333333,210.692816666667,82867,83045,178
102,0,blank,0,153.745383333333,223.473766666667,83045,83218,173
102,10,CHAR_SIZE,70,156.86885,216.75705,83218,83276,58
102,0,blank,0,138.92565,173.34345,83307,83491,184
102,0,blank,0,93.2795333333333,178.912283333333,83491,83674,183
102,0,blank,0,92.5441,200.8542,83674,83704,30
102,9,char,56,80.4673333333333,185.957316666667,83764,83945,181
102,10,a1,68,88.0780833333333,204.658316666667,83945,84126,181
102,9,str1,57,110.634233333333,199.49825,84126,84315,189
102,6,CHAR_SIZE,49,99.7839,122.7059,84315,84347,32
102,9,comma,61,179.131,180.041783333333,84375,84572,197
102,0,blank,0,237.524566666667,204.402083333333,84572,84746,174
102,10,],71,224.42912,208.7859,84746,84890,144
102,10,CHAR_SIZE,70,123.37995,215.374966666667,84950,85129,179
102,9,str1,57,103.657666666667,196.16675,85129,85313,184
102,0,blank,0,59.5524,160.8358,85313,85344,31
102,9,char,56,57.22374,191.28834,85374,85523,149
102,9,char,56,83.9603333333333,195.193283333333,85583,85764,181
102,0,blank,0,134.3659,195.54315,85764,85938,174
102,13,str1,92,175.017725,285.56645,85938,86055,117
102,15,),105,204.214125,321.01735,86086,86203,117
102,0,blank,0,144.6509,353.1143,86264,86292,28
102,16,str1,109,167.854933333333,345.39735,86354,86530,176
102,15,str2,104,187.5838,323.533,86530,86702,172
102,17,create,114,70.5440833333333,357.089283333333,86758,86933,175
102,18,printf,123,65.2956,389.78365,86933,87115,182
102,0,blank,0,42.23075,388.828,87115,87293,178
102,18,printf,123,56.4121,386.88265,87293,87352,59
102,18,"Onremovingcharactersfromsecondstringweget:%s\n",125,124.9946,381.6615,87410,87439,29
102,16,alphacheck,107,114.09635,338.492183333333,87469,87644,175
102,17,str2_rem,116,128.061066666667,369.337666666667,87644,87820,176
102,16,alphacheck,107,121.569883333333,345.717783333333,87820,87997,177
102,17,str2_rem,116,145.463433333333,360.514133333333,87997,88175,178
102,18,printf,123,75.5510333333333,385.3236,88175,88357,182
102,17,create,114,63.117975,357.08935,88386,88505,119
102,0,blank,0,32.4021,344.8339,88534,88564,30
102,17,str2_rem,116,121.730233333333,369.25945,88624,88802,178
102,16,alphacheck,107,129.06992,348.633,88802,88952,150
102,17,create,114,76.6957,364.559633333333,89014,89193,179
102,17,str2_rem,116,114.590783333333,363.1058,89193,89374,181
102,17,str2_rem,116,137.776783333333,366.587933333333,89374,89555,181
102,17,str2_rem,116,186.444983333333,360.863516666667,89555,89728,173
102,17,comma,119,198.97095,363.955,89728,89910,182
102,16,str1,109,166.221766666667,353.440383333333,89910,90081,171
102,18,"Onremovingcharactersfromsecondstringweget:%s\n",125,138.220514285714,378.475357142857,90081,90278,197
102,17,str2_rem,116,120.1454,371.7409,90278,90309,31
102,17,str2_rem,116,121.15448,356.6226,90368,90545,177
102,17,(,115,110.829,361.6574,90545,90576,31
102,10,[,69,111.203383333333,213.17595,90606,90793,187
102,11,str2_rem,78,123.80485,228.136433333333,90793,90979,186
102,10,CHAR_SIZE,70,127.022583333333,210.935583333333,90979,91156,177
102,10,CHAR_SIZE,70,163.98485,206.461666666667,91156,91328,172
102,16,str1,109,165.262583333333,337.015516666667,91328,91499,171
102,18,"Onremovingcharactersfromsecondstringweget:%s\n",125,181.55995,386.88945,91499,91671,172
102,0,blank,0,211.845816666667,349.984283333333,91671,91842,171
102,17,str2_rem,116,175.9524,362.63702,91842,91986,144
102,0,blank,0,114.1559,532.6772,92015,92046,31
102,18,printf,123,56.1427,391.318583333333,92073,92248,175
102,18,printf,123,50.26475,384.201883333333,92248,92431,183
102,14,printf,95,55.3175,307.6095,92431,92489,58
102,14,printf,95,49.45775,307.39125,92546,92605,59
102,0,blank,0,51.0463,354.020225,92665,92785,120
102,26,i,178,124.8236,557.2955,92815,92845,30
102,18,"Onremovingcharactersfromsecondstringweget:%s\n",125,145.183014285714,391.298628571429,92872,93065,193
102,0,blank,0,-323,-105,93096,93251,155
102,18,"Onremovingcharactersfromsecondstringweget:%s\n",125,156.6822,394.3621,93276,93312,36
102,0,blank,0,198.741366666667,409.052783333333,93374,93535,161
102,16,a1,111,218.810066666667,345.769766666667,93563,93649,86
102,0,blank,0,208.003571428571,411.022614285714,93677,93875,198
102,0,blank,0,194.3765,479.9029,93875,93903,28
102,0,blank,0,29.0399,261.4045,94071,94096,25
102,12,printf,83,65.8057666666667,260.218066666667,94214,94393,179
102,0,blank,0,40.8093,178.237183333333,94393,94575,182
102,0,blank,0,38.6179,158.20938,94575,94727,152
102,5,include,41,50.5600166666667,93.6970166666667,94785,94963,178
102,4,include,34,32.5087,70.47246,94963,95139,176
102,0,blank,0,85.83425,74.7962833333333,95139,95319,180
102,4,ctype,36,105.2953,86.72565,95319,95501,182
102,4,ctype,36,102.803516666667,73.1166833333333,95501,95684,183
102,4,ctype,36,100.467066666667,76.0616,95684,95776,92
102,18,"Onremovingcharactersfromsecondstringweget:%s\n",125,187.7894,388.35906,96034,96172,138
102,17,str2_rem,116,156.9423,369.663014285714,96228,96427,199
102,18,"Onremovingcharactersfromsecondstringweget:%s\n",125,164.468916666667,379.2995,96427,96599,172
102,0,blank,0,214.894266666667,376.377766666667,96599,96772,173
102,18,"Onremovingcharactersfromsecondstringweget:%s\n",125,193.4005,380.7308,96772,96799,27
102,0,blank,0,-323,-105,96826,96930,104
102,0,blank,0,255.5789,323.9715,96955,96986,31
102,18,"Onremovingcharactersfromsecondstringweget:%s\n",125,224.089625,379.663125,97048,97151,103
102,0,blank,0,149.262533333333,399.800633333333,97208,97386,178
102,0,blank,0,157.71454,401.43684,97386,97526,140
102,0,blank,0,142.2519,481.7941,97557,97588,31
102,0,blank,0,113.03046,385.37186,97643,97815,172
102,17,str2_rem,116,115.677266666667,355.4691,97815,97936,121
102,18,"Onremovingcharactersfromsecondstringweget:%s\n",125,216.56322,378.28676,98029,98175,146
102,17,str2,118,227.465633333333,368.47635,98175,98373,198
102,12,"Enterstring1:",85,163.328483333333,257.607683333333,98400,98573,173
102,16,a1,111,221.7296,337.339733333333,98573,98744,171
102,17,str2,118,222.0637,364.924816666667,98744,98917,173
102,17,str2,118,222.3661,357.288457142857,98917,99114,197
102,17,str2,118,224.816942857143,356.080014285714,99114,99312,198
102,0,blank,0,144.773966666667,348.4987,99312,99485,173
102,0,blank,0,144.890283333333,347.313716666667,99485,99659,174
102,16,(,108,148.900983333333,337.3081,99659,99831,172
102,17,str2_rem,116,162.517633333333,374.212866666667,99831,100004,173
102,12,"Enterstring1:",85,159.0686,253.507766666667,100004,100117,113
102,9,str1,57,110.40698,188.90152,100200,100352,152
102,10,[,69,105.0458,214.3706,100411,100438,27
102,10,a1,68,83.9060333333333,220.485033333333,100525,100614,89
102,0,blank,0,76.0137,203.0827,100675,100734,59
102,0,blank,0,188.718133333333,174.902333333333,100764,100853,89
102,12,"Enterstring1:",85,225.1659,255.1175,100884,100911,27
102,9,],65,170.7309,190.98425,100938,100996,58
102,16,a1,111,233.757133333333,349.935966666667,101028,101204,176
102,0,blank,0,202.928125,363.058325,101204,101319,115
102,19,return,130,53.6307333333333,401.238733333333,101350,101521,171
102,19,return,130,63.69165,404.96785,101521,101692,171
102,18,printf,123,55.13545,396.717966666667,101692,101866,174
102,18,printf,123,73.9613666666667,393.70115,101866,102040,174
102,18,"Onremovingcharactersfromsecondstringweget:%s\n",125,114.794466666667,392.3263,102040,102214,174
102,18,"Onremovingcharactersfromsecondstringweget:%s\n",125,160.763066666667,386.501566666667,102214,102388,174
102,0,blank,0,155.5367,415.8937,102388,102444,56
102,18,"Onremovingcharactersfromsecondstringweget:%s\n",125,235.22126,390.49778,102470,102619,149
102,18,"Onremovingcharactersfromsecondstringweget:%s\n",125,286.24655,391.00775,102619,102775,156
102,18,"Onremovingcharactersfromsecondstringweget:%s\n",125,340.91685,383.35945,102775,102967,192
102,18,"Onremovingcharactersfromsecondstringweget:%s\n",125,392.676033333333,381.8597,102967,103155,188
102,18,"Onremovingcharactersfromsecondstringweget:%s\n",125,413.493857142857,378.508271428571,103155,103354,199
102,18,"Onremovingcharactersfromsecondstringweget:%s\n",125,482.874257142857,393.824,103354,103551,197
102,0,blank,0,475.732,425.1489,103551,103579,28
102,18,"Onremovingcharactersfromsecondstringweget:%s\n",125,530.327414285714,390.4936,103607,103805,198
102,0,blank,0,558.4556,410.712128571429,103805,104002,197
102,0,blank,0,594.806683333333,424.458466666667,104002,104174,172
102,18,"Onremovingcharactersfromsecondstringweget:%s\n",125,632.014085714286,386.519671428571,104174,104373,199
102,0,blank,0,654.882083333333,430.203366666667,104373,104544,171
102,0,blank,0,679.637666666667,405.935466666667,104544,104716,172
102,0,blank,0,687.361733333333,428.841383333333,104716,104887,171
102,18,str2_rem,127,695.6955,389.441133333333,104887,105060,173
102,0,blank,0,676.770933333333,426.419466666667,105060,105232,172
102,0,blank,0,668.129,416.6602,105232,105319,87
102,17,create,114,103.2341,368.5735,105435,105551,116
102,23,index,150,140.8875,500.3946,105582,105613,31
102,18,printf,123,64.4221166666667,390.219766666667,105642,105823,181
102,0,blank,0,29.3754,332.4642,105823,105854,31
102,17,create,114,53.80994,355.69456,105913,106054,141
102,19,return,130,83.7941666666667,406.7007,106082,106169,87
102,15,scanf,100,57.1049333333333,321.551083333333,106226,106400,174
102,0,blank,0,19.82255,310.09795,106400,106459,59
102,19,return,130,66.30114,416.96768,106491,106634,143
102,18,printf,123,84.9315333333333,380.918033333333,106660,106838,178
102,17,create,114,103.96185,357.2484,106838,106899,61
102,17,str2_rem,116,154.911716666667,375.313683333333,106928,107101,173
102,18,"Onremovingcharactersfromsecondstringweget:%s\n",125,185.487525,378.44845,107101,107215,114
102,17,comma,119,195.941066666667,358.9893,107242,107330,88
102,18,"Onremovingcharactersfromsecondstringweget:%s\n",125,145.47255,390.779466666667,107358,107537,179
102,0,blank,0,122.229,400.9942,107537,107658,121
102,18,"Onremovingcharactersfromsecondstringweget:%s\n",125,118.99505,380.7616,107686,107745,59
102,17,str2_rem,116,173.300683333333,370.859966666667,107806,107977,171
102,18,"Onremovingcharactersfromsecondstringweget:%s\n",125,187.155633333333,379.794983333333,107977,108150,173
102,17,str2,118,216.93835,361.215683333333,108150,108322,172
102,17,str2_rem,116,143.956833333333,366.244716666667,108322,108495,173
102,0,blank,0,86.6679666666667,354.1117,108495,108669,174
102,17,create,114,68.4635142857143,371.376542857143,108669,108868,199
102,17,create,114,61.6706166666667,367.29955,108868,109040,172
102,16,alphacheck,107,77.703475,347.54925,109040,109152,112
102,17,create,114,48.9374,375.176483333333,109180,109353,173
102,17,create,114,52.4730428571429,361.8933,109353,109552,199
102,17,create,114,55.3966333333333,355.70495,109552,109725,173
102,18,"Onremovingcharactersfromsecondstringweget:%s\n",125,128.240483333333,385.596266666667,109725,109896,171
102,0,blank,0,93.4153833333333,398.615166666667,109896,110068,172
102,18,(,124,112.105128571429,392.815828571429,110068,110267,199
102,18,"Onremovingcharactersfromsecondstringweget:%s\n",125,197.151914285714,388.189714285714,110267,110465,198
102,18,"Onremovingcharactersfromsecondstringweget:%s\n",125,240.815566666667,387.1238,110465,110638,173
102,0,blank,0,256.8874,417.9781,110638,110666,28
102,19,return,130,52.7833666666667,405.269533333333,110694,110866,172
102,0,blank,0,48.0566333333333,423.403266666667,110866,110953,87
102,17,comma,119,259.522,375.8146,110982,111154,172
102,0,blank,0,339.135233333333,366.286133333333,111154,111326,172
102,18,"Onremovingcharactersfromsecondstringweget:%s\n",125,361.477183333333,387.685216666667,111326,111498,172
102,18,"Onremovingcharactersfromsecondstringweget:%s\n",125,393.169533333333,391.0315,111498,111671,173
102,0,blank,0,450.864242857143,416.501214285714,111699,111898,199
102,0,blank,0,502.8857,413.221657142857,111898,112097,199
102,0,blank,0,547.605657142857,411.5318,112097,112296,199
102,0,blank,0,570.667942857143,442.887628571429,112296,112494,198
102,18,"Onremovingcharactersfromsecondstringweget:%s\n",125,613.772142857143,397.5069,112494,112692,198
102,0,blank,0,628.892375,407.79,112692,112806,114
102,0,blank,0,592.1795,508.22,112835,112862,27
102,0,blank,0,640.4798,444.164757142857,112891,113087,196
102,0,blank,0,654.037833333333,424.7695,113087,113179,92
102,0,blank,0,664.283057142857,404.5058,113207,113406,199
102,0,blank,0,689.294666666667,391.924783333333,113406,113575,169
102,16,(,108,145.066433333333,340.537033333333,113634,113807,173
102,17,create,114,95.6821833333333,365.533216666667,113807,113984,177
102,17,create,114,64.0238166666667,356.800783333333,113984,114156,172
102,18,printf,123,61.6300833333333,385.721566666667,114156,114332,176
102,17,create,114,63.3067666666667,360.709933333333,114332,114505,173
102,18,printf,123,79.4154333333333,383.707466666667,114505,114593,88
102,0,blank,0,-323,-105,114622,114806,184
102,0,blank,0,-323,-105,114806,114995,189
102,0,blank,0,-323,-105,114995,115050,55
102,13,;,94,219.9033,281.4055,115162,115187,25
102,16,alphacheck,107,117.465975,342.773175,115245,115399,154
102,15,str2,104,180.49795,318.7193,115399,115566,167
102,15,str2,104,202.8153,322.97044,115566,115763,197
102,16,;,113,250.76828,336.9177,115839,116028,189
102,0,blank,0,204.5373,364.7456,116028,116226,198
102,17,str2_rem,116,119.784633333333,360.699016666667,116226,116398,172
102,16,alphacheck,107,100.0191,334.361283333333,116398,116572,174
102,14,printf,95,99.9856,309.58785,116572,116744,172
102,14,printf,95,88.22675,298.0957,116744,116915,171
102,0,blank,0,78.5111833333333,266.253966666667,116915,117088,173
102,11,str2_rem,78,103.303966666667,226.397383333333,117088,117261,173
102,11,str2_rem,78,109.05585,227.530783333333,117261,117433,172
102,11,str2_rem,78,160.35255,237.115075,117433,117545,112
102,12,"Enterstring1:",85,158.71795,265.012466666667,117574,117744,170
102,18,"Onremovingcharactersfromsecondstringweget:%s\n",125,206.226933333333,377.977683333333,117772,117970,198
102,0,blank,0,162.821514285714,403.799742857143,117970,118163,193
102,0,blank,0,700.703,514.1279,118220,118249,29
102,0,blank,0,735.0285,422.33835,118362,118470,108
102,0,blank,0,639.055,535.3397,118500,118533,33
102,0,blank,0,700.042333333333,418.376616666667,118613,118801,188
102,18,comma,126,675.933533333333,383.485833333333,118801,118890,89
102,16,alphacheck,107,139.8309,352.466316666667,118952,119143,191
102,17,str2_rem,116,121.745583333333,361.3724,119143,119338,195
102,17,create,114,102.979816666667,356.548283333333,119338,119509,171
102,17,create,114,78.7597,362.50405,119509,119681,172
102,15,"%s",102,109.401,315.287957142857,119681,119876,195
102,11,str2_rem,78,114.115614285714,229.3895,119876,120074,198
102,10,CHAR_SIZE,70,123.191383333333,220.284966666667,120074,120248,174
102,10,CHAR_SIZE,70,139.788285714286,218.260857142857,120307,120505,198
102,11,str2_rem,78,158.0069,227.2406,120533,120589,56
102,12,"Enterstring1:",85,211.0147,259.5046,120670,120728,58
102,11,str2_rem,78,100.993433333333,226.880066666667,120758,120931,173
102,11,char,77,69.6256833333333,227.0042,120931,121103,172
102,0,blank,0,84.44005,190.28445,121103,121160,57
102,0,blank,0,190.158716666667,185.665383333333,121188,121361,173
102,10,CHAR_SIZE,70,196.925671428571,215.094028571429,121361,121559,198
102,10,CHAR_SIZE,70,173.833566666667,218.1521,121559,121736,177
102,13,"%s",90,125.374266666667,274.904833333333,121767,121853,86
102,11,50,80,194.525633333333,224.887316666667,121909,122078,169
102,12,"Enterstring1:",85,228.016828571429,262.779057142857,122135,122332,197
102,0,blank,0,250.030566666667,320.097533333333,122332,122468,136
102,14,"Enterstring2:",97,230.53935,303.80705,122493,122545,52
102,14,"Enterstring2:",97,227.434833333333,302.906033333333,122627,122712,85
102,14,"Enterstring2:",97,193.9254,292.4058,122799,122825,26
102,13,),93,210.846933333333,268.554733333333,122886,122976,90
102,14,"Enterstring2:",97,193.56935,303.66645,123024,123195,171
102,15,),105,208.4142,322.2212,123195,123356,161
102,14,"Enterstring2:",97,151.988857142857,307.968442857143,123402,123601,199
102,15,"%s",102,110.080766666667,316.317366666667,123601,123796,195
102,15,str2,104,173.453271428571,327.6525,123796,123991,195
102,14,printf,95,100.7617,302.874,123991,124049,58
102,14,printf,95,90.5149714285714,296.946071428571,124099,124297,198
102,16,alphacheck,107,131.31284,340.31138,124297,124442,145
102,15,"%s",102,112.896816666667,319.603,124442,124640,198
102,15,"%s",102,119.030166666667,319.155266666667,124640,124811,171
102,16,alphacheck,107,133.887971428571,341.027814285714,124811,125009,198
102,0,blank,0,98.7063166666667,332.566283333333,125009,125180,171
102,15,scanf,100,86.6283142857143,326.593571428571,125180,125379,199
102,15,"%s",102,111.516083333333,331.4772,125379,125551,172
102,16,alphacheck,107,128.1989,346.5219,125551,125609,58
102,0,blank,0,103.568616666667,312.0141,125637,125831,194
102,16,alphacheck,107,107.524716666667,343.4017,125831,126003,172
102,14,printf,95,86.8065333333333,294.559,126003,126089,86
102,16,str1,109,173.305185714286,347.398442857143,126118,126316,198
102,17,str2_rem,116,177.33858,371.812,126316,126456,140
102,0,blank,0,204.22608,371.68688,126485,126628,143
102,0,blank,0,211.656766666667,361.520733333333,126684,126771,87
102,18,"Onremovingcharactersfromsecondstringweget:%s\n",125,199.704466666667,379.075233333333,126856,126966,110
102,17,str2,118,245.972371428571,371.7491,127019,127218,199
102,18,"Onremovingcharactersfromsecondstringweget:%s\n",125,242.917116666667,396.2653,127218,127410,192
102,18,"Onremovingcharactersfromsecondstringweget:%s\n",125,183.86605,380.805466666667,127410,127601,191
102,17,str2_rem,116,179.2214,357.7133,127601,127657,56
102,0,blank,0,185.4558,411.2737,127685,127714,29
102,17,str2_rem,116,138.60105,373.208483333333,127771,127945,174
102,18,(,124,107.110766666667,385.060833333333,127945,128139,194
102,17,create,114,99.1832333333333,373.705616666667,128139,128311,172
102,17,create,114,101.8711,362.321716666667,128311,128486,175
102,17,str2_rem,116,114.958566666667,361.123633333333,128486,128603,117
102,0,blank,0,-323,-105,128679,128807,128
102,17,str2_rem,116,187.4992,366.381716666667,128974,129144,170
102,0,blank,0,204.17945,333.4979,129144,129321,177
102,17,comma,119,260.61642,357.5239,129321,129468,147
102,0,blank,0,262.15818,349.6331,129468,129660,192
102,18,"Onremovingcharactersfromsecondstringweget:%s\n",125,256.485483333333,379.989066666667,129660,129834,174
102,17,),121,301.86688,369.19342,129834,130009,175
102,17,comma,119,261.6769,365.644316666667,130009,130196,187
102,16,),112,235.6552,346.9401,130196,130257,61
102,0,blank,0,539.3554,674.55585,130317,130492,175
102,0,blank,0,535.1385,667.1132,130492,130567,75
102,0,blank,0,527.606033333333,675.102983333333,130621,130800,179
102,0,blank,0,513.96354,638.54196,130800,130977,177
102,0,blank,0,714.713666666667,625.7946,131007,131096,89
102,0,blank,0,726.624,420.462,131215,131243,28
102,18,"Onremovingcharactersfromsecondstringweget:%s\n",125,586.6899,393.45334,131394,131539,145
102,0,blank,0,316.22005,355.37635,131596,131653,57
102,0,blank,0,407.21962,438.36494,131682,131827,145
102,18,"Onremovingcharactersfromsecondstringweget:%s\n",125,263.42565,381.390575,131883,132016,133
102,0,blank,0,248.05402,409.72804,132016,132199,183
102,0,blank,0,225.227042857143,401.558928571429,132199,132398,199
102,18,"Onremovingcharactersfromsecondstringweget:%s\n",125,322.5548,393.365866666667,132398,132483,85
102,0,blank,0,354.2573,303.188,132567,132595,28
102,0,blank,0,380.57245,408.3616,132623,132743,120
102,0,blank,0,457.367966666667,412.227533333333,132856,133048,192
102,18,"Onremovingcharactersfromsecondstringweget:%s\n",125,483.407014285714,382.998242857143,133048,133242,194
102,0,blank,0,505.776542857143,425.342014285714,133242,133441,199
102,0,blank,0,527.771,448.7104,133441,133498,57
102,18,"Onremovingcharactersfromsecondstringweget:%s\n",125,496.9951,387.9192,133526,133554,28
102,0,blank,0,435.134325,416.64615,133582,133692,110
102,0,blank,0,550.2625,505.7107,133779,133807,28
102,0,blank,0,535.5101,404.4715,133835,133863,28
102,0,blank,0,583.801,361.5799,134019,134044,25
102,17,str2,118,239.039128571429,359.2336,134180,134374,194
102,17,str2,118,223.570916666667,371.24245,134374,134565,191
102,16,str1,109,176.625128571429,348.301771428571,134565,134762,197
102,17,(,115,106.053128571429,367.673614285714,134762,134960,198
102,18,"Onremovingcharactersfromsecondstringweget:%s\n",125,125.860425,393.75395,134960,135072,112
102,18,printf,123,86.6692285714286,383.9249,135128,135321,193
102,18,"Onremovingcharactersfromsecondstringweget:%s\n",125,175.28235,388.576233333333,135377,135547,170
102,18,"Onremovingcharactersfromsecondstringweget:%s\n",125,176.905083333333,381.494066666667,135547,135721,174
102,17,str2_rem,116,181.96208,373.42028,135721,135862,141
102,17,str2_rem,116,178.6718,358.08505,135862,136049,187
102,18,"Onremovingcharactersfromsecondstringweget:%s\n",125,220.6223,377.986866666667,136049,136154,105
102,0,blank,0,-323,-105,136231,136358,127
102,0,blank,0,-323,-105,136358,136483,125
102,18,"Onremovingcharactersfromsecondstringweget:%s\n",125,249.273685714286,388.570714285714,136513,136703,190
102,18,"Onremovingcharactersfromsecondstringweget:%s\n",125,274.558525,391.6234,136703,136816,113
102,17,comma,119,261.174571428571,369.2309,136845,137043,198
102,0,blank,0,235.515357142857,354.830857142857,137043,137239,196
102,18,"Onremovingcharactersfromsecondstringweget:%s\n",125,273.114925,388.0331,137239,137352,113
102,0,blank,0,260.0407,405.423671428571,137379,137575,196
102,17,str2,118,253.608583333333,372.856666666667,137575,137747,172
102,18,"Onremovingcharactersfromsecondstringweget:%s\n",125,267.714183333333,379.033583333333,137747,137923,176
102,16,str1,109,189.16182,340.76138,137923,138088,165
102,15,str2,104,164.459066666667,325.669816666667,138141,138308,167
102,16,str1,109,176.771366666667,343.901633333333,138308,138500,192
102,16,alphacheck,107,142.4602,341.3159,138500,138529,29
102,15,str2,104,168.35915,325.0038,138637,138693,56
102,0,blank,0,-323,-105,138721,138774,53
102,0,blank,0,231.058457142857,320.136171428571,138799,138985,186
102,0,blank,0,177.13845,244.500475,138985,139099,114
102,12,"Enterstring1:",85,166.062733333333,246.392033333333,139156,139235,79
102,11,50,80,187.0877,238.17735,139264,139321,57
102,10,CHAR_SIZE,70,211.357833333333,220.74015,139436,139630,194
102,0,blank,0,190.6511,140.1249,139630,139658,28
102,0,blank,0,234.91405,213.85655,139687,139881,194
102,0,blank,0,226.91722,243.33788,139881,140074,193
102,0,blank,0,280.4887,350.79346,140074,140254,180
102,17,a1,120,285.1223,359.73935,140254,140427,173
102,16,),112,240.8439,337.193533333333,140427,140613,186
102,17,str2,118,251.0494,360.19774,140613,140790,177
102,17,str2,118,231.297966666667,372.9557,140790,140947,157
102,17,str2,118,245.290375,374.69455,140947,141102,155
102,0,blank,0,-323,-105,141206,141392,186
102,0,blank,0,-323,-105,141392,141417,25
102,0,blank,0,435.5901,-103.9723,141441,141478,37
102,0,blank,0,393.7916,686.68725,141506,141565,59
102,0,blank,0,477.0131,670.3329,141598,141631,33
102,0,blank,0,338.7244,682.5462,141659,141810,151
102,0,blank,0,394.345816666667,682.100266666667,141869,142042,173
102,0,blank,0,400.655833333333,675.525516666667,142042,142240,198
102,0,blank,0,354.930016666667,661.29045,142240,142415,175
102,0,blank,0,352.733933333333,631.962233333333,142415,142589,174
102,0,blank,0,355.8241,637.8288,142589,142780,191
102,0,blank,0,356.65056,599.8115,142780,142937,157
102,29,),205,218.5806,632.309366666667,142966,143162,196
102,0,blank,0,289.993075,735.821875,143162,143334,172
102,0,blank,0,268.3704,784.1532,143334,143365,31
102,0,blank,0,120.0978,439.507,143683,143731,48
102,18,printf,123,97.405,394.8984,143731,143888,157
102,0,blank,0,100.665166666667,471.698566666667,143888,144065,177
102,21,alphacheck,135,67.1721666666667,463.94335,144065,144236,171
102,21,alphacheck,135,103.6338,455.561133333333,144236,144370,134
102,0,blank,0,124.99188,473.25994,144395,144571,176
102,0,blank,0,168.708233333333,483.67475,144571,144764,193
102,0,blank,0,162.37486,465.15528,144764,144910,146
102,0,blank,0,934.4936,294.03518,144969,145161,192
102,0,blank,0,193.613833333333,470.421383333333,145250,145426,176
102,0,blank,0,179.736366666667,478.870433333333,145426,145625,199
102,0,blank,0,118.03365,483.440683333333,145625,145803,178
102,0,blank,0,107.4575,465.547283333333,145803,145980,177
102,21,alphacheck,135,145.026633333333,461.9735,145980,146156,176
102,21,alphacheck,135,116.953033333333,460.6141,146156,146245,89
102,0,blank,0,587.349975,345.981325,146303,146419,116
102,0,blank,0,868.57675,285.973875,146448,146563,115
102,0,blank,0,-323,-105,146621,146771,150
102,0,blank,0,90.0444333333333,475.466633333333,146801,146883,82
102,0,blank,0,114.7765,475.011666666667,146912,147086,174
102,21,alphacheck,135,129.7257,461.577966666667,147086,147263,177
102,0,blank,0,134.80752,481.27962,147263,147411,148
102,23,index,150,130.87915,505.9664,147439,147574,135
102,21,alphacheck,135,135.07005,458.944925,147574,147753,179
102,19,0,131,114.7395,414.8508,147753,147783,30
102,0,blank,0,107.3421,488.1429,147815,147847,32
102,0,blank,0,146.7791,484.1867,147910,147938,28
102,19,return,130,61.1974,416.2087,148023,148050,27
102,13,"%s",90,107.47815,271.1214,148164,148286,122
102,0,blank,0,190.802633333333,485.852333333333,148314,148500,186
102,21,char,137,185.031128571429,449.723685714286,148500,148689,189
102,0,blank,0,198.71985,426.57555,148689,148747,58
102,21,str,139,235.510083333333,445.833733333333,148775,148947,172
102,21,str,139,237.265866666667,448.2979,148947,149120,173
102,0,blank,0,285.42845,479.9905,149120,149293,173
102,21,int,141,282.64176,454.10942,149293,149458,165
102,21,int,141,297.815442857143,453.951157142857,149487,149686,199
102,0,blank,0,307.0374,444.4751,149686,149715,29
102,0,blank,0,-323,-105,149743,149898,155
102,0,blank,0,323.3394,536.3872,149983,150006,23
102,0,blank,0,335.126342857143,478.2174,150032,150229,197
102,0,blank,0,342.42842,473.94746,150229,150373,144
102,0,blank,0,343.2452,476.043933333333,150401,150593,192
102,0,blank,0,302.379728571429,483.010314285714,150593,150792,199
102,0,blank,0,243.987183333333,493.250716666667,150792,150964,172
102,0,blank,0,134.968614285714,475.222585714286,150993,151191,198
102,23,index,150,128.876766666667,499.300166666667,151191,151362,171
102,0,blank,0,121.8073,552.904366666667,151390,151475,85
102,24,=,155,117.347425,511.9573,151535,151650,115
102,24,;,164,148.59575,511.8801,151767,151818,51
102,24,=,155,122.94135,528.576583333333,151903,152079,176
102,29,),205,215.3756,621.9117,152079,152108,29
102,0,blank,0,132.5932,551.74405,152137,152196,59
102,0,blank,0,123.383866666667,558.616,152224,152395,171
102,24,i,165,101.92785,524.3572,152423,152481,58
102,0,blank,0,143.0356,550.5772,152540,152568,28
102,0,blank,0,-323,-105,152627,152778,151
102,26,tolower,174,181.650366666667,556.4649,152958,153034,76
102,0,blank,0,162.189716666667,543.219283333333,153063,153233,170
102,21,alphacheck,135,111.0076,457.8296,153233,153263,30
102,0,blank,0,154.379842857143,532.0501,153291,153488,197
102,24,i,165,166.038342857143,514.038485714286,153488,153687,199
102,0,blank,0,179.432766666667,540.327133333333,153687,153858,171
102,0,blank,0,109.072066666667,526.302316666667,153858,154057,199
102,26,[,177,117.936785714286,568.9595,154057,154254,197
102,0,blank,0,131.027985714286,541.3292,154254,154453,199
102,0,blank,0,161.598566666667,545.0758,154453,154625,172
102,26,tolower,174,186.658314285714,555.418142857143,154625,154824,199
102,0,blank,0,224.34074,530.154,154824,154967,143
102,24,strlen,160,254.61872,523.95208,154967,155132,165
102,0,blank,0,263.10868,534.48932,155132,155326,194
102,24,str,162,278.7629,524.28615,155326,155378,52
102,0,blank,0,290.705283333333,544.375566666667,155433,155605,172
102,0,blank,0,264.4118,471.103716666667,155633,155806,173
102,0,blank,0,274.43874,466.88616,155806,155997,191
102,0,blank,0,243.66175,484.93755,155997,156072,75
102,21,str,139,245.933716666667,458.951183333333,156098,156269,171
102,0,blank,0,222.428566666667,490.459066666667,156269,156441,172
102,0,blank,0,230.477416666667,530.6614,156441,156613,172
102,21,alphacheck,135,95.3883,462.15075,156613,156671,58
102,0,blank,0,112.8997,526.758316666667,156699,156894,195
102,27,index,182,103.3435,589.0075,156894,156922,28
102,24,0,156,138.895166666667,525.427416666667,156950,157123,173
102,0,blank,0,179.335066666667,527.987933333333,157123,157295,172
102,0,blank,0,220.610166666667,487.321666666667,157295,157467,172
102,0,blank,0,261.554783333333,499.215883333333,157467,157639,172
102,21,str,139,228.889583333333,459.421033333333,157667,157838,171
102,0,blank,0,237.61655,496.737,157838,157895,57
102,0,blank,0,284.311,536.911933333333,157925,158010,85
102,24,str,162,281.42812,513.06552,158038,158227,189
102,0,blank,0,257.5701,501.916957142857,158227,158425,198
102,0,blank,0,262.932516666667,457.90095,158425,158624,199
102,21,str,139,253.0961,455.5596,158624,158738,114
102,9,],65,164.128433333333,197.63875,158794,158966,172
102,9,],65,165.53745,187.236316666667,158966,159158,192
102,10,CHAR_SIZE,70,132.508,208.654466666667,159158,159331,173
102,10,CHAR_SIZE,70,146.925533333333,214.670383333333,159331,159504,173
102,9,str1,57,114.010771428571,186.291871428571,159504,159702,198
102,9,50,64,162.77365,181.810983333333,159702,159874,172
102,10,CHAR_SIZE,70,193.690683333333,202.872333333333,159874,160047,173
102,9,str2,62,221.613716666667,187.392566666667,160047,160240,193
102,0,blank,0,231.26546,158.1865,160240,160383,143
102,11,str2_rem,78,125.6978,226.739728571429,160441,160636,195
102,9,str1,57,102.7606,191.049116666667,160636,160808,172
102,11,str2_rem,78,137.088116666667,236.3601,160808,160979,171
102,11,str2_rem,78,151.10125,228.722483333333,160979,161152,173
102,11,str2_rem,78,156.8489,236.1447,161152,161347,195
102,11,[,79,181.135375,228.158675,161347,161461,114
102,0,blank,0,-323,-105,161519,161620,101
102,11,str2_rem,78,165.850385714286,228.903528571429,161755,161952,197
102,10,CHAR_SIZE,70,122.0208,210.64574,161952,162100,148
102,10,CHAR_SIZE,70,141.470666666667,214.471266666667,162158,162355,197
102,0,blank,0,145.5163,223.67196,162384,162529,145
102,12,"Enterstring1:",85,138.093328571429,257.878371428571,162587,162781,194
102,11,str2_rem,78,126.13666,242.54946,162781,162966,185
102,13,"%s",90,114.88188,267.32066,162966,163156,190
102,11,str2_rem,78,156.7863,239.36385,163156,163328,172
102,13,"%s",90,142.23786,277.27656,163328,163522,194
102,12,printf,83,81.1065571428571,251.425128571429,163522,163719,197
102,11,char,77,80.1335,234.5369,163719,163842,123
102,11,char,77,64.8636,242.7046,163842,164000,158
102,18,printf,123,74.31815,395.267783333333,164112,164311,199
102,17,create,114,63.2238,360.1191,164311,164340,29
102,0,blank,0,52.1607,456.0771,164369,164399,30
102,23,i,148,90.451975,497.55015,164428,164542,114
102,23,i,148,87.9420166666667,491.477633333333,164571,164744,173
102,24,;,164,151.4338,515.361466666667,164744,164830,86
102,0,blank,0,127.6492,512.6362,164859,164917,58
102,16,alphacheck,107,74.8945714285714,341.611957142857,164975,165171,196
102,15,scanf,100,73.76326,325.8233,165171,165361,190
102,15,scanf,100,84.1836666666667,315.65395,165361,165557,196
102,14,printf,95,95.22204,299.42128,165557,165734,177
102,15,"%s",102,137.3687,320.810033333333,165734,165929,195
102,16,alphacheck,107,136.15415,336.053333333333,165929,166103,174
102,15,(,101,97.3974333333333,316.896566666667,166103,166279,176
102,16,alphacheck,107,121.829566666667,341.9341,166279,166413,134
102,16,(,108,149.701733333333,347.503866666667,166413,166570,157
102,17,str2_rem,116,192.911425,363.2632,166570,166729,159
102,17,str2_rem,116,171.754725,361.82785,166729,166917,188
102,16,str1,109,154.83896,337.20926,166917,167100,183
102,0,blank,0,103.05356,324.3876,167100,167250,150
102,15,scanf,100,88.9613666666667,327.695833333333,167250,167435,185
102,15,scanf,100,67.0900666666667,314.499183333333,167435,167611,176
102,14,printf,95,48.36645,294.6278,167611,167669,58
102,0,blank,0,984.6312,302.34594,167788,167930,142
102,0,blank,0,1025.25233333333,287.1299,167930,168129,199
102,0,blank,0,1017.55466666667,303.724666666667,168129,168306,177
102,0,blank,0,1024.27666666667,309.395866666667,168306,168482,176
102,0,blank,0,1028.59533333333,313.6634,168482,168657,175
102,0,blank,0,1033.19733333333,321.29565,168657,168833,176
102,0,blank,0,1023.843,321.410516666667,168833,169008,175
102,0,blank,0,1027.636,332.371033333333,169008,169182,174
102,0,blank,0,1031.1686,345.50356,169182,169328,146
102,0,blank,0,1047.4605,331.0475,169328,169526,198
102,0,blank,0,1026.40366666667,332.362716666667,169526,169723,197
102,0,blank,0,1034.4225,329.538883333333,169723,169898,175
102,0,blank,0,1039.27033333333,322.232666666667,169898,170095,197
102,0,blank,0,1036.2,328.16038,170095,170242,147
103,0,blank,0,1020.7852,475.44502,172020,172166,146
103,0,blank,0,999.57525,498.5183,172166,172349,183
103,0,blank,0,1008.08016666667,487.591033333333,172349,172518,169
103,0,blank,0,-323,-105,172606,172708,102
103,0,blank,0,332.2902,562.3816,172733,172759,26
103,12,"Enterstring1:",85,181.085166666667,102.4231,172822,173011,189
103,12,"Enterstring1:",85,192.3218,102.402866666667,173011,173183,172
103,12,"Enterstring1:",85,179.97755,83.01525,173183,173325,142
103,0,blank,0,134.96275,31.61055,173352,173412,60
103,0,blank,0,154.8046,414.0054,173531,173658,127
103,24,;,164,148.26915,349.327925,173658,173840,182
103,21,alphacheck,135,80.607425,300.1661,173840,174022,182
103,21,alphacheck,135,81.6568,294.17256,174022,174212,190
103,0,blank,0,45.64698,287.24188,174212,174394,182
103,21,alphacheck,135,74.35236,298.43252,174394,174568,174
103,21,alphacheck,135,118.137466666667,293.2249,174568,174746,178
103,21,alphacheck,135,117.149666666667,282.8577,174746,174854,108
103,12,"Enterstring1:",85,132.98675,95.513675,174905,175024,119
103,0,blank,0,-323,-105,175083,175188,105
103,13,str1,92,165.744533333333,108.406666666667,175271,175460,189
103,0,blank,0,159.198466666667,108.614183333333,175460,175640,180
103,14,"Enterstring2:",97,163.5884,136.805,175640,175818,178
103,0,blank,0,137.820633333333,169.01525,175818,175999,181
103,16,alphacheck,107,137.13464,182.88414,175999,176180,181
103,0,blank,0,204.212333333333,172.8321,176180,176356,176
103,15,str2,104,190.203066666667,153.628883333333,176356,176534,178
103,0,blank,0,153.227333333333,345.577583333333,176564,176742,178
103,0,blank,0,163.190433333333,301.6017,176742,176923,181
103,21,char,137,194.929833333333,283.121483333333,176923,177100,177
103,21,str,139,228.312583333333,281.013833333333,177100,177276,176
103,0,blank,0,251.9933,279.5122,177276,177335,59
103,0,blank,0,185.31435,125.160083333333,177365,177542,177
103,16,str1,109,168.628775,170.311,177542,177732,190
103,15,"%s",102,105.590583333333,153.661133333333,177732,177910,178
103,0,blank,0,114.8271,147.9779,177910,177940,30
103,0,blank,0,-323,-105,179201,179399,198
103,0,blank,0,-323,-105,179399,179584,185
103,0,blank,0,-323,-105,179584,179768,184
103,0,blank,0,-323,-105,179768,179854,86
103,29,index,203,177.533266666667,475.699233333333,179925,180122,197
103,0,blank,0,178.155028571429,478.455714285714,180122,180321,199
103,29,index,203,180.89486,464.2621,180321,180464,143
103,0,blank,0,189.0032,480.2867,180522,180552,30
103,29,index,203,166.190633333333,459.176216666667,180610,180802,192
103,28,"in=%d",193,174.331785714286,437.697942857143,180802,181000,198
103,29,],204,208.381716666667,459.579116666667,181000,181171,171
103,0,blank,0,191.1807,488.97378,181171,181343,172
103,0,blank,0,254.70905,473.61495,181343,181537,194
103,0,blank,0,154.87025,497.42045,181537,181709,172
103,31,index,209,150.66806,506.96216,181709,181886,177
103,29,index,203,161.381228571429,475.898757142857,181917,182116,199
103,29,index,203,163.4985,464.333333333333,182116,182200,84
103,0,blank,0,181.12265,492.504333333333,182311,182479,168
103,31,],210,198.483728571429,517.061714285714,182535,182733,198
103,0,blank,0,204.284857142857,525.256114285714,182733,182930,197
103,0,blank,0,229.3845,502.199816666667,182930,183103,173
103,0,blank,0,198.688228571429,549.375514285714,183103,183302,199
103,0,blank,0,177.99308,559.94976,183302,183437,135
103,0,blank,0,185.9256,-103.8199,183465,183570,105
103,0,blank,0,204.429566666667,539.674733333333,183596,183791,195
103,0,blank,0,189.660033333333,554.93485,183791,183964,173
103,0,blank,0,146.57046,550.42108,183964,184132,168
103,0,blank,0,138.1377,544.33335,184132,184228,96
103,0,blank,0,-323,-105,184337,184436,99
103,0,blank,0,-323,-105,184436,184557,121
103,15,"%s",102,132.94465,152.41995,184597,184776,179
103,14,"Enterstring2:",97,130.4155,135.6293,184776,184805,29
103,0,blank,0,146.001033333333,147.814266666667,184864,185041,177
103,15,str2,104,185.695183333333,166.3584,185041,185218,177
103,10,CHAR_SIZE,70,192.980633333333,57.57635,185218,185393,175
103,9,50,64,154.809116666667,27.0371333333333,185393,185569,176
103,0,blank,0,124.37325,-6.63955,185569,185746,177
103,0,blank,0,70.9791166666667,3.40671666666667,185746,185925,179
103,0,blank,0,72.3766333333333,8.27346666666667,185925,186103,178
103,0,blank,0,110.23585,1.05906666666667,186103,186282,179
103,0,blank,0,107.41155,37.95465,186282,186341,59
103,0,blank,0,-323,-105,186371,186501,130
103,0,blank,0,-323,-105,186501,186579,78
103,0,blank,0,181.211683333333,12.4951666666667,186607,186781,174
103,9,50,64,158.274833333333,21.1097,186781,186963,182
103,9,str1,57,121.44592,33.2669,186963,187142,179
103,10,CHAR_SIZE,70,181.240433333333,41.8835166666667,187142,187333,191
103,9,str2,62,220.730733333333,35.1008833333333,187333,187510,177
103,0,blank,0,197.6011,-0.544750000000001,187510,187570,60
103,0,blank,0,-323,-105,187598,187678,80
103,0,blank,0,125.8437,-1.2132,187703,187739,36
103,10,CHAR_SIZE,70,113.240616666667,47.3709666666667,187868,188040,172
103,0,blank,0,75.4001,52.87675,188040,188101,61
103,10,a1,68,103.676228571429,46.6525714285714,188163,188362,199
103,0,blank,0,91.4849666666667,79.8437,188362,188532,170
103,10,CHAR_SIZE,70,156.111366666667,51.2660166666667,188532,188712,180
103,12,"Enterstring1:",85,172.573283333333,83.6192,188712,188889,177
103,12,"Enterstring1:",85,200.112183333333,102.045316666667,188889,189070,181
103,13,str1,92,175.5442,109.741133333333,189070,189160,90
103,12,"Enterstring1:",85,195.100483333333,95.1869833333333,189216,189390,174
103,0,blank,0,157.60025,105.68495,189390,189561,171
103,13,(,89,97.6899,117.415333333333,189561,189743,182
103,13,"%s",90,121.52765,119.913483333333,189743,189923,180
103,13,str1,92,174.24855,117.543275,189923,190040,117
103,14,"Enterstring2:",97,199.092883333333,140.095316666667,190071,190249,178
103,14,"Enterstring2:",97,118.348083333333,144.7417,190249,190426,177
103,15,"%s",102,132.678266666667,155.6719,190426,190598,172
103,14,"Enterstring2:",97,134.137966666667,144.819716666667,190598,190771,173
103,15,"%s",102,138.433916666667,167.008666666667,190771,190945,174
103,14,"Enterstring2:",97,123.04758,135.08972,190945,191089,144
103,0,blank,0,-323,-105,191145,191220,75
103,0,blank,0,113.37395,146.0632,191337,191387,50
103,0,blank,0,185.7825,254.58,191473,191506,33
103,15,comma,103,149.793871428571,157.161971428571,191535,191733,198
103,15,str2,104,170.3062,150.660616666667,191733,191905,172
103,15,str2,104,191.00965,168.7312,191905,192079,174
103,16,alphacheck,107,139.431616666667,174.101633333333,192079,192252,173
103,15,scanf,100,70.6228333333333,148.25415,192280,192451,171
103,14,(,96,112.193471428571,139.104571428571,192451,192650,199
103,14,"Enterstring2:",97,130.669166666667,130.444166666667,192650,192823,173
103,16,alphacheck,107,84.1064,170.759266666667,192823,192995,172
103,15,scanf,100,84.13686,164.13872,192995,193140,145
103,0,blank,0,197.820033333333,334.705133333333,193169,193346,177
103,0,blank,0,210.63594,293.39844,193346,193494,148
103,0,blank,0,-323,-105,193524,193704,180
103,0,blank,0,-323,-105,193704,193883,179
103,0,blank,0,-323,-105,193883,194070,187
103,0,blank,0,-323,-105,194070,194250,180
103,0,blank,0,-323,-105,194250,194428,178
103,0,blank,0,-323,-105,194428,194607,179
103,0,blank,0,-323,-105,194607,194784,177
103,0,blank,0,-323,-105,194784,194963,179
103,0,blank,0,-323,-105,194963,195142,179
103,0,blank,0,-323,-105,195142,195320,178
103,0,blank,0,-323,-105,195320,195498,178
103,0,blank,0,-323,-105,195498,195674,176
103,0,blank,0,-323,-105,195674,195864,190
103,0,blank,0,-323,-105,195864,196060,196
103,0,blank,0,-323,-105,196060,196243,183
103,0,blank,0,-323,-105,196243,196428,185
103,0,blank,0,-323,-105,196428,196620,192
103,0,blank,0,-323,-105,196620,196809,189
103,0,blank,0,-323,-105,196809,197000,191
103,0,blank,0,-323,-105,197000,197169,169
103,0,blank,0,-323,-105,197169,197363,194
103,0,blank,0,-323,-105,197363,197552,189
103,0,blank,0,-323,-105,197552,197733,181
103,0,blank,0,-323,-105,197733,197919,186
103,0,blank,0,-323,-105,197919,198110,191
103,0,blank,0,-323,-105,198110,198295,185
103,0,blank,0,-323,-105,198295,198480,185
103,0,blank,0,-323,-105,198480,198671,191
103,0,blank,0,-323,-105,198671,198859,188
103,0,blank,0,-323,-105,198859,199047,188
103,0,blank,0,-323,-105,199047,199155,108
103,0,blank,0,141.76448,-103.77584,199309,199456,147
103,0,blank,0,153.12455,-103.81155,199585,199653,68
103,0,blank,0,-323,-105,199730,199927,197
103,0,blank,0,-323,-105,199927,200120,193
103,0,blank,0,-323,-105,200120,200299,179
103,0,blank,0,-323,-105,200299,200462,163
103,0,blank,0,263.423533333333,378.137566666667,200488,200683,195
103,27,-,188,235.2796,426.2809,200683,200733,50
103,26,str,176,261.804233333333,400.189766666667,200773,200889,116
103,26,i,178,132.40108,401.60052,200965,201143,178
103,27,=,183,148.696175,421.0652,201143,201280,137
103,26,i,178,133.605366666667,410.852916666667,201308,201479,171
103,26,],179,135.91525,393.477525,201479,201594,115
103,0,blank,0,213.9987,387.79535,201651,201824,173
103,0,blank,0,271.629766666667,375.503533333333,201824,201996,172
103,26,i,178,298.447683333333,404.771983333333,201996,202193,197
103,0,blank,0,284.478316666667,368.254983333333,202218,202390,172
103,0,blank,0,280.4189,327.8965,202390,202446,56
103,0,blank,0,-323,-105,202503,202654,151
103,27,a,189,271.4337,413.639,202680,202706,26
103,26,str,176,267.266428571429,403.441785714286,202753,202940,187
103,0,blank,0,188.72275,412.612533333333,202940,203113,173
103,28,printf,191,137.167516666667,444.715283333333,203113,203288,175
103,28,printf,191,116.572516666667,435.781,203288,203462,174
103,27,index,182,120.17165,429.848433333333,203462,203633,171
103,28,printf,191,129.991957142857,436.406871428571,203633,203832,199
103,28,"in=%d",193,179.962928571429,444.428514285714,203832,204031,199
103,28,"in=%d",193,188.242583333333,442.206283333333,204031,204205,174
103,27,[,185,199.927666666667,430.547933333333,204205,204377,172
103,0,blank,0,254.53262,429.97566,204377,204551,174
103,28,index,195,258.30935,454.46,204551,204715,164
103,28,index,195,242.03525,449.65515,204715,204891,176
103,27,a,189,260.0297,428.6953,204891,204938,47
103,27,=,183,143.592728571429,420.245671428571,204994,205191,197
103,0,blank,0,-323,-105,205248,205404,156
103,0,blank,0,142.232833333333,406.5863,205506,205585,79
103,26,tolower,174,219.253866666667,402.810266666667,205614,205786,172
103,26,tolower,174,220.900533333333,394.081833333333,205786,205873,87
103,0,blank,0,421.944,-103.5531,205931,205959,28
103,0,blank,0,-323,-105,206018,206069,51
103,0,blank,0,-323,-105,206253,206529,276
103,0,blank,0,-323,-105,206529,206626,97
103,0,blank,0,626.555466666667,-103.8462,206859,206947,88
103,0,blank,0,669.8243,-103.849,207218,207406,188
103,0,blank,0,650.1013,-103.870383333333,207406,207601,195
103,0,blank,0,707.5885,-103.81795,207601,207787,186
103,0,blank,0,673.7048,-103.7994,207787,207812,25
103,0,blank,0,-323,-105,208061,208218,157
103,0,blank,0,-323,-105,208218,208412,194
103,0,blank,0,-323,-105,208412,208552,140
103,0,blank,0,-323,-105,208552,208703,151
103,0,blank,0,-323,-105,208703,208845,142
103,0,blank,0,-323,-105,208845,208961,116
103,0,blank,0,-323,-105,208961,209195,234
103,0,blank,0,-323,-105,209195,209245,50
103,0,blank,0,-323,-105,209245,209584,339
103,0,blank,0,-323,-105,209584,209750,166
103,0,blank,0,-323,-105,209750,209923,173
103,0,blank,0,-323,-105,209923,210419,496
103,0,blank,0,-323,-105,210419,210953,534
103,0,blank,0,-323,-105,210953,211083,130
103,0,blank,0,-323,-105,211083,211334,251
103,0,blank,0,-323,-105,211334,211529,195
103,0,blank,0,-323,-105,211529,211703,174
103,0,blank,0,-323,-105,211703,212180,477
103,0,blank,0,-323,-105,212180,212245,65
103,0,blank,0,-323,-105,212245,212920,675
103,0,blank,0,-323,-105,212920,213117,197
103,0,blank,0,-323,-105,213117,213281,164
103,0,blank,0,-323,-105,213281,213448,167
103,0,blank,0,-323,-105,213448,214009,561
103,0,blank,0,-323,-105,214009,214183,174
103,0,blank,0,-323,-105,214183,214346,163
103,0,blank,0,-323,-105,214346,214492,146
103,0,blank,0,-323,-105,214492,214680,188
103,0,blank,0,-323,-105,214680,214769,89
103,0,blank,0,-323,-105,214769,214941,172
103,0,blank,0,-323,-105,214941,215049,108
103,0,blank,0,-323,-105,215049,215193,144
103,0,blank,0,-323,-105,215193,215466,273
103,0,blank,0,-323,-105,215466,215593,127
103,0,blank,0,-323,-105,215593,215695,102
103,0,blank,0,-323,-105,215695,215851,156
103,0,blank,0,-323,-105,215851,216184,333
103,0,blank,0,-323,-105,216184,216444,260
103,0,blank,0,-323,-105,216444,216624,180
103,0,blank,0,-323,-105,216624,216879,255
103,0,blank,0,-323,-105,216879,217133,254
103,0,blank,0,-323,-105,217133,217159,26
103,0,blank,0,-323,-105,217159,217764,605
103,0,blank,0,-323,-105,217764,217895,131
103,27,index,182,130.9474,413.0721,218488,218522,34
103,28,printf,191,100.49844,451.49748,218598,218791,193
103,27,index,182,133.065266666667,422.7708,218891,219069,178
103,27,=,183,149.262066666667,429.0099,219069,219153,84
103,0,blank,0,203.55965,416.3673,219212,219268,56
103,27,=,183,149.22795,424.54475,219328,219382,54
103,26,tolower,174,183.30235,405.60475,219438,219494,56
103,0,blank,0,-323,-105,219522,219676,154
103,27,str,184,168.7799,432.6891,219701,219727,26
103,0,blank,0,170.633485714286,410.0543,219779,219960,181
103,27,index,182,91.7818166666667,414.9438,219960,220136,176
103,0,blank,0,230.9781,374.5752,220167,220198,31
103,28,printf,191,122.56806,442.76552,220254,220428,174
103,26,i,178,132.08258,408.9421,220428,220600,172
103,26,tolower,174,174.390885714286,406.830714285714,220600,220798,198
103,26,tolower,174,174.700442857143,407.5739,220798,220993,195
103,0,blank,0,193.299583333333,386.701766666667,220993,221191,198
103,0,blank,0,202.16365,381.29365,221191,221248,57
103,26,str,176,101.3597,405.741325,221279,221397,118
103,0,blank,0,116.4538,379.7048,221456,221635,179
103,24,strlen,160,215.588833333333,346.074483333333,221635,221813,178
103,24,strlen,160,245.08405,366.28475,221813,221992,179
103,0,blank,0,243.136783333333,374.900966666667,221992,222171,179
103,0,blank,0,186.970916666667,345.086783333333,222171,222353,182
103,24,=,155,122.613816666667,353.409466666667,222353,222530,177
103,23,index,150,121.460816666667,340.304866666667,222530,222706,176
103,23,index,150,153.442,329.3701,222706,222735,29
103,27,index,182,90.5824333333333,414.627833333333,222765,222853,88
103,26,str,176,95.7988166666667,399.71045,222944,223123,179
103,26,str,176,100.3831,393.9632,223123,223214,91
103,0,blank,0,177.7438,565.5264,223244,223274,30
103,0,blank,0,147.250266666667,406.1646,223301,223483,182
103,26,tolower,174,197.0006,398.21775,223483,223539,56
103,0,blank,0,-323,-105,223599,223785,186
103,26,tolower,174,181.192757142857,409.430385714286,223811,223995,184
103,27,str,184,190.9369,428.940757142857,223995,224194,199
103,27,str,184,186.924733333333,420.405933333333,224194,224366,172
103,27,str,184,191.666528571429,420.327314285714,224366,224564,198
103,0,blank,0,228.117228571429,418.2386,224564,224762,198
103,27,-,188,237.026766666667,430.0486,224762,224944,182
103,28,index,195,247.3081,436.6678,224944,225090,146
103,27,],187,217.0345,430.387,225090,225166,76
103,0,blank,0,-323,-105,225261,225370,109
103,0,blank,0,206.2809,479.518,225410,225463,53
103,27,-,188,236.043442857143,415.922485714286,225544,225731,187
103,26,tolower,174,220.673333333333,403.603266666667,225731,225819,88
103,27,str,184,171.69785,432.9619,225846,225904,58
103,29,a,201,136.3193,467.1754,225904,226212,308
103,28,"in=%d",193,163.229042857143,449.578128571429,226212,226399,187
103,26,tolower,174,207.147433333333,406.154716666667,226399,226571,172
103,28,"in=%d",193,164.5749,441.217,226571,226629,58
103,0,blank,0,-323,-105,226657,226760,103
103,0,blank,0,221.7796,480.1693,226863,226938,75
103,26,tolower,174,187.254285714286,399.750985714286,226963,227158,195
103,27,-,188,241.1056,416.1077,227158,227187,29
103,27,=,183,143.930833333333,424.544766666667,227242,227425,183
103,26,tolower,174,189.0519,410.8996,227425,227452,27
103,27,],187,214.194,422.410766666667,227510,227692,182
103,0,blank,0,251.662785714286,424.778828571429,227692,227879,187
103,0,blank,0,245.65265,429.4165,227879,227937,58
103,0,blank,0,-323,-105,227993,228145,152
103,27,-,188,238.5359,430.3767,228274,228385,111
103,0,blank,0,247.497975,414.847675,228412,228525,113
103,0,blank,0,73.3547,411.274033333333,228552,228731,179
103,0,blank,0,90.304,433.29235,228731,228792,61
103,28,printf,191,107.2365,442.655383333333,228852,229033,181
103,28,printf,191,83.0916,451.7322,229033,229064,31
103,0,blank,0,-323,-105,229155,229286,131
103,0,blank,0,61.9046,436.6729,229382,229406,24
103,0,blank,0,112.639975,480.5248,229498,229609,111
103,28,printf,191,87.85948,444.16648,229638,229779,141
103,27,str,184,174.86105,431.952616666667,229808,229981,173
103,0,blank,0,144.781816666667,447.363166666667,229981,230165,184
103,27,-,188,234.9244,428.45395,230165,230343,178
103,0,blank,0,233.980866666667,458.776733333333,230343,230428,85
103,0,blank,0,-323,-105,230456,230637,181
103,0,blank,0,-323,-105,230637,230813,176
103,0,blank,0,-323,-105,230813,231003,190
103,0,blank,0,-323,-105,231003,231182,179
103,0,blank,0,-323,-105,231182,231359,177
103,0,blank,0,-323,-105,231359,231546,187
103,0,blank,0,-323,-105,231546,231731,185
103,0,blank,0,-323,-105,231731,231921,190
103,0,blank,0,-323,-105,231921,232098,177
103,0,blank,0,-323,-105,232098,232138,40
103,39,=,253,113.9422,689.6063,232283,232308,25
103,0,blank,0,267.6942,-103.9898,232390,232418,28
103,0,blank,0,92.826625,733.484725,232445,232565,120
103,0,blank,0,77.63485,760.3343,232619,232675,56
103,0,blank,0,217.3502,-103.9228,232736,232761,25
103,0,blank,0,94.2236,704.324,232844,232872,28
103,26,i,178,132.044716666667,409.843,233111,233286,175
103,0,blank,0,151.4405,401.4295,233286,233316,30
103,21,alphacheck,135,130.9243,290.3095,233342,233370,28
103,0,blank,0,151.194071428571,377.202442857143,233399,233596,197
103,27,str,184,186.901,413.0878,233596,233625,29
103,21,alphacheck,135,89.52905,291.32535,233653,233712,59
103,21,*,138,221.0617,287.7025,233743,233773,30
103,21,alphacheck,135,90.6042,294.51615,233802,233861,59
103,0,blank,0,243.372,419.0511,233890,233921,31
103,23,int,147,55.72325,338.138625,233949,234068,119
103,0,blank,0,81.5404333333333,360.8355,234100,234186,86
103,24,(,161,90.3683,362.8265,234216,234248,32
103,0,blank,0,110.423666666667,344.839966666667,234308,234396,88
103,28,printf,191,114.983733333333,438.2414,234426,234607,181
103,0,blank,0,135.3104,433.7587,234607,234639,32
103,0,blank,0,194.5497,483.904,234668,234697,29
103,28,printf,191,107.87545,445.8794,234726,234900,174
103,26,=,173,163.9087,410.629,234900,234986,86
103,0,blank,0,-323,-105,235015,235169,154
103,27,=,183,143.6942,415.7739,235209,235261,52
103,28,"in=%d",193,220.5987,452.0346,235384,235437,53
103,27,str,184,170.63695,429.7908,235465,235644,179
103,28,"in=%d",193,173.850014285714,443.470557142857,235644,235843,199
103,0,blank,0,-323,-105,235872,236051,179
103,0,blank,0,-323,-105,236051,236083,32
103,28,"in=%d",193,173.10235,440.678416666667,236269,236443,174
103,29,index,203,188.0247,457.4983,236443,236471,28
103,28,"in=%d",193,162.394183333333,444.332466666667,236526,236704,178
103,26,tolower,174,189.29135,405.6978,236704,236765,61
103,0,blank,0,-323,-105,236828,236955,127
103,0,blank,0,-323,-105,236955,237053,98
103,39,strlen,258,216.973033333333,694.930083333333,237168,237337,169
103,38,;,249,236.622375,662.8136,237337,237476,139
103,0,blank,0,-323,-105,237970,238147,177
103,0,blank,0,-323,-105,238147,238345,198
103,0,blank,0,-323,-105,238345,238520,175
103,0,blank,0,-323,-105,238520,238595,75
103,0,blank,0,-323,-105,238595,238953,358
103,0,blank,0,-323,-105,238953,239138,185
103,0,blank,0,-323,-105,239138,239315,177
103,0,blank,0,-323,-105,239315,239430,115
103,28,"in=%d",193,166.17785,436.62035,239461,239646,185
103,28,"in=%d",193,221.00066,444.0326,239723,239898,175
103,0,blank,0,226.347516666667,421.867366666667,239898,240092,194
103,28,"in=%d",193,217.036716666667,435.229866666667,240092,240266,174
103,27,str,184,178.072116666667,430.592716666667,240266,240438,172
103,0,blank,0,144.508483333333,442.920516666667,240438,240614,176
103,28,"in=%d",193,210.384716666667,447.7086,240614,240812,198
103,27,a,189,276.532457142857,421.822257142857,240812,241008,196
103,27,a,189,271.051366666667,419.1077,241036,241229,193
103,26,str,176,282.3503,407.2011,241229,241314,85
103,0,blank,0,-323,-105,241370,241496,126
103,0,blank,0,291.0002,467.3461,241521,241547,26
103,26,str,176,266.438614285714,409.987542857143,241609,241796,187
103,27,a,189,278.24544,422.39698,241796,241938,142
103,0,blank,0,132.610814285714,476.649957142857,241966,242165,199
103,29,[,202,147.166314285714,465.899214285714,242165,242364,199
103,29,index,203,188.969,471.274257142857,242364,242562,198
103,0,blank,0,212.712371428571,465.315585714286,242562,242760,198
103,28,"in=%d",193,208.533733333333,451.2496,242760,242845,85
103,28,"in=%d",193,222.880428571429,452.476171428571,242873,243072,199
103,28,"in=%d",193,197.195357142857,451.284528571429,243072,243271,199
103,28,"in=%d",193,199.272485714286,453.433628571429,243271,243470,199
103,28,"in=%d",193,174.0249,449.4532,243470,243499,29
103,0,blank,0,-323,-105,243527,243657,130
103,28,"in=%d",193,210.9732,437.8821,243690,243735,45
103,28,"in=%d",193,216.739314285714,453.534514285714,243797,243990,193
103,0,blank,0,228.284771428571,459.467728571429,243990,244189,199
103,0,blank,0,234.0959,458.587233333333,244189,244359,170
103,28,"in=%d",193,200.523516666667,448.709783333333,244416,244589,173
103,29,],204,207.33195,471.07405,244589,244646,57
103,0,blank,0,-323,-105,244786,244959,173
103,0,blank,0,-323,-105,244959,245154,195
103,0,blank,0,-323,-105,245154,245330,176
103,0,blank,0,-323,-105,245330,245434,104
103,0,blank,0,-323,-105,245434,245541,107
103,0,blank,0,-323,-105,245541,245703,162
103,0,blank,0,-323,-105,245703,245866,163
103,0,blank,0,-323,-105,245866,246065,199
103,0,blank,0,-323,-105,246065,246257,192
103,0,blank,0,-323,-105,246257,246302,45
103,0,blank,0,239.8371,480.34415,246838,246900,62
103,28,comma,194,230.265671428571,451.440085714286,246929,247128,199
103,28,comma,194,228.535433333333,447.395183333333,247128,247300,172
103,0,blank,0,243.236314285714,472.283257142857,247300,247499,199
103,28,index,195,246.260571428571,451.584557142857,247499,247698,199
103,0,blank,0,268.595528571429,467.0267,247698,247897,199
103,28,index,195,262.9232,445.16875,247897,247953,56
103,27,index,182,133.398333333333,426.665183333333,247982,248154,172
103,28,"in=%d",193,155.37,453.00525,248154,248326,172
103,27,str,184,192.262633333333,426.05805,248326,248499,173
103,27,str,184,187.5721,432.4399,248499,248586,87
103,0,blank,0,-323,-105,248643,248749,106
103,0,blank,0,240.4813,500.4619,248776,248804,28
103,29,),205,215.548814285714,468.969085714286,248869,249063,194
103,0,blank,0,150.408933333333,483.717666666667,249063,249237,174
103,0,blank,0,151.04775,491.815466666667,249237,249409,172
103,0,blank,0,164.003233333333,486.6222,249409,249496,87
103,0,blank,0,-323,-105,249525,249705,180
103,0,blank,0,234.7661,462.4915,249743,249794,51
103,28,"in=%d",193,218.568833333333,449.340783333333,249858,250049,191
103,28,index,195,235.6029,434.452557142857,250049,250248,199
103,27,a,189,273.735333333333,429.5453,250248,250333,85
103,0,blank,0,-323,-105,250391,250519,128
103,0,blank,0,535.5109,610.323,250644,250668,24
103,0,blank,0,505.06704,707.58438,250693,250832,139
103,0,blank,0,493.8065,642.5793,250832,250918,86
103,0,blank,0,507.4149,669.6992,250918,251057,139
103,0,blank,0,494.29136,662.39246,251148,251318,170
103,0,blank,0,481.438033333333,656.048533333333,251318,251434,116
103,0,blank,0,556.5159,601.1023,251757,251931,174
103,0,blank,0,517.017575,695.269775,252267,252462,195
103,0,blank,0,538.127633333333,638.2634,252462,252650,188
103,0,blank,0,586.14735,615.33075,252650,252750,100
103,0,blank,0,-323,-105,252775,252875,100
103,0,blank,0,428.5145,639.3499,252900,252925,25
103,0,blank,0,-323,-105,253004,253154,150
103,21,comma,140,257.0065,298.947,253293,253439,146
103,28,comma,194,230.572,437.97895,253535,253646,111
103,0,blank,0,147.7192,408.33805,253732,253811,79
103,0,blank,0,225.4893,338.2962,253851,253923,72
103,0,blank,0,183.085466666667,412.278733333333,254073,254190,117
103,0,blank,0,329.90798,276.80862,254229,254414,185
103,0,blank,0,303.07345,246.5788,254414,254469,55
103,28,index,195,280.814628571429,442.891285714286,254550,254745,195
103,28,index,195,267.67706,439.68328,254745,254930,185
103,26,i,178,303.16205,393.868533333333,254930,255121,191
103,0,blank,0,330.06248,276.2453,255121,255262,141
103,0,blank,0,328.381733333333,278.357133333333,255262,255419,157
103,27,a,189,263.734,421.244133333333,255469,255644,175
103,27,a,189,278.9505,423.167333333333,255644,255794,150
103,0,blank,0,-323,-105,255844,255998,154
103,0,blank,0,277.7725,560.6854,256141,256166,25
103,24,;,164,148.0934,358.195,256275,256416,141
103,27,str,184,192.69036,417.0148,256525,256721,196
103,28,"in=%d",193,160.12215,438.21015,256799,256877,78
103,26,tolower,174,217.488666666667,399.074133333333,257126,257209,83
103,0,blank,0,-323,-105,257238,257391,153
103,0,blank,0,-323,-105,257451,257488,37
103,0,blank,0,220.9094,412.836514285714,257514,257701,187
103,0,blank,0,210.95545,433.372233333333,257759,257932,173
103,28,"in=%d",193,202.623466666667,443.422683333333,257932,258106,174
103,0,blank,0,203.90305,412.7879,258106,258165,59
103,27,str,184,192.62202,422.05068,258329,258502,173
103,0,blank,0,171.71488,409.01846,258502,258697,195
103,0,blank,0,-323,-105,258857,259049,192
103,0,blank,0,-323,-105,259049,259244,195
103,0,blank,0,-323,-105,259244,259381,137
103,0,blank,0,-323,-105,259381,259544,163
103,0,blank,0,-323,-105,259544,259719,175
103,0,blank,0,-323,-105,259719,259826,107
103,0,blank,0,-323,-105,259826,260032,206
103,0,blank,0,-323,-105,260032,260267,235
103,0,blank,0,-323,-105,260267,260455,188
103,0,blank,0,-323,-105,260455,260510,55
103,0,blank,0,-323,-105,260510,260898,388
103,0,blank,0,-323,-105,260898,261072,174
103,0,blank,0,-323,-105,261072,261134,62
103,0,blank,0,-323,-105,261134,261548,414
103,0,blank,0,-323,-105,261548,261965,417
103,0,blank,0,-323,-105,261965,262693,728
103,0,blank,0,-323,-105,262693,262860,167
103,0,blank,0,-323,-105,262860,262993,133
103,0,blank,0,-323,-105,262993,263175,182
103,0,blank,0,-323,-105,263175,263364,189
103,0,blank,0,-323,-105,263364,263543,179
103,0,blank,0,-323,-105,263543,263725,182
103,0,blank,0,-323,-105,263725,263897,172
103,0,blank,0,-323,-105,263897,264072,175
103,0,blank,0,-323,-105,264072,264110,38
103,0,blank,0,-323,-105,264110,264318,208
103,0,blank,0,-323,-105,264318,264365,47
103,0,blank,0,-323,-105,264365,264603,238
103,0,blank,0,-323,-105,264603,264802,199
103,0,blank,0,-323,-105,264802,265000,198
103,0,blank,0,-323,-105,265000,265054,54
103,0,blank,0,-323,-105,265054,265324,270
103,0,blank,0,-323,-105,265324,266456,1132
103,0,blank,0,-323,-105,266456,266587,131
103,0,blank,0,-323,-105,266587,266778,191
103,0,blank,0,-323,-105,266778,266966,188
103,0,blank,0,-323,-105,266966,267374,408
103,0,blank,0,-323,-105,267374,267754,380
103,0,blank,0,224.0864,458.7267,267789,267821,32
103,29,index,203,156.2082,476.6038,267821,268046,225
103,24,str,162,279.233066666667,353.316966666667,268090,268255,165
103,0,blank,0,304.79088,301.35886,268336,268526,190
103,0,blank,0,276.9614,312.0517,268684,268802,118
103,27,],187,217.201914285714,431.386442857143,268830,269028,198
103,0,blank,0,184.27148,433.97312,269028,269169,141
103,28,printf,191,101.602633333333,443.1132,269228,269401,173
103,0,blank,0,79.3816,456.21104,269401,269542,141
103,0,blank,0,-323,-105,269570,269697,127
103,27,[,185,195.397828571429,432.245728571429,269784,269975,191
103,28,"in=%d",193,195.396616666667,440.615783333333,270035,270214,179
103,29,index,203,171.728533333333,468.698933333333,270214,270328,114
103,0,blank,0,240.8672,557.7536,270382,270409,27
103,0,blank,0,250.9084,462.0922,270439,270634,195
103,0,blank,0,237.721766666667,474.312266666667,270634,270802,168
103,0,blank,0,-323,-105,270915,271066,151
103,0,blank,0,-323,-105,271066,271255,189
103,0,blank,0,-323,-105,271255,271431,176
103,0,blank,0,-323,-105,271431,271608,177
103,0,blank,0,-323,-105,271608,271779,171
103,0,blank,0,-323,-105,271779,271922,143
103,0,blank,0,-323,-105,271922,272092,170
103,0,blank,0,-323,-105,272092,272290,198
103,0,blank,0,-323,-105,272290,272454,164
103,0,blank,0,-323,-105,272454,272557,103
103,0,blank,0,-323,-105,272747,272879,132
103,0,blank,0,-323,-105,272879,273057,178
103,0,blank,0,-323,-105,273057,273238,181
103,0,blank,0,-323,-105,273238,273417,179
103,0,blank,0,-323,-105,273417,273454,37
103,0,blank,0,-323,-105,273811,273994,183
103,0,blank,0,-323,-105,273994,274172,178
103,0,blank,0,-323,-105,274172,274213,41
103,0,blank,0,162.927,575.4359,274459,274631,172
103,0,blank,0,132.36885,594.15145,274631,274796,165
103,0,blank,0,-323,-105,274822,274951,129
103,0,blank,0,148.938516666667,489.702333333333,275069,275257,188
103,29,index,203,192.07305,472.2764,275257,275317,60
103,29,index,203,183.383916666667,467.688533333333,275373,275548,175
103,26,[,177,289.4476,407.4921,275548,275577,29
103,0,blank,0,230.561028571429,456.881585714286,275605,275802,197
103,0,blank,0,257.664,384.5544,275802,275830,28
103,28,"in=%d",193,207.32895,443.96905,275859,275914,55
103,0,blank,0,297.3843,457.2632,276003,276034,31
103,28,"in=%d",193,213.582433333333,446.971066666667,276061,276143,82
103,0,blank,0,-323,-105,276171,276332,161
103,0,blank,0,156.06,428.0213,276522,276581,59
103,0,blank,0,157.7,418.0143,276618,276657,39
103,0,blank,0,-323,-105,276900,277042,142
103,0,blank,0,-323,-105,277042,277220,178
103,0,blank,0,-323,-105,277220,277412,192
103,0,blank,0,-323,-105,277412,277568,156
103,0,blank,0,-323,-105,277568,277753,185
103,0,blank,0,-323,-105,277753,277918,165
103,0,blank,0,-323,-105,277918,278103,185
103,0,blank,0,-323,-105,278103,278292,189
103,0,blank,0,-323,-105,278292,278468,176
103,0,blank,0,-323,-105,278468,278665,197
103,0,blank,0,-323,-105,278665,278842,177
103,0,blank,0,-323,-105,278842,279032,190
103,0,blank,0,-323,-105,279032,279215,183
103,0,blank,0,-323,-105,279215,279399,184
103,0,blank,0,-323,-105,279399,279573,174
103,0,blank,0,-323,-105,279573,279706,133
103,0,blank,0,-323,-105,279706,279842,136
103,0,blank,0,-323,-105,279842,280169,327
103,0,blank,0,-323,-105,280169,280335,166
103,0,blank,0,-323,-105,280335,280530,195
103,0,blank,0,-323,-105,280530,280710,180
103,0,blank,0,-323,-105,280710,280903,193
103,0,blank,0,-323,-105,280903,281073,170
103,0,blank,0,-323,-105,281073,281179,106
103,0,blank,0,-323,-105,281179,281338,159
103,0,blank,0,-323,-105,281338,281537,199
103,0,blank,0,-323,-105,281537,281672,135
103,0,blank,0,117.92548,504.14722,282671,282850,179
103,0,blank,0,107.1063,494.0488,282850,283042,192
103,29,if,198,104.33422,471.32594,283042,283233,191
103,28,printf,191,111.704866666667,442.4739,283233,283346,113
103,18,"Onremovingcharactersfromsecondstringweget:%s\n",125,220.038266666667,219.8906,283522,283626,104
103,0,blank,0,193.84095,246.64915,283667,283783,116
103,0,blank,0,169.50325,369.97985,283860,283938,78
103,27,i,186,206.89454,419.79078,283976,284170,194
103,0,blank,0,142.062366666667,423.93265,284170,284352,182
103,0,blank,0,141.64955,421.62685,284352,284467,115
103,0,blank,0,-323,-105,284496,284599,103
103,0,blank,0,226.795571428571,418.422514285714,284700,284888,188
103,27,-,188,238.276933333333,431.9918,284888,285061,173
103,0,blank,0,276.0456,456.9487,285061,285089,28
103,0,blank,0,-323,-105,285118,285273,155
103,23,;,151,170.20935,328.48935,285308,285507,199
103,27,str,184,178.246725,415.12505,285507,285676,169
103,26,tolower,174,193.10896,403.26204,285676,285858,182
103,26,],179,140.94395,390.88535,285858,285940,82
103,28,(,192,152.5016,452.776775,285978,286154,176
103,28,"in=%d",193,166.4248,442.1161,286154,286286,132
103,26,tolower,174,216.4149,405.7314,286286,286418,132
103,28,"in=%d",193,214.08345,445.016175,286418,286601,183
103,0,blank,0,205.509633333333,433.0508,286601,286688,87
103,0,blank,0,-323,-105,286717,286822,105
103,27,[,185,200.133157142857,414.064671428571,286931,287120,189
103,0,blank,0,200.27205,412.17365,287120,287238,118
103,11,[,79,180.766366666667,65.3799666666667,287267,287442,175
103,0,blank,0,129.145485714286,37.5837142857143,287442,287640,198
103,0,blank,0,67.2543833333333,60.83625,287640,287813,173
103,10,int,67,69.6416,46.2070666666667,287813,287984,171
103,11,str2_rem,78,101.64875,66.4121166666667,287984,288155,171
103,12,printf,83,59.1938666666667,99.5349833333333,288155,288328,173
103,0,blank,0,75.6642833333333,44.5960166666667,288328,288499,171
103,0,blank,0,78.13115,56.49025,288499,288670,171
103,0,blank,0,65.61076,14.45986,288670,288857,187
103,0,blank,0,102.666,12.5692857142857,288857,289056,199
103,0,blank,0,154.81985,13.0124,289056,289229,173
103,0,blank,0,162.833,-23.8479,289229,289258,29
103,0,blank,0,-323,-105,289287,289393,106
103,0,blank,0,160.6967,455.7957,289418,289443,25
103,29,],204,205.18895,464.12815,289496,289680,184
103,28,"in=%d",193,205.198214285714,447.146928571429,289680,289878,198
103,29,],204,211.979133333333,476.708666666667,289878,290074,196
103,28,"in=%d",193,199.328028571429,447.863242857143,290074,290271,197
103,28,"in=%d",193,199.707933333333,451.978616666667,290271,290442,171
103,28,"in=%d",193,208.8703,447.41865,290442,290616,174
103,28,"in=%d",193,174.3989,453.69522,290616,290757,141
103,28,"in=%d",193,158.627483333333,453.948383333333,290786,290957,171
103,28,printf,191,130.4284,439.6249,290957,290986,29
103,0,blank,0,117.109183333333,493.4361,291014,291184,170
103,29,!,200,127.96615,472.821366666667,291184,291381,197
103,29,index,203,163.791633333333,469.483433333333,291381,291554,173
103,28,"in=%d",193,190.151983333333,448.798666666667,291554,291728,174
103,29,),205,217.969,462.4155,291728,291787,59
103,0,blank,0,-323,-105,291818,291947,129
103,0,blank,0,216.0887,554.5614,291972,292005,33
103,31,index,209,157.462428571429,504.345214285714,292068,292261,193
103,31,[,208,138.972783333333,502.028733333333,292261,292434,173
103,0,blank,0,130.5909,491.404842857143,292434,292633,199
103,0,blank,0,118.2996,510.0476,292633,292690,57
103,0,blank,0,144.0153,474.9939,292719,292747,28
103,36,char,230,123.232583333333,611.243483333333,292776,292947,171
103,36,char,230,131.242525,611.677625,292947,293062,115
103,29,[,202,150.799266666667,462.894166666667,293091,293267,176
103,0,blank,0,146.935766666667,481.35395,293267,293439,172
103,31,index,209,160.052566666667,510.6657,293439,293525,86
103,0,blank,0,-323,-105,293554,293708,154
103,0,blank,0,144.5259,551.908,293733,293758,25
103,0,blank,0,148.482157142857,486.866114285714,293815,294005,190
103,29,a,201,133.826833333333,471.98255,294005,294178,173
103,31,index,209,152.757066666667,503.9619,294178,294353,175
103,29,[,202,151.39505,466.31695,294353,294413,60
103,0,blank,0,-323,-105,294502,294680,178
103,0,blank,0,-323,-105,294680,294858,178
103,0,blank,0,-323,-105,294858,295031,173
103,0,blank,0,505.782042857143,713.267557142857,295066,295262,196
103,0,blank,0,569.3229,753.6593,295262,295289,27
103,0,blank,0,642.3691,-103.8712,295494,295520,26
103,0,blank,0,470.831,693.483566666667,295605,295738,133
103,0,blank,0,471.4478,678.4199,295738,295806,68
103,0,blank,0,-323,-105,295833,296297,464
103,0,blank,0,-323,-105,296297,296407,110
103,0,blank,0,510.267228571428,713.4625,296457,296643,186
103,0,blank,0,510.386914285714,716.4878,296643,296834,191
103,0,blank,0,487.026528571429,696.191771428571,296834,297025,191
103,0,blank,0,475.0283,705.298,297025,297107,82
103,0,blank,0,469.225516666667,708.684566666667,297162,297327,165
103,0,blank,0,463.450985714286,706.723685714286,297354,297547,193
103,0,blank,0,478.51025,754.26595,297547,297605,58
103,0,blank,0,483.947,756.0643,297605,297810,205
103,0,blank,0,467.113614285714,681.228342857143,297810,297991,181
103,0,blank,0,483.849157142857,708.077285714286,297991,298183,192
103,0,blank,0,475.616585714286,717.731285714286,298183,298378,195
103,0,blank,0,475.168542857143,716.229071428572,298378,298571,193
103,0,blank,0,489.811057142857,727.800985714286,298571,298762,191
103,0,blank,0,474.9242,708.811933333333,298762,298843,81
103,0,blank,0,503.682883333333,732.18615,299075,299252,177
103,0,blank,0,490.795428571429,711.132785714286,299252,299443,191
103,0,blank,0,422.3655,719.6609,299443,299469,26
103,0,blank,0,489.897628571429,705.686528571429,299524,299715,191
103,0,blank,0,481.955075,701.8164,299715,299824,109
103,0,blank,0,482.3738,-103.9955,300029,300054,25
103,0,blank,0,491.661085714286,719.177314285714,300078,300261,183
103,0,blank,0,486.055942857143,696.9972,300261,300451,190
103,0,blank,0,508.117971428571,710.218728571429,300451,300642,191
103,0,blank,0,503.651385714286,730.1362,300642,300838,196
103,0,blank,0,474.186071428571,693.480185714286,300838,301027,189
103,0,blank,0,493.236828571429,694.4479,301027,301216,189
103,0,blank,0,505.811285714286,692.833828571429,301216,301406,190
103,0,blank,0,507.1231,708.4696,301406,301433,27
103,0,blank,0,510.8551,718.4512,301433,301649,216
103,0,blank,0,570.3506,695.0457,301649,301731,82
103,0,blank,0,501.1942,711.1326,301985,302163,178
103,0,blank,0,487.8529,734.6665,302163,302377,214
103,0,blank,0,550.9433,708.61965,302377,302535,158
103,0,blank,0,524.4823,714.2998,302535,302723,188
103,0,blank,0,505.99845,708.837883333333,302723,302914,191
103,0,blank,0,509.189471428571,702.644342857143,302914,303106,192
103,0,blank,0,493.2741,742.9289,303106,303160,54
103,0,blank,0,461.887,739.6213,303339,303564,225
103,0,blank,0,515.709175,706.140975,303564,303749,185
103,0,blank,0,503.4053,724.113475,303749,303913,164
103,0,blank,0,496.86415,684.4707,303913,304102,189
103,0,blank,0,493.300916666667,691.153716666667,304102,304297,195
103,0,blank,0,507.843333333333,685.60905,304350,304513,163
103,0,blank,0,543.4383,751.7792,304513,304568,55
103,0,blank,0,508.21122,716.50202,304900,305050,150
103,0,blank,0,447.9218,724.7707,305050,305133,83
103,0,blank,0,-323,-105,305249,305301,52
103,0,blank,0,-323,-105,305301,305643,342
103,0,blank,0,-323,-105,305643,305816,173
103,0,blank,0,-323,-105,305816,306007,191
103,0,blank,0,-323,-105,306007,306190,183
103,0,blank,0,-323,-105,306190,306365,175
103,0,blank,0,-323,-105,306365,306485,120
103,0,blank,0,-323,-105,306485,306571,86
103,0,blank,0,-323,-105,306571,306899,328
103,0,blank,0,-323,-105,306899,307065,166
103,0,blank,0,172.741257142857,485.2947,307091,307281,190
103,0,blank,0,203.255671428571,516.834871428571,307281,307480,199
103,0,blank,0,154.582083333333,455.759666666667,307480,307651,171
103,29,[,202,149.601433333333,466.121233333333,307651,307824,173
103,28,(,192,146.266116666667,441.4408,307824,307997,173
103,28,"in=%d",193,164.110616666667,451.979266666667,307997,308172,175
103,28,"in=%d",193,179.745866666667,434.469383333333,308172,308346,174
103,29,),205,219.6264,467.1794,308346,308434,88
103,0,blank,0,-323,-105,308463,308593,130
103,0,blank,0,221.0931,386.4351,308618,308652,34
103,28,"in=%d",193,211.303,445.3223,308712,308762,50
103,0,blank,0,117.0707,455.2142,308819,308985,166
103,27,index,182,116.485825,431.239925,309012,309126,114
103,28,"in=%d",193,183.868566666667,437.454333333333,309213,309386,173
103,0,blank,0,199.707016666667,412.698283333333,309386,309559,173
103,26,str,176,260.710325,396.54785,309559,309726,167
103,0,blank,0,226.426685714286,471.354342857143,309751,309945,194
103,0,blank,0,176.168133333333,482.489483333333,309945,310117,172
103,29,index,203,203.375483333333,460.691,310117,310288,171
103,0,blank,0,243.694,458.02815,310288,310460,172
103,28,index,195,278.6256,451.8774,310460,310604,144
103,0,blank,0,-323,-105,310632,310737,105
103,0,blank,0,255.5281,426.510171428571,310844,311033,189
103,28,comma,194,229.915533333333,435.860833333333,311033,311119,86
103,28,index,195,237.927016666667,451.789083333333,311147,311320,173
103,0,blank,0,238.62062,468.08294,311320,311510,190
103,0,blank,0,215.25172,479.38584,311510,311653,143
103,28,"in=%d",193,203.753833333333,454.45295,311653,311847,194
103,0,blank,0,197.200066666667,493.25405,311847,312019,172
103,29,index,203,179.41695,476.700125,312019,312134,115
103,0,blank,0,158.681542857143,490.345914285714,312164,312363,199
103,0,blank,0,164.6237,486.7626,312363,312391,28
103,0,blank,0,-323,-105,312420,312612,192
103,0,blank,0,151.244957142857,481.364585714286,312638,312824,186
103,31,index,209,170.34945,511.58295,312824,313000,176
103,0,blank,0,160.37758,533.02034,313000,313189,189
103,0,blank,0,161.47045,497.576383333333,313189,313358,169
103,0,blank,0,-323,-105,313415,313595,180
103,0,blank,0,-323,-105,313595,313772,177
103,0,blank,0,-323,-105,313772,313950,178
103,0,blank,0,-323,-105,313950,314128,178
103,0,blank,0,-323,-105,314128,314320,192
103,0,blank,0,-323,-105,314320,314498,178
103,0,blank,0,722.546975,-103.914375,314648,314783,135
103,0,blank,0,638.498,-103.86784,314814,315012,198
103,0,blank,0,702.606285714286,-103.8488,315012,315207,195
103,0,blank,0,692.42425,-103.862275,315207,315317,110
103,0,blank,0,689.24255,-103.8548,315317,315498,181
103,0,blank,0,693.306,-103.8391,315498,315523,25
103,0,blank,0,753.702,-103.8388,315523,315698,175
103,0,blank,0,-323,-105,315773,315950,177
103,0,blank,0,-323,-105,315950,316130,180
103,0,blank,0,-323,-105,316130,316312,182
103,0,blank,0,-323,-105,316312,316486,174
103,0,blank,0,-323,-105,316486,316987,501
103,0,blank,0,-323,-105,316987,317134,147
103,0,blank,0,-323,-105,317134,317698,564
103,0,blank,0,-323,-105,317698,317887,189
103,0,blank,0,-323,-105,317887,317919,32
103,0,blank,0,-323,-105,317919,318323,404
103,0,blank,0,-323,-105,318323,318518,195
103,0,blank,0,-323,-105,318518,318779,261
103,0,blank,0,-323,-105,318779,318818,39
103,0,blank,0,167.54695,480.90345,319396,319444,48
103,0,blank,0,-323,-105,319575,319763,188
103,0,blank,0,-323,-105,319763,319942,179
103,0,blank,0,-323,-105,319942,319979,37
103,30,{,206,87.106,487.6867,320043,320151,108
103,29,!,200,128.46422,470.33122,320237,320424,187
103,30,{,206,86.5745333333333,485.200866666667,320463,320655,192
103,0,blank,0,121.490671428571,501.6428,320655,320850,195
103,31,index,209,182.5917,510.17905,320850,320906,56
103,31,index,209,150.3392,510.587428571429,320963,321160,197
103,31,index,209,161.504057142857,514.261128571429,321160,321356,196
103,29,[,202,152.917316666667,468.9464,321356,321526,170
103,0,blank,0,-323,-105,321580,321760,180
103,28,printf,191,140.62866,440.64034,321865,321998,133
103,29,[,202,151.388471428571,457.855385714286,322054,322247,193
103,28,"in=%d",193,160.760571428571,449.924542857143,322247,322446,199
103,31,[,208,140.565442857143,506.091242857143,322446,322644,198
103,31,[,208,135.036571428571,518.112685714286,322644,322842,198
103,31,index,209,166.294442857143,510.249685714286,322842,323041,199
103,0,blank,0,211.86135,495.887,323041,323098,57
103,0,blank,0,-323,-105,323155,323259,104
103,0,blank,0,163.555,489.167457142857,323361,323541,180
103,29,if,198,94.4908,466.43325,323541,323713,172
103,28,printf,191,131.031971428571,454.013185714286,323713,323912,199
103,28,printf,191,128.2416,453.821766666667,323912,324085,173
103,0,blank,0,131.218866666667,466.758716666667,324085,324253,168
103,29,a,201,138.850657142857,459.891714285714,324308,324507,199
103,29,index,203,164.1277,465.14845,324507,324677,170
103,0,blank,0,-323,-105,324705,324859,154
103,28,"in=%d",193,154.448242857143,452.283428571428,324941,325128,187
103,29,[,202,146.383342857143,457.579742857143,325128,325327,199
103,0,blank,0,144.56955,452.605366666667,325327,325498,171
103,29,[,202,152.484057142857,462.669885714286,325498,325697,199
103,0,blank,0,153.669971428571,453.625571428572,325697,325896,199
103,28,"in=%d",193,163.1765,438.441414285714,325896,326093,197
103,27,str,184,170.248171428571,425.896771428571,326093,326292,199
103,0,blank,0,172.828485714286,412.904528571429,326292,326490,198
103,28,(,192,148.997685714286,451.907185714286,326490,326686,196
103,0,blank,0,162.451683333333,428.5962,326686,326854,168
103,29,a,201,140.3231,457.33915,326854,326953,99
103,27,index,182,87.7402,425.7255,326953,327062,109
103,27,index,182,85.20065,417.0565,327062,327246,184
103,0,blank,0,79.848,427.5107,327246,327281,35
103,0,blank,0,-323,-105,327310,327440,130
103,29,index,203,188.8541,459.5825,327466,327491,25
103,0,blank,0,171.1507,412.1945,327543,327568,25
103,0,blank,0,191.503957142857,525.832142857143,327593,327781,188
103,0,blank,0,199.38255,522.9452,327781,327838,57
103,0,blank,0,76.4848285714286,551.331671428571,327867,328064,197
103,0,blank,0,81.6952285714286,563.677071428571,328064,328258,194
103,0,blank,0,68.8533285714286,565.270071428571,328258,328455,197
103,34,(,217,112.85,572.52502,328455,328596,141
103,34,(,217,112.253685714286,568.843514285714,328624,328822,198
103,36,void,222,34.7233666666667,616.17545,328822,328993,171
103,36,void,222,41.9055714285714,612.461842857143,328993,329192,199
103,36,create,223,75.9986833333333,626.900233333333,329192,329363,171
103,36,char,230,133.743928571429,611.756171428571,329363,329562,199
103,36,char,230,145.62845,610.945133333333,329562,329733,171
103,0,blank,0,147.39145,565.931475,329733,329847,114
103,0,blank,0,145.35805,270.8375,329876,329933,57
103,12,"Enterstring1:",85,125.72905,101.27205,329962,330076,114
103,14,printf,95,103.648683333333,127.0621,330134,330312,178
103,14,printf,95,92.46245,137.974433333333,330312,330493,181
103,0,blank,0,89.10355,125.2449,330493,330673,180
103,15,"%s",102,137.0628,157.14935,330673,330733,60
103,13,scanf,88,81.5656166666667,120.857916666667,330764,330948,184
103,13,(,89,100.1884,118.797983333333,330948,331128,180
103,15,"%s",102,138.126666666667,149.514083333333,331128,331304,176
103,14,printf,95,73.3458714285714,139.167071428571,331304,331503,199
103,14,printf,95,50.1898666666667,134.582133333333,331503,331676,173
103,14,printf,95,43.0601333333333,139.3311,331676,331761,85
103,13,scanf,88,48.5327,106.1647,331789,331983,194
103,0,blank,0,37.0759166666667,125.838083333333,331983,332155,172
103,16,alphacheck,107,43.7137,171.700133333333,332155,332333,178
103,17,(,115,112.84635,204.068,332333,332513,180
103,0,blank,0,152.962016666667,162.634433333333,332513,332685,172
103,16,str1,109,163.605016666667,178.727083333333,332685,332857,172
103,15,str2,104,184.48715,159.053433333333,332857,333031,174
103,0,blank,0,-323,-105,333060,333164,104
103,13,;,94,221.6581,109.2363,333194,333236,42
103,15,str2,104,192.845857142857,167.9075,333306,333500,194
103,16,str1,109,192.62094,174.03044,333500,333644,144
103,28,"in=%d",193,178.688383333333,447.5998,333701,333872,171
103,29,index,203,189.5742,457.0164,333872,333984,112
103,28,"in=%d",193,180.402685714286,451.447257142857,334013,334209,196
103,27,[,185,196.210057142857,429.994771428571,334209,334408,199
103,28,"in=%d",193,182.200114285714,438.964571428571,334408,334604,196
103,27,=,183,150.1093,430.4605,334604,334800,196
103,28,printf,191,93.7502833333333,447.5116,334800,334972,172
103,26,str,176,102.106657142857,404.557942857143,334972,335169,197
103,0,blank,0,122.205628571429,384.120171428571,335169,335367,198
103,0,blank,0,164.00368,399.43344,335367,335506,139
103,0,blank,0,-323,-105,335561,335662,101
103,0,blank,0,232.8541,478.8655,335688,335726,38
103,28,"in=%d",193,173.498133333333,448.363766666667,335796,335875,79
103,29,index,203,198.67205,456.09785,335903,335960,57
103,29,a,201,143.128985714286,465.180242857143,336016,336213,197
103,0,blank,0,99.5183,433.966316666667,336213,336385,172
103,27,index,182,102.7627,424.3252,336385,336441,56
103,27,str,184,172.533914285714,418.932185714286,336470,336668,198
103,0,blank,0,172.394571428571,406.186271428571,336668,336865,197
103,27,str,184,171.94595,424.68275,336865,337037,172
103,0,blank,0,159.911814285714,432.357642857143,337037,337232,195
103,0,blank,0,109.2365,382.5837,337232,337259,27
103,27,index,182,116.019228571429,418.444742857143,337287,337485,198
103,26,tolower,174,188.224783333333,395.0985,337485,337661,176
103,26,tolower,174,203.853428571429,405.616357142857,337661,337859,198
103,28,"in=%d",193,200.8524,439.4441,337859,337888,29
103,0,blank,0,241.37796,386.8057,337948,338094,146
103,0,blank,0,-323,-105,338123,338277,154
103,0,blank,0,254.294457142857,389.3044,338366,338553,187
103,0,blank,0,268.7995,412.7135,338553,338722,169
103,27,index,182,93.3067833333333,431.319366666667,338751,338922,171
103,27,index,182,132.563,423.875971428571,338922,339118,196
103,27,str,184,188.553685714286,426.126414285714,339174,339371,197
103,0,blank,0,-323,-105,339398,339580,182
103,0,blank,0,-323,-105,339580,339761,181
103,0,blank,0,-323,-105,339761,339938,177
103,0,blank,0,-323,-105,339938,340126,188
103,0,blank,0,-323,-105,340126,340314,188
103,0,blank,0,-323,-105,340314,340496,182
103,0,blank,0,-323,-105,340496,340685,189
103,0,blank,0,-323,-105,340685,340873,188
103,0,blank,0,-323,-105,340873,341059,186
103,0,blank,0,-323,-105,341059,341244,185
103,0,blank,0,-323,-105,341244,341440,196
103,0,blank,0,-323,-105,341440,341619,179
103,0,blank,0,-323,-105,341619,341801,182
103,0,blank,0,-323,-105,341801,341985,184
103,0,blank,0,-323,-105,341985,342169,184
103,0,blank,0,-323,-105,342169,342350,181
103,0,blank,0,-323,-105,342350,342538,188
103,0,blank,0,-323,-105,342538,342725,187
103,0,blank,0,-323,-105,342725,342867,142
103,0,blank,0,-323,-105,342867,343064,197
103,0,blank,0,-323,-105,343064,343187,123
103,0,blank,0,160.146483333333,689.121316666667,343216,343399,183
103,0,blank,0,157.6779,757.096,343399,343431,32
103,38,index,248,208.7237,661.143,343462,343489,27
103,0,blank,0,193.141816666667,693.848233333333,343546,343718,172
103,0,blank,0,152.572057142857,679.487457142857,343718,343916,198
103,0,blank,0,146.3286,669.88235,343916,343998,82
103,0,blank,0,193.0912,678.5703,343998,344163,165
103,0,blank,0,328.2019,645.4998,344192,344276,84
103,39,strlen,258,218.18944,679.47904,344302,344475,173
103,39,strlen,258,231.241,685.28436,344475,344649,174
103,38,;,249,235.68896,665.77614,344733,344903,170
103,0,blank,0,279.154666666667,652.296466666667,344903,345049,146
103,39,strlen,258,241.0107,691.8354,345076,345105,29
103,0,blank,0,264.4324,662.240471428571,345508,345704,196
103,0,blank,0,310.061125,663.158,345704,345877,173
103,0,blank,0,316.49305,675.03935,345877,345939,62
103,38,index,248,213.739016666667,670.327783333333,345996,346169,173
103,38,index,248,196.6652,671.798866666667,346169,346255,86
103,0,blank,0,199.1314,692.459966666667,346398,346568,170
103,38,;,249,238.24305,660.9201,346568,346739,171
103,0,blank,0,259.47628,665.3026,346739,346937,198
103,39,strlen,258,240.87605,681.521175,346937,347128,191
103,0,blank,0,227.06135,705.04165,347128,347287,159
103,0,blank,0,263.214733333333,653.015466666667,347585,347723,138
103,38,index,248,209.6167,664.2063,347723,347912,189
103,0,blank,0,178.604066666667,679.192033333333,347912,348107,195
103,0,blank,0,163.417116666667,702.602433333333,348107,348302,195
103,0,blank,0,183.6424,726.3534,348302,348411,109
103,0,blank,0,-323,-105,348653,348804,151
103,0,blank,0,258.1142,650.6762,348830,348879,49
103,0,blank,0,189.62742,700.0721,348993,349166,173
103,38,index,248,190.681166666667,673.281833333333,349166,349359,193
103,0,blank,0,177.293366666667,673.9175,349359,349550,191
103,39,i,263,171.7259,691.528642857143,349550,349746,196
103,0,blank,0,151.1195,744.8724,349746,349774,28
103,39,i,263,172.8782,696.836025,349827,350019,192
103,0,blank,0,150.01895,755.084383333333,350019,350217,198
103,0,blank,0,133.810733333333,754.646333333333,350217,350332,115
103,0,blank,0,144.6909,737.4901,350388,350416,28
103,0,blank,0,595.684,653.442066666667,350557,350634,77
103,0,blank,0,992.188,621.3563,350741,350766,25
103,0,blank,0,991.0162,617.11424,350892,351089,197
103,0,blank,0,946.6018,633.38802,351089,351230,141
103,0,blank,0,1065.373,530.5261,351258,351286,28
103,0,blank,0,989.3988,619.55378,351314,351454,140
103,0,blank,0,1041.6735,569.3236,351510,351568,58
103,0,blank,0,953.819166666667,638.236333333333,351599,351768,169
103,0,blank,0,522.690466666667,669.8888,351852,351937,85
103,0,blank,0,493.2667,721.093166666667,351994,352164,170
103,0,blank,0,528.716075,731.257925,352192,352304,112
103,0,blank,0,599.073,597.01535,352333,352388,55
103,0,blank,0,593.51468,651.02458,352416,352561,145
103,0,blank,0,574.67575,669.94285,352589,352644,55
103,0,blank,0,568.32096,678.14868,352703,352848,145
103,0,blank,0,560.145728571429,662.763242857143,352903,353098,195
103,0,blank,0,562.399585714286,485.624014285714,353157,353352,195
103,0,blank,0,607.206275,451.04845,353352,353465,113
103,0,blank,0,553.527333333333,433.092,353496,353581,85
103,0,blank,0,511.028666666667,514.966733333333,353608,353692,84
104,0,blank,0,-323,-105,355974,356165,191
104,0,blank,0,-323,-105,356165,356360,195
104,0,blank,0,-323,-105,356360,356536,176
104,0,blank,0,-323,-105,356536,356715,179
104,0,blank,0,-323,-105,356715,356898,183
104,0,blank,0,-323,-105,356898,357079,181
104,0,blank,0,-323,-105,357079,357256,177
104,0,blank,0,-323,-105,357256,357453,197
104,0,blank,0,-323,-105,357453,357562,109
104,0,blank,0,555.437,756.87395,357892,357947,55
104,0,blank,0,586.15692,727.94986,357979,358122,143
104,0,blank,0,662.9907,677.0603,358205,358265,60
104,0,blank,0,615.44456,708.41718,358323,358515,192
104,0,blank,0,620.1622,722.911633333333,358568,358656,88
104,36,str_rem,226,182.903071428571,480.659757142857,358741,358935,194
104,36,char,230,150.73315,482.716683333333,358935,359126,191
104,36,char,230,152.338583333333,474.459916666667,359126,359293,167
104,0,blank,0,160.3101,455.3997,359293,359381,88
104,0,blank,0,187.5496,509.0485,359408,359438,30
104,36,str_rem,226,174.824083333333,493.032966666667,359467,359663,196
104,0,blank,0,172.6041,514.2023,359663,359856,193
104,0,blank,0,150.6856,495.8213,359856,359912,56
104,0,blank,0,207.75315,500.62505,359940,359997,57
104,17,str2_rem,116,173.533533333333,57.8477833333333,360107,360289,182
104,17,str2_rem,116,189.02415,73.64035,360289,360349,60
104,0,blank,0,298.1108,41.6371,360410,360438,28
104,0,blank,0,207.714642857143,45.5076285714286,360467,360666,199
104,16,;,113,249.85285,34.0731833333333,360666,360836,170
104,15,scanf,100,53.7831,25.1010666666667,360865,361038,173
104,16,alphacheck,107,62.55456,38.2113,361038,361185,147
104,16,alphacheck,107,67.6438714285714,40.6879857142857,361213,361410,197
104,15,(,101,95.0551285714286,26.8233857142857,361410,361609,199
104,16,alphacheck,107,137.04875,39.4243666666667,361609,361779,170
104,0,blank,0,156.853366666667,20.46935,361779,361961,182
104,0,blank,0,157.190683333333,26.5666333333333,361961,362142,181
104,16,a1,111,233.801785714286,37.4277428571429,362142,362338,196
104,0,blank,0,188.173671428571,471.670142857143,362393,362589,196
104,36,str_rem,226,199.048585714286,475.898771428571,362589,362787,198
104,0,blank,0,149.2546,521.8143,362787,362816,29
104,36,str_rem,226,189.065214285714,477.358957142857,362844,363036,192
104,36,str_rem,226,202.326114285714,481.213628571429,363036,363232,196
104,36,comma,234,267.035257142857,481.136728571429,363232,363426,194
104,0,blank,0,300.87525,467.76985,363426,363482,56
104,0,blank,0,365.232714285714,471.6818,363510,363701,191
104,0,blank,0,319.7675,464.9165,363701,363728,27
104,0,blank,0,172.74365,126.895025,363843,363957,114
104,18,"Onremovingcharactersfromsecondstringweget:%s\n",125,200.622433333333,80.3691166666667,364014,364211,197
104,0,blank,0,217.354528571429,54.8241428571429,364211,364407,196
104,0,blank,0,260.960233333333,29.8728,364407,364583,176
104,0,blank,0,294.40465,5.7267,364583,364639,56
104,17,),121,297.17145,55.84295,364666,364721,55
104,36,[,237,372.779257142857,477.294014285714,364778,364973,195
104,0,blank,0,401.2415,494.14578,364973,365114,141
104,0,blank,0,272.419816666667,72.8959,365170,365347,177
104,15,),105,209.5415,25.3440833333333,365376,365550,174
104,15,str2,104,196.4536,25.18725,365550,365726,176
104,16,str1,109,169.43585,34.3585833333333,365726,365902,176
104,16,(,108,151.013916666667,36.6542666666667,365902,366082,180
104,15,"%s",102,129.162183333333,15.16515,366082,366258,176
104,15,scanf,100,85.4244333333333,21.232,366258,366438,180
104,0,blank,0,139.2234,113.8134,366438,366468,30
104,0,blank,0,200.503,418.331816666667,366499,366670,171
104,0,blank,0,123.543566666667,409.785133333333,366670,366843,173
104,0,blank,0,134.42205,386.41905,366843,367016,173
104,0,blank,0,148.26605,420.04135,367016,367070,54
104,0,blank,0,136.099857142857,396.6739,367098,367295,197
104,0,blank,0,104.0173,424.401371428572,367295,367493,198
104,34,printf,216,64.2228,431.3667,367493,367684,191
104,0,blank,0,32.2454,437.1462,367786,367845,59
104,0,blank,0,126.707933333333,409.832166666667,368083,368168,85
104,0,blank,0,156.2076,426.449466666667,368228,368312,84
104,0,blank,0,114.9181,345.4387,368370,368398,28
104,29,(,199,117.986,319.4205,368455,368513,58
104,23,int,147,55.10296,202.38328,368540,368712,172
104,0,blank,0,33.5472166666667,140.074033333333,368712,368889,177
104,0,blank,0,98.9259333333333,99.5608,368889,369066,177
104,21,char,137,188.810883333333,144.51795,369066,369244,178
104,0,blank,0,230.4979,112.2933,369244,369274,30
104,0,blank,0,58.9523333333333,125.824033333333,369304,369484,180
104,0,blank,0,78.072425,174.265075,369484,369600,116
104,0,blank,0,22.2023333333333,138.232316666667,369628,369803,175
104,36,void,222,40.2268571428571,490.967157142857,369863,370062,199
104,36,create,223,71.7934,486.986128571429,370062,370259,197
104,0,blank,0,86.9682,468.2489,370259,370315,56
104,0,blank,0,373.038514285714,476.21,370343,370540,197
104,0,blank,0,397.862233333333,493.056183333333,370540,370710,170
104,0,blank,0,55.7863,-16.8897666666667,370766,370944,178
104,0,blank,0,42.2603,-9.54936,370944,371092,148
104,0,blank,0,46.6390166666667,32.7522,371121,371298,177
104,0,blank,0,107.7332,176.1526,371298,371329,31
104,16,alphacheck,107,74.8098857142857,37.8343714285714,371357,371554,197
104,15,"%s",102,118.918925,29.9317,371554,371665,111
104,0,blank,0,-323,-105,371692,371793,101
104,16,alphacheck,107,95.7223,36.2618,371818,371853,35
104,15,"%s",102,118.862857142857,25.9717857142857,371921,372110,189
104,15,comma,103,145.69275,20.4314333333333,372110,372282,172
104,16,str1,109,170.171833333333,45.0879833333333,372282,372453,171
104,16,a1,111,213.1911,47.4154333333333,372453,372538,85
104,36,create,223,106.982983333333,489.776116666667,372595,372767,172
104,0,blank,0,76.3655833333333,519.0718,372767,372940,173
104,38,i,242,86.2451333333333,521.1621,372940,373112,172
104,0,blank,0,95.3432714285714,510.502757142857,373112,373311,199
104,0,blank,0,124.015357142857,529.346242857143,373311,373510,199
104,38,=,245,140.538985714286,521.918085714286,373510,373709,199
104,0,blank,0,184.501214285714,509.969171428571,373709,373904,195
104,0,blank,0,198.849866666667,512.8909,373904,374073,169
104,38,comma,247,95.3044142857143,530.598085714286,374102,374297,195
104,38,i,242,88.02505,526.681933333333,374297,374468,171
104,39,=,253,117.201742857143,552.309557142857,374468,374664,196
104,0,blank,0,152.832771428571,543.610928571429,374664,374863,199
104,39,<,257,190.506471428571,540.3114,374863,375061,198
104,38,index,248,216.917357142857,531.036942857143,375061,375259,198
104,0,blank,0,229.514633333333,571.791266666667,375259,375345,86
104,38,index,248,228.9242,522.586914285714,375373,375572,199
104,0,blank,0,227.088233333333,468.252333333333,375572,375662,90
104,0,blank,0,210.509971428571,451.3966,375718,375916,198
104,39,strlen,258,259.459114285714,542.075471428571,375916,376113,197
104,39,strlen,258,261.73785,545.670616666667,376113,376284,171
104,36,str_rem,226,211.553342857143,486.574214285714,376284,376481,197
104,36,str_rem,226,175.9773,491.1699,376481,376509,28
104,36,str_rem,226,206.254871428571,473.189085714286,376537,376734,197
104,0,blank,0,297.600614285714,500.293814285714,376734,376932,198
104,0,blank,0,282.4943,522.70905,376932,376989,57
104,0,blank,0,-323,-105,377017,377146,129
104,0,blank,0,241.4207,569.0075,377180,377245,65
104,36,],238,260.794675,492.2801,377414,377539,125
104,18,"Onremovingcharactersfromsecondstringweget:%s\n",125,170.618083333333,77.3745666666667,377596,377768,172
104,0,blank,0,161.9151,26.6444833333333,377768,377947,179
104,16,str1,109,156.075366666667,39.1488,377947,378127,180
104,16,str1,109,192.0003,41.7912,378127,378312,185
104,0,blank,0,196.679,-17.0485,378312,378340,28
104,0,blank,0,143.5805,54.55865,378371,378492,121
104,16,alphacheck,107,143.43285,36.9545666666667,378522,378701,179
104,15,comma,103,148.947685714286,15.6885428571429,378701,378900,199
104,0,blank,0,161.331457142857,31.8986,378900,379099,199
104,16,str1,109,183.626342857143,35.9866714285714,379099,379298,199
104,0,blank,0,206.558185714286,32.5655428571429,379298,379494,196
104,0,blank,0,268.537485714286,537.206057142857,379551,379750,199
104,0,blank,0,250.571516666667,532.123316666667,379750,379922,172
104,0,blank,0,252.587414285714,535.025571428571,379922,380121,199
104,0,blank,0,188.435457142857,451.439385714286,380121,380319,198
104,0,blank,0,158.587571428571,465.559585714286,380319,380516,197
104,0,blank,0,116.254671428571,471.517728571429,380516,380713,197
104,0,blank,0,35.9276428571429,453.679028571429,380713,380908,195
104,36,void,222,16.19286,474.75002,380908,381047,139
104,39,strlen,258,252.826816666667,552.820266666667,381131,381299,168
104,39,str,260,282.324471428571,550.386471428571,381354,381547,193
104,0,blank,0,278.11065,577.38245,381547,381604,57
104,0,blank,0,159.5935,108.502,381661,381718,57
104,0,blank,0,151.568342857143,113.517728571429,381803,382000,197
104,16,str1,109,161.3619,40.7263,382000,382031,31
104,0,blank,0,204.507657142857,157.238485714286,382058,382253,195
104,17,comma,119,198.016866666667,72.7456666666667,382253,382448,195
104,16,str1,109,177.719666666667,51.0314,382448,382630,182
104,15,scanf,100,66.1298333333333,28.9211333333333,382630,382802,172
104,16,alphacheck,107,57.6336428571429,34.8140285714286,382802,383000,198
104,16,alphacheck,107,83.49405,34.5555833333333,383000,383173,173
104,16,alphacheck,107,97.1505666666666,37.0999,383173,383259,86
104,0,blank,0,-323,-105,383287,383419,132
104,16,alphacheck,107,66.7561714285714,48.4195428571429,383448,383633,185
104,16,alphacheck,107,59.6636,39.07315,383633,383690,57
104,0,blank,0,325.1524,483.5098,383749,383923,174
104,0,blank,0,354.479983333333,495.405133333333,383923,384096,173
104,0,blank,0,388.642125,500.80385,384096,384213,117
104,0,blank,0,92.5390166666667,505.069016666667,384271,384446,175
104,0,blank,0,71.471,517.0386,384446,384618,172
104,0,blank,0,58.5397833333333,513.644116666666,384618,384791,173
104,0,blank,0,71.2232666666667,514.189233333333,384791,384965,174
104,38,i,242,85.54315,523.091316666667,384965,385138,173
104,39,for,250,68.1613,546.16785,385138,385311,173
104,0,blank,0,104.863966666667,553.5913,385311,385486,175
104,39,0,254,135.334116666667,543.8782,385486,385660,174
104,39,<,257,185.645566666667,549.03815,385660,385833,173
104,38,index,248,214.085683333333,533.3616,385833,386007,174
104,0,blank,0,252.256133333333,533.356266666667,386007,386181,174
104,0,blank,0,290.28565,533.35565,386181,386354,173
104,0,blank,0,130.6403,567.619533333333,386383,386556,173
104,0,blank,0,88.5937666666667,583.599783333333,386556,386729,173
104,41,index,267,131.793957142857,585.202614285714,386729,386928,199
104,42,list,279,143.5014,608.5773,386928,386957,29
104,0,blank,0,-323,-105,386986,387141,155
104,41,index,267,132.7462,603.4053,387170,387209,39
104,0,blank,0,177.936471428571,577.179814285714,387272,387462,190
104,0,blank,0,189.05665,578.969816666667,387462,387635,173
104,0,blank,0,185.297833333333,582.530716666667,387635,387807,172
104,41,=,268,146.734771428571,595.563242857143,387807,388006,199
104,0,blank,0,143.64,571.72775,388006,388101,95
104,42,index,281,230.6797,607.0385,388101,388211,110
104,0,blank,0,216.524,579.8934,388211,388396,185
104,42,index,281,221.0613,610.5321,388396,388428,32
104,0,blank,0,-323,-105,388486,388641,155
104,42,index,281,193.5309,607.8032,388686,388742,56
104,41,i,271,207.90566,603.37924,388803,388937,134
104,18,"Onremovingcharactersfromsecondstringweget:%s\n",125,185.640985714286,82.6888285714286,388995,389193,198
104,0,blank,0,179.8618,129.92055,389193,389249,56
104,0,blank,0,227.9756,456.993633333333,389277,389449,172
104,0,blank,0,275.807966666667,483.69895,389449,389620,171
104,36,comma,234,385.561216666667,480.087816666667,389649,389820,171
104,0,blank,0,381.804233333333,497.626783333333,389820,389992,172
104,0,blank,0,392.9323,492.384566666667,389992,390164,172
104,0,blank,0,353.0739,512.89445,390164,390220,56
104,0,blank,0,221.234675,573.164525,390248,390361,113
104,18,"Onremovingcharactersfromsecondstringweget:%s\n",125,129.979483333333,80.6637333333333,390418,390610,192
104,17,str2_rem,116,185.147185714286,60.3650428571429,390610,390808,198
104,0,blank,0,205.916283333333,47.54885,390808,390986,178
104,16,a1,111,233.910757142857,48.9374714285714,390986,391185,199
104,0,blank,0,253.363183333333,29.6164333333333,391185,391355,170
104,0,blank,0,418.461328571429,513.4529,391469,391664,195
104,0,blank,0,413.103266666667,497.656166666667,391664,391835,171
104,0,blank,0,399.161183333333,498.20815,391835,392006,171
104,0,blank,0,415.38585,494.83235,392035,392092,57
104,0,blank,0,256.030685714286,580.359857142857,392121,392318,197
104,0,blank,0,247.886228571429,578.950657142857,392318,392515,197
104,0,blank,0,201.0003,566.387,392515,392714,199
104,38,index,248,185.546385714286,526.839071428571,392714,392911,197
104,0,blank,0,148.9349,528.902971428571,392911,393109,198
104,0,blank,0,150.795442857143,523.1443,393109,393307,198
104,0,blank,0,124.02625,524.733166666667,393307,393479,172
104,0,blank,0,110.969666666667,529.958833333333,393479,393564,85
104,0,blank,0,135.611457142857,499.981428571429,393620,393814,194
104,36,str_rem,226,177.746583333333,484.557266666667,393814,393989,175
104,0,blank,0,233.224128571429,460.418957142857,393989,394187,198
104,36,],238,257.74605,478.155725,394187,394300,113
104,0,blank,0,-323,-105,394357,394512,155
104,36,str,231,339.095428571429,492.184585714286,394628,394817,189
104,0,blank,0,380.939733333333,507.267616666667,394817,394989,172
104,36,],238,380.840383333333,484.79385,394989,395160,171
104,0,blank,0,383.450742857143,494.0369,395160,395359,199
104,0,blank,0,402.180616666667,487.676416666667,395359,395531,172
104,0,blank,0,401.74618,496.01696,395531,395674,143
104,0,blank,0,240.43865,576.548633333333,395702,395874,172
104,0,blank,0,248.839128571429,575.336814285714,395874,396073,199
104,0,blank,0,386.0178,503.818583333333,396073,396246,173
104,0,blank,0,401.959183333333,487.553816666667,396246,396418,172
104,36,int,235,416.792533333333,491.420983333333,396418,396590,172
104,0,blank,0,416.572042857143,499.700514285714,396590,396788,198
104,17,str2,118,220.1668,71.4481285714286,396874,397071,197
104,16,),112,236.771933333333,42.3087333333333,397071,397246,175
104,0,blank,0,269.024042857143,35.1459142857143,397246,397439,193
104,0,blank,0,389.455614285714,472.442828571429,397496,397695,199
104,36,int,235,410.702633333333,486.3286,397695,397866,171
104,36,int,235,422.4807,482.984366666667,397866,397952,86
104,0,blank,0,-323,-105,398009,398151,142
104,17,str2,118,243.0758,67.0244,398176,398200,24
104,17,comma,119,255.825,59.2744833333333,398250,398420,170
104,16,),112,236.011,51.10835,398420,398534,114
104,0,blank,0,196.447883333333,102.1577,398563,398734,171
104,16,str1,109,167.977266666667,47.1797666666667,398761,398850,89
104,0,blank,0,161.1602,18.74612,398881,399030,149
104,16,str1,109,162.818,46.3852833333333,399061,399241,180
104,15,str2,104,191.68814,13.0516,399241,399394,153
104,15,scanf,100,68.3694,16.0652833333333,399456,399638,182
104,16,alphacheck,107,67.1726833333333,42.8580333333333,399638,399817,179
104,16,alphacheck,107,111.402083333333,48.13445,399817,399997,180
104,16,str1,109,174.45592,40.43784,399997,400177,180
104,15,str2,104,193.368666666667,24.8697166666667,400177,400361,184
104,16,comma,110,194.927933333333,37.8674833333333,400361,400545,184
104,16,comma,110,201.9962,47.7326,400545,400576,31
104,0,blank,0,205.716283333333,38.01105,400637,400819,182
104,15,str2,104,192.422766666667,24.8825,400819,401006,187
104,15,str2,104,169.6246,24.7447,401117,401214,97
104,0,blank,0,-323,-105,401246,401402,156
104,0,blank,0,-323,-105,401402,401452,50
104,0,blank,0,106.2972,1.0895,401513,401543,30
104,16,a1,111,224.205571428571,38.0292571428571,401606,401805,199
104,16,a1,111,223.1378,33.7474666666667,401805,401979,174
104,16,),112,237.365433333333,52.1389,401979,402150,171
104,16,a1,111,228.079983333333,48.1539833333333,402150,402331,181
104,17,str2,118,245.1956,57.2290666666667,402331,402422,91
104,0,blank,0,653.413683333333,65.6996666666667,402483,402658,175
104,18,"Onremovingcharactersfromsecondstringweget:%s\n",125,647.4649,94.14385,402658,402775,117
104,0,blank,0,958.187833333333,432.591666666667,402833,403009,176
104,0,blank,0,955.547,469.029816666667,403009,403185,176
104,0,blank,0,956.7385,449.5913,403185,403301,116
104,0,blank,0,1025.28933333333,432.908983333333,403359,403543,184
104,0,blank,0,1031.37483333333,452.944766666667,403543,403718,175
104,0,blank,0,1031.40316666667,436.46715,403718,403895,177
104,0,blank,0,1031.99233333333,452.627783333333,403895,404073,178
104,0,blank,0,1038.48016666667,451.430433333333,404073,404251,178
104,0,blank,0,1032.47716666667,450.96695,404251,404449,198
104,0,blank,0,1046.21416666667,437.969016666667,404449,404627,178
104,0,blank,0,1032.1854,458.0541,404627,404774,147
104,0,blank,0,1029.95075,447.423225,404774,404967,193
104,0,blank,0,1020.5054,444.04326,404967,405148,181
104,0,blank,0,1030.461,454.0062,405148,405324,176
104,0,blank,0,1028.407,427.314975,405324,405460,136
105,0,blank,0,356.131157142857,588.262242857143,407347,407541,194
105,0,blank,0,357.663325,586.5992,407541,407652,111
105,0,blank,0,309.33465,640.62575,407709,407786,77
105,0,blank,0,364.89135,643.217866666667,407814,407994,180
105,0,blank,0,290.282125,623.0837,407994,408143,149
105,0,blank,0,55.7408,600.6106,408476,408669,193
105,0,blank,0,34.26955,608.3727,408669,408803,134
105,0,blank,0,48.2505666666667,589.270833333333,408889,408973,84
105,0,blank,0,105.158028571429,618.265742857143,409028,409222,194
105,0,blank,0,186.01235,669.84295,409222,409339,117
105,0,blank,0,508.4545,650.310733333333,409500,409581,81
105,0,blank,0,883.166428571429,384.167985714286,409687,409884,197
105,0,blank,0,947.472333333333,352.808466666667,409884,409971,87
105,0,blank,0,1002.407,269.029275,410028,410128,100
105,0,blank,0,1026.49166666667,231.6472,410190,410302,112
105,11,50,80,188.80298,210.23444,410390,410571,181
105,9,50,64,151.679825,170.35375,410571,410756,185
105,9,50,64,154.782783333333,160.288183333333,410756,410920,164
105,0,blank,0,169.6703,152.259033333333,410920,411077,157
105,0,blank,0,219.4736,153.614,411077,411303,226
105,0,blank,0,174.504325,145.17465,411303,411452,149
105,0,blank,0,306.3403,581.08264,411653,411779,126
105,0,blank,0,349.98365,582.7025,411836,411970,134
105,0,blank,0,336.14192,563.92988,411970,412149,179
105,0,blank,0,337.808671428571,553.871914285714,412149,412345,196
105,0,blank,0,337.9034,546.2243,412345,412402,57
105,0,blank,0,749.748857142857,659.176928571429,412537,412723,186
105,0,blank,0,751.814,666.052071428571,412723,412922,199
105,0,blank,0,711.536,675.337,412922,412951,29
105,0,blank,0,799.8625,686.4986,412979,413037,58
105,0,blank,0,767.018857142857,670.047857142857,413065,413263,198
105,0,blank,0,762.246,684.1699,413263,413290,27
105,0,blank,0,751.2126,663.80406,413345,413481,136
106,0,blank,0,788.1106,-103.96974,415503,415640,137
106,0,blank,0,781.757,753.55,415670,415724,54
106,0,blank,0,771.821285714286,729.359557142857,415780,415977,197
106,0,blank,0,753.9016,755.64834,415977,416117,140
106,0,blank,0,460.2346,-103.8997,416280,416305,25
106,0,blank,0,349.085775,690.098175,416455,416591,136
106,0,blank,0,325.58135,732.7403,416653,416716,63
106,0,blank,0,324.084,-103.9518,416813,416845,32
106,0,blank,0,183.6475,510.82455,416965,417015,50
106,39,strlen,258,212.8225,498.1528,417040,417068,28
106,41,-,273,241.6136,553.9626,417097,417266,169
106,0,blank,0,262.375766666667,565.999666666667,417266,417446,180
106,41,str,269,192.4617,545.16135,417474,417584,110
106,0,blank,0,-323,-105,417634,417823,189
106,0,blank,0,-323,-105,417823,418012,189
106,0,blank,0,-323,-105,418012,418193,181
106,0,blank,0,206.534575,-103.94255,418379,418496,117
106,0,blank,0,334.4254,-103.9445,418550,418578,28
106,0,blank,0,215.11295,-103.9674,418633,418689,56
106,0,blank,0,121.805183333333,764.0377,418746,418917,171
106,0,blank,0,101.885033333333,748.707383333333,418976,419153,177
106,0,blank,0,127.154214285714,742.8203,419153,419349,196
106,0,blank,0,128.25055,767.42555,419349,419409,60
106,0,blank,0,103.895233333333,738.194166666667,419493,419604,111
106,0,blank,0,128.632433333333,720.7431,419691,419834,143
106,0,blank,0,213.1531,794.1184,419894,419923,29
106,0,blank,0,201.113483333333,761.6769,419979,420150,171
106,0,blank,0,174.6788,773.8221,420150,420180,30
106,0,blank,0,186.95455,741.619225,420286,420431,145
106,0,blank,0,289.9328,744.6935,420513,420540,27
106,0,blank,0,110.4713,742.36375,420569,420626,57
106,0,blank,0,175.9406,748.3923,420682,420800,118
106,0,blank,0,135.51832,743.02532,420853,421052,199
106,0,blank,0,124.0762,752.19985,421109,421163,54
106,0,blank,0,96.3879333333334,729.692933333333,421216,421297,81
106,0,blank,0,56.4979,742.1075,421350,421381,31
106,0,blank,0,54.2984666666667,734.190416666667,421462,421660,198
106,0,blank,0,42.1036,773.9255,421716,421747,31
106,0,blank,0,21.0427,692.0368,422143,422168,25
106,0,blank,0,28.5393333333333,771.6063,422251,422337,86
106,0,blank,0,69.03155,759.8128,422394,422451,57
106,0,blank,0,60.2758571428571,750.829785714286,422531,422730,199
106,0,blank,0,78.3286666666666,749.462283333333,422730,422895,165
106,47,str_rem,298,58.4118,673.1403,422951,422978,27
106,0,blank,0,93.9484,743.9307,423033,423059,26
106,0,blank,0,73.4194833333333,728.50485,423113,423284,171
106,0,blank,0,79.4321,743.061875,423284,423426,142
106,0,blank,0,90.0546857142857,753.270485714286,423479,423671,192
106,0,blank,0,-323,-105,423830,423909,79
106,0,blank,0,112.9678,778.3201,424018,424043,25
106,0,blank,0,128.016,-103.999,424092,424117,25
106,0,blank,0,96.9548,768.419,424144,424199,55
106,0,blank,0,-323,-105,424254,424355,101
106,0,blank,0,98.19974,752.59436,424381,424505,124
106,0,blank,0,70.1198,747.9391,424617,424644,27
106,0,blank,0,100.87935,757.908775,424700,424811,111
106,0,blank,0,96.3616,793.7997,424869,424900,31
106,0,blank,0,92.5861,745.8017,424984,425152,168
106,0,blank,0,91.1707,760.46578,425152,425324,172
106,0,blank,0,142.6062,-103.8218,425353,425531,178
106,0,blank,0,100.2378,-103.8152,425531,425706,175
106,0,blank,0,86.0170571428572,-103.8546,425706,425902,196
106,0,blank,0,42.4781,-103.7689,425902,425930,28
106,0,blank,0,70.8811,-103.827966666667,425958,426043,85
106,0,blank,0,124.17065,-103.76695,426152,426233,81
106,0,blank,0,70.27905,-103.88505,426284,426418,134
106,0,blank,0,-323,-105,426497,426676,179
106,0,blank,0,-323,-105,426676,426853,177
106,0,blank,0,-323,-105,426853,426944,91
106,0,blank,0,-323,-105,426944,427436,492
106,0,blank,0,-323,-105,427436,427612,176
106,0,blank,0,-323,-105,427612,427811,199
106,0,blank,0,-323,-105,427811,427988,177
106,0,blank,0,-323,-105,427988,428175,187
106,0,blank,0,-323,-105,428175,428251,76
106,39,strlen,258,240.431,500.6531,428295,428327,32
106,42,list,279,145.69254,564.13282,428372,428555,183
106,0,blank,0,154.381342857143,578.490385714286,428555,428748,193
106,0,blank,0,183.4904,530.35095,428748,428821,73
106,0,blank,0,-323,-105,428868,428972,104
106,0,blank,0,200.1343,529.2512,429004,429115,111
106,39,strlen,258,251.382228571429,507.309257142857,429229,429414,185
106,38,0,246,162.506042857143,481.669371428571,429414,429606,192
106,0,blank,0,187.599071428571,452.554128571429,429606,429798,192
106,36,[,237,247.459771428571,427.991557142857,429798,429991,193
106,36,char,230,141.026571428571,431.374928571429,430020,430219,199
106,0,blank,0,142.494333333333,418.710533333333,430219,430303,84
106,0,blank,0,50.9739714285714,453.107014285714,430331,430529,198
106,38,comma,247,98.2757428571429,469.694728571429,430529,430727,198
106,0,blank,0,139.979157142857,464.157657142857,430727,430925,198
106,0,blank,0,128.141357142857,477.749771428571,430925,431124,199
106,0,blank,0,142.115983333333,518.781,431124,431295,171
106,41,str,269,168.683542857143,545.510628571429,431295,431494,199
106,41,str,269,186.137816666667,535.99475,431494,431668,174
106,0,blank,0,210.3965,528.5668,431668,431696,28
106,0,blank,0,-323,-105,431725,431856,131
106,0,blank,0,174.550957142857,525.334742857143,431977,432168,191
106,0,blank,0,232.115783333333,549.871866666667,432168,432341,173
106,0,blank,0,230.804471428571,545.324785714286,432341,432540,199
106,0,blank,0,232.62305,542.68335,432540,432654,114
106,0,blank,0,114.932842857143,407.668057142857,432683,432882,199
106,0,blank,0,102.550971428571,416.100942857143,432882,433080,198
106,0,blank,0,313.215157142857,451.831157142857,433108,433307,199
106,0,blank,0,356.934914285714,447.160385714286,433307,433506,199
106,36,],238,377.8294,439.9655,433506,433563,57
106,0,blank,0,232.567633333333,550.079766666667,433591,433763,172
106,41,str,269,188.494033333333,552.082766666667,433763,433935,172
106,0,blank,0,155.3757,550.2927,433935,434049,114
106,0,blank,0,-323,-105,434078,434233,155
106,41,=,268,150.083242857143,552.0737,434346,434535,189
106,41,index,267,129.842085714286,541.794414285714,434535,434734,199
106,0,blank,0,124.578171428571,559.416871428571,434734,434929,195
106,41,index,267,114.018171428571,544.5217,434929,435127,198
106,42,if,276,99.9534714285714,562.008485714286,435127,435324,197
106,0,blank,0,133.6959,555.399,435324,435520,196
106,42,list,279,168.369428571429,559.256228571429,435520,435718,198
106,41,[,270,201.4198,553.362671428571,435718,435916,198
106,0,blank,0,225.2721,538.4831,435916,436087,171
106,42,index,281,225.2094,558.338633333333,436087,436173,86
106,0,blank,0,-323,-105,436230,436331,101
106,0,blank,0,129.9046,528.2379,436356,436404,48
106,42,if,276,102.569866666667,564.120483333333,436497,436681,184
106,0,blank,0,63.6499857142857,563.743514285714,436681,436874,193
106,41,index,267,88.7323142857143,553.197571428571,436874,437071,197
106,0,blank,0,128.299166666667,525.7891,437071,437155,84
106,0,blank,0,-323,-105,437183,437336,153
106,0,blank,0,142.7,519.1729,437367,437427,60
106,41,=,268,143.635514285714,549.965571428571,437514,437702,188
106,41,str,269,179.855985714286,542.939914285714,437702,437901,199
106,0,blank,0,254.69122,534.50514,437901,438042,141
106,0,blank,0,-323,-105,438129,438319,190
106,0,blank,0,-323,-105,438319,438506,187
106,0,blank,0,-323,-105,438506,438665,159
106,0,blank,0,-323,-105,438665,438829,164
106,0,blank,0,-323,-105,438829,439014,185
106,0,blank,0,-323,-105,439014,439200,186
106,0,blank,0,96.861,454.890428571429,439235,439426,191
106,0,blank,0,32.5843857142857,461.422671428571,439426,439625,199
106,0,blank,0,56.4684857142857,452.371542857143,439625,439824,199
106,0,blank,0,133.890116666667,455.207166666667,439824,439995,171
106,0,blank,0,76.228,447.291266666667,439995,440168,173
106,0,blank,0,-323,-105,440255,440442,187
106,0,blank,0,-323,-105,440442,440606,164
106,0,blank,0,-323,-105,440606,440754,148
106,0,blank,0,-323,-105,440754,440923,169
106,0,blank,0,-323,-105,440923,441028,105
106,0,blank,0,-323,-105,441028,441204,176
106,0,blank,0,-323,-105,441204,441394,190
106,0,blank,0,-323,-105,441394,441521,127
106,0,blank,0,-323,-105,441521,441700,179
106,0,blank,0,-323,-105,441700,441867,167
106,0,blank,0,-323,-105,441867,442050,183
106,0,blank,0,-323,-105,442050,442226,176
106,0,blank,0,-323,-105,442226,442394,168
106,0,blank,0,-323,-105,442394,442529,135
106,0,blank,0,-323,-105,442529,442698,169
106,0,blank,0,-323,-105,442698,442957,259
106,0,blank,0,-323,-105,442957,443131,174
106,0,blank,0,-323,-105,443131,443328,197
106,0,blank,0,-323,-105,443328,443500,172
106,0,blank,0,-323,-105,443500,443693,193
106,0,blank,0,-323,-105,443693,443850,157
106,0,blank,0,-323,-105,443850,444043,193
106,0,blank,0,-323,-105,444043,444237,194
106,41,index,267,90.4094,547.5102,444271,444382,111
106,0,blank,0,-323,-105,444420,444607,187
106,0,blank,0,-323,-105,444607,444785,178
106,0,blank,0,-323,-105,444785,444972,187
106,0,blank,0,-323,-105,444972,445163,191
106,0,blank,0,-323,-105,445163,445200,37
106,0,blank,0,-323,-105,445200,445398,198
106,0,blank,0,-323,-105,445398,445474,76
106,0,blank,0,-323,-105,445474,445710,236
106,0,blank,0,-323,-105,445710,445744,34
106,0,blank,0,-323,-105,445744,446158,414
106,0,blank,0,-323,-105,446158,446211,53
106,0,blank,0,-323,-105,446211,446402,191
106,0,blank,0,-323,-105,446402,446533,131
106,0,blank,0,-323,-105,446916,446983,67
106,0,blank,0,453.0908,392.54115,447127,447304,177
106,0,blank,0,467.944025,417.055025,447304,447468,164
106,0,blank,0,472.624466666667,448.740333333333,447468,447586,118
106,0,blank,0,374.8098,458.6799,447624,447662,38
106,42,list,279,173.9036,572.437057142857,447705,447901,196
106,42,[,280,179.536571428571,561.8435,447901,448096,195
106,42,list,279,169.929171428571,566.427042857143,448096,448292,196
106,42,[,280,175.65955,570.913783333333,448292,448460,168
106,0,blank,0,-323,-105,448488,448667,179
106,0,blank,0,149.3119,522.81,448692,448718,26
106,0,blank,0,120.9446,532.790128571429,448774,448957,183
106,0,blank,0,146.69868,515.634,448957,449145,188
106,0,blank,0,172.603333333333,590.963666666667,449145,449248,103
106,44,str_rem,285,173.77195,600.5873,449248,449422,174
106,0,blank,0,123.256366666667,619.5924,449422,449612,190
106,0,blank,0,137.474614285714,581.886242857143,449612,449808,196
106,0,blank,0,-323,-105,449863,450030,167
106,0,blank,0,186.854942857143,590.063242857143,450176,450364,188
106,0,blank,0,204.714842857143,589.676171428571,450364,450562,198
106,44,str_rem,285,172.289416666667,611.885866666667,450562,450756,194
106,44,str_rem,285,153.924128571429,619.535971428571,450756,450950,194
106,44,str_rem,285,153.460357142857,618.518385714286,450950,451145,195
106,44,str_rem,285,139.897142857143,609.6584,451145,451342,197
106,44,str_rem,285,152.8024,617.0735,451342,451371,29
106,0,blank,0,-323,-105,451428,451612,184
106,0,blank,0,176.9189,640.4053,451998,452083,85
106,0,blank,0,-323,-105,452479,452665,186
106,0,blank,0,-323,-105,452665,452851,186
106,41,str,269,189.6998,547.5732,453141,453217,76
106,0,blank,0,181.3623,644.8734,453258,453341,83
106,44,str_rem,285,186.624,607.99838,453416,453606,190
106,0,blank,0,242.1706,608.1302,453606,453636,30
106,0,blank,0,177.73218,579.59278,453690,453863,173
106,0,blank,0,160.89375,549.803025,453863,453983,120
106,0,blank,0,154.8685,592.2619,454072,454148,76
106,0,blank,0,200.3644,586.3197,454206,454234,28
106,0,blank,0,176.9088,651.152,454261,454292,31
106,0,blank,0,234.93784,652.741,454351,454494,143
106,0,blank,0,196.7773,579.4575,454521,454548,27
106,44,[,292,200.5638,615.412233333333,454606,454693,87
106,0,blank,0,-323,-105,454721,454905,184
106,0,blank,0,-323,-105,454905,454941,36
106,0,blank,0,133.1944,583.9219,454975,454999,24
106,44,str_rem,285,166.886714285714,614.130114285714,455049,455239,190
106,0,blank,0,127.366633333333,532.559533333333,455297,455382,85
106,0,blank,0,109.40714,592.4279,455411,455583,172
106,0,blank,0,-323,-105,455608,455790,182
106,0,blank,0,125.6087,579.1836,455823,455868,45
106,0,blank,0,142.48925,553.36745,456069,456129,60
106,0,blank,0,172.795285714286,623.974885714286,456184,456377,193
106,44,[,292,198.41636,604.51484,456377,456514,137
106,42,[,280,180.423325,566.873425,456569,456702,133
106,0,blank,0,144.252516666667,578.093766666667,456730,456895,165
106,0,blank,0,143.36888,514.72144,456895,457077,182
106,0,blank,0,157.879471428571,506.101114285714,457077,457275,198
106,42,[,280,177.1793,557.236,457275,457332,57
106,0,blank,0,-323,-105,457389,457490,101
106,0,blank,0,236.7013,661.6275,457515,457542,27
106,0,blank,0,176.1485,620.568242857143,457605,457795,190
106,0,blank,0,214.2665,633.1201,457795,457963,168
106,0,blank,0,194.546675,635.242225,457963,458143,180
106,44,str_rem,285,169.2185,607.6991,458143,458221,78
106,44,str_rem,285,168.734128571429,608.555985714286,458276,458469,193
106,44,str_rem,285,178.235742857143,618.8688,458469,458667,198
106,0,blank,0,195.945166666667,622.477233333333,458667,458838,171
106,0,blank,0,255.123066666667,599.268716666667,458866,459035,169
106,44,str,291,290.2307,608.2332,459035,459224,189
106,0,blank,0,288.465433333333,587.963766666667,459224,459399,175
106,44,str_rem,285,168.563866666667,616.775966666667,459449,459550,101
106,0,blank,0,161.50125,588.8545,459575,459682,107
106,0,blank,0,-323,-105,459710,459839,129
106,0,blank,0,174.2631,562.988157142857,459973,460158,185
106,42,[,280,177.833542857143,563.843742857143,460158,460355,197
106,0,blank,0,194.0957,577.164,460355,460469,114
106,41,-,273,242.046328571429,543.8062,460497,460694,197
106,42,),283,248.0282,563.606616666667,460694,460862,168
106,0,blank,0,186.559783333333,584.127466666667,460862,461054,192
106,42,list,279,154.737066666667,556.678066666667,461054,461213,159
106,0,blank,0,-323,-105,461263,461414,151
106,0,blank,0,293.2061,547.5479,461444,461487,43
106,41,a,274,260.166,552.63476,461576,461707,131
106,0,blank,0,263.86376,565.18036,461707,461888,181
106,0,blank,0,233.5796,553.076866666667,461888,461970,82
106,0,blank,0,393.1652,462.076233333333,462026,462157,131
106,36,[,237,487.2984,429.33055,462182,462232,50
106,0,blank,0,454.4022,492.7378,462261,462320,59
106,0,blank,0,167.3995,578.5841,462402,462458,56
106,0,blank,0,255.77215,586.9972,462485,462543,58
106,0,blank,0,243.7416,668.7351,462573,462629,56
106,0,blank,0,200.7569,522.5585,462654,462705,51
106,44,j,287,210.261466666667,609.529533333333,462835,462912,77
106,0,blank,0,-323,-105,462973,463124,151
106,0,blank,0,197.717,648.87252,463233,463361,128
106,0,blank,0,393.8817,749.2741,463388,463444,56
106,0,blank,0,206.10804,655.34904,463469,463614,145
106,0,blank,0,271.366933333333,637.969833333333,463642,463809,167
106,44,str,291,300.5364,613.3718,463866,463921,55
106,0,blank,0,302.514,669.83745,464002,464054,52
106,0,blank,0,282.753742857143,625.449757142857,464110,464298,188
106,0,blank,0,223.61855,577.177225,464298,464433,135
106,0,blank,0,191.6965,592.08865,464493,464556,63
106,0,blank,0,213.97505,581.1878,464614,464672,58
106,0,blank,0,165.018625,639.214075,464731,464870,139
106,0,blank,0,161.2446,620.0281,464954,464980,26
106,0,blank,0,173.07798,598.42032,465004,465201,197
106,44,j,287,207.03415,613.70765,465201,465363,162
106,42,list,279,167.5103,567.98066,465363,465546,183
106,42,list,279,158.021433333333,565.027866666667,465546,465740,194
106,0,blank,0,182.74636,642.96686,465740,465906,166
106,0,blank,0,-323,-105,465930,466083,153
106,0,blank,0,488.134683333333,757.098716666667,466205,466390,185
106,0,blank,0,500.9612,726.890866666667,466390,466586,196
106,0,blank,0,482.0756,777.2573,466586,466613,27
106,0,blank,0,504.84215,714.97935,466698,466871,173
106,0,blank,0,575.40725,775.22985,466926,466985,59
106,0,blank,0,586.4731,770.894,467068,467095,27
106,0,blank,0,590.6483,-103.95575,467181,467237,56
106,0,blank,0,568.18975,-103.9817,467348,467459,111
106,0,blank,0,517.6521,761.9305,467542,467597,55
106,0,blank,0,536.0015,-103.9757,467656,467685,29
106,0,blank,0,638.76795,744.61385,467712,467797,85
106,0,blank,0,629.9239,754.14085,467967,468024,57
106,0,blank,0,552.99046,751.88782,468054,468194,140
106,0,blank,0,538.28275,743.13115,468255,468432,177
106,0,blank,0,580.4413,734.61705,468432,468485,53
106,0,blank,0,621.95135,715.637025,468544,468660,116
106,0,blank,0,575.6981,701.841125,468692,468865,173
106,0,blank,0,579.7699,735.99586,468865,469011,146
106,0,blank,0,542.689433333333,718.589966666667,469011,469154,143
106,0,blank,0,556.2305,709.1611,469154,469267,113
106,0,blank,0,509.0088,754.4842,469402,469427,25
106,0,blank,0,549.88755,737.98305,469453,469510,57
106,0,blank,0,-323,-105,469736,469807,71
106,0,blank,0,-323,-105,469807,469946,139
106,18,"Onremovingcharactersfromsecondstringweget:%s\n",125,433.951733333333,43.3554666666667,469976,470074,98
106,0,blank,0,416.3565,20.5822,470159,470209,50
106,0,blank,0,268.62435,26.474,470235,470408,173
106,0,blank,0,242.69888,26.63854,470494,470684,190
106,17,;,122,308.6601,13.0235666666667,470684,470865,181
106,18,"Onremovingcharactersfromsecondstringweget:%s\n",125,389.51866,31.10138,470865,471027,162
106,0,blank,0,290.6133,78.5401,471027,471082,55
106,0,blank,0,450.2382,4.6294,471107,471213,106
106,0,blank,0,557.002883333333,24.4289666666667,471300,471492,192
106,0,blank,0,542.4495,18.8473,471492,471662,170
106,0,blank,0,579.47166,-9.6398,471662,471832,170
106,0,blank,0,649.9812,-8.627,471832,472027,195
106,0,blank,0,630.9329,2.9128,472027,472057,30
106,0,blank,0,330.5112,8.78424999999999,472217,472267,50
106,18,"Onremovingcharactersfromsecondstringweget:%s\n",125,174.829383333333,30.0796166666667,472292,472488,196
106,17,comma,119,194.05925,14.49465,472488,472651,163
106,0,blank,0,315.624566666667,16.7890833333333,472679,472852,173
106,0,blank,0,368.776816666667,19.5861333333333,472852,473047,195
106,0,blank,0,447.13695,15.4674,473047,473205,158
106,0,blank,0,455.30755,-43.4884,473205,473313,108
106,0,blank,0,423.8434,-8.9218,473363,473390,27
106,0,blank,0,559.9626,56.9689,473417,473445,28
106,0,blank,0,549.549216666667,12.3215166666667,473477,473659,182
106,0,blank,0,591.89526,23.69506,473659,473808,149
106,0,blank,0,636.45786,-1.48062,473808,473980,172
106,0,blank,0,641.99768,9.35734,473980,474129,149
106,18,comma,126,676.49432,27.6729,474129,474303,174
106,0,blank,0,684.7379,17.6157,474303,474363,60
106,42,],282,237.8059,560.496,474423,474502,79
106,41,],272,220.50038,549.10594,474529,474673,144
106,0,blank,0,236.128475,632.27075,474673,474833,160
106,0,blank,0,198.551175,594.49175,474859,475025,166
106,44,str_rem,285,144.3086,612.5158,475076,475105,29
106,0,blank,0,206.6189,592.0755,475135,475243,108
106,0,blank,0,187.944875,625.477125,475301,475439,138
106,0,blank,0,-323,-105,475497,475678,181
106,0,blank,0,-323,-105,475678,475714,36
106,42,index,281,195.210866666667,570.47275,475766,475940,174
106,0,blank,0,253.49984,667.35776,475940,476113,173
106,0,blank,0,224.174633333333,640.784466666667,476113,476221,108
106,0,blank,0,211.1409,593.379483333333,476251,476429,178
106,42,list,279,167.44845,568.1623,476429,476602,173
106,0,blank,0,145.864928571429,590.558342857143,476602,476800,198
106,0,blank,0,157.31,599.725433333333,476800,476973,173
106,0,blank,0,206.78815,640.569416666667,476973,477172,199
106,0,blank,0,245.931375,619.813775,477172,477365,193
106,42,list,279,158.4685,555.04835,477365,477472,107
106,41,str,269,168.689257142857,537.768357142857,477497,477691,194
106,0,blank,0,143.323616666667,517.454383333333,477691,477887,196
106,0,blank,0,158.560316666667,527.886066666667,477887,478065,178
106,0,blank,0,140.498883333333,522.6397,478065,478242,177
106,0,blank,0,158.085683333333,515.521116666667,478242,478420,178
106,0,blank,0,154.4998,500.56605,478420,478598,178
106,39,i,263,170.89515,492.16255,478598,478778,180
106,0,blank,0,182.189383333333,524.090283333333,478778,478959,181
106,42,index,281,185.88425,571.921033333333,478959,479139,180
106,42,index,281,186.0999,569.191783333333,479139,479321,182
106,0,blank,0,182.253883333333,579.767183333333,479321,479500,179
106,44,[,292,196.400983333333,610.909433333333,479500,479677,177
106,0,blank,0,213.5567,644.865966666667,479677,479855,178
106,0,blank,0,180.3986,635.8162,479855,479914,59
106,0,blank,0,-323,-105,479943,480102,159
106,0,blank,0,201.0435,631.91205,480261,480433,172
106,0,blank,0,210.168383333333,647.044316666667,480433,480612,179
106,0,blank,0,189.499166666667,595.26075,480612,480792,180
106,0,blank,0,189.12916,590.63836,480792,480937,145
106,0,blank,0,336.19075,678.23895,480966,481053,87
106,0,blank,0,169.82904,579.44218,481163,481310,147
106,44,str_rem,285,181.2782,616.631566666667,481370,481456,86
106,36,char,230,124.7414,435.8107,481544,481573,29
106,0,blank,0,201.52315,530.8673,481601,481658,57
106,41,[,270,202.4384,537.134333333333,481715,481802,87
106,0,blank,0,311.6031,781.4904,481831,481859,28
106,42,list,279,159.4813,570.1705,481888,481918,30
106,0,blank,0,245.460166666667,622.671833333333,482004,482120,116
106,0,blank,0,-323,-105,482150,482331,181
106,0,blank,0,467.62355,511.810725,482593,482734,141
106,17,str2_rem,116,174.896283333333,15.1342166666667,483011,483189,178
106,17,comma,119,200.254433333333,9.77613333333333,483189,483365,176
106,17,str2,118,219.0425,10.3498,483365,483394,29
106,0,blank,0,-323,-105,483423,483554,131
106,0,blank,0,270.409966666667,585.197333333333,483662,483739,77
106,0,blank,0,413.6631,776.2949,483769,483797,28
106,0,blank,0,400.0698,653.7138,483853,483880,27
106,0,blank,0,260.1151,586.16895,483911,483967,56
106,0,blank,0,293.80425,569.9465,484027,484087,60
106,44,str,291,287.1174,618.381666666667,484144,484316,172
106,0,blank,0,294.447983333333,624.142616666667,484316,484486,170
106,0,blank,0,319.67665,620.433,484543,484599,56
106,0,blank,0,297.05425,632.0478,484658,484714,56
106,0,blank,0,267.0184,608.6492,484745,484773,28
106,44,str,291,277.427671428571,604.780285714286,484801,484997,196
106,0,blank,0,311.6061,652.8453,484997,485025,28
106,47,=,302,162.9628,677.1766,485164,485193,29
106,0,blank,0,186.7295,737.5811,485382,485409,27
106,0,blank,0,291.5083,-103.957566666667,485546,485733,187
106,0,blank,0,216.2814,-103.930333333333,485733,485844,111
106,0,blank,0,348.2735,-103.962,485930,485956,26
106,0,blank,0,122.0424,686.7509,486113,486138,25
106,0,blank,0,124.638814285714,715.682214285714,486242,486437,195
106,0,blank,0,139.33752,720.20372,486437,486580,143
106,0,blank,0,366.82685,-103.9526,486665,486748,83
106,0,blank,0,225.901033333333,743.0094,486775,486913,138
106,0,blank,0,193.03385,747.6449,486913,487025,112
106,0,blank,0,293.5424,-103.9656,487053,487082,29
106,0,blank,0,261.431,708.2211,487170,487228,58
106,48,},305,199.130283333333,674.92185,487284,487482,198
106,0,blank,0,272.3406,730.3408,487482,487511,29
106,0,blank,0,442.6351,-103.9237,487540,487569,29
106,0,blank,0,-323,-105,487624,487805,181
106,0,blank,0,-323,-105,487805,487831,26
106,0,blank,0,167.091866666667,729.624866666667,488043,488200,157
106,0,blank,0,343.9644,-103.9903,488255,488280,25
106,0,blank,0,351.663,773.3326,488395,488450,55
106,0,blank,0,218.0045,676.7827,488533,488560,27
106,0,blank,0,154.1112,639.9403,488645,488674,29
106,0,blank,0,328.5453,661.9,488703,488732,29
106,0,blank,0,247.85605,638.0029,488759,488816,57
106,0,blank,0,294.3116,729.2099,488847,488904,57
106,0,blank,0,222.8082,652.693,489041,489068,27
106,0,blank,0,-323,-105,489097,489277,180
106,0,blank,0,-323,-105,489277,489437,160
106,0,blank,0,127.8105,640.7988,489464,489512,48
106,0,blank,0,177.6774,771.3993,489538,489669,131
106,0,blank,0,244.174066666667,658.8015,489914,490095,181
106,0,blank,0,254.1783,645.2272,490095,490154,59
106,0,blank,0,247.74045,635.4754,490154,490353,199
106,0,blank,0,-323,-105,490402,490587,185
106,0,blank,0,-323,-105,490587,490712,125
106,44,=,290,256.8167,608.3032,491168,491481,313
106,0,blank,0,327.1511,635.688175,491481,491644,163
106,0,blank,0,270.446,612.47415,491721,491800,79
106,0,blank,0,287.4956,650.96225,491883,491962,79
106,42,list,279,166.90424,568.41858,492002,492176,174
106,42,list,279,164.561614285714,566.689557142857,492176,492372,196
106,0,blank,0,153.617714285714,576.004557142857,492372,492568,196
106,0,blank,0,140.7852,576.660214285714,492568,492758,190
106,0,blank,0,158.664328571429,583.122171428571,492758,492953,195
106,0,blank,0,160.94775,597.01405,492953,493009,56
106,0,blank,0,-323,-105,493037,493168,131
106,42,index,281,228.5237,571.2551,493215,493273,58
106,42,list,279,140.570685714286,575.795014285714,493344,493530,186
106,42,(,277,117.933485714286,561.4385,493530,493726,196
106,0,blank,0,132.091585714286,555.491028571429,493726,493922,196
106,42,(,277,122.864342857143,557.602014285714,493922,494119,197
106,41,index,267,120.3864,552.063716666667,494119,494288,169
106,0,blank,0,-323,-105,494316,494472,156
106,0,blank,0,126.8413,533.7046,494514,494569,55
106,42,!,278,130.376471428571,557.886357142857,494631,494818,187
106,42,list,279,138.943814285714,562.759928571429,494818,495017,199
106,0,blank,0,155.69745,549.814183333333,495017,495189,172
106,42,list,279,164.907614285714,557.362842857143,495189,495387,198
106,0,blank,0,100.998928571429,642.216571428571,495387,495586,199
106,47,str_rem,298,66.7114142857143,676.835657142857,495586,495783,197
106,0,blank,0,29.81425,655.427416666667,495783,495954,171
106,0,blank,0,14.8282166666667,671.751033333333,495954,496125,171
106,0,blank,0,8.96574999999999,688.450325,496125,496240,115
106,0,blank,0,494.93814,724.40874,496298,496443,145
106,0,blank,0,866.095833333333,619.85115,496501,496675,174
106,0,blank,0,872.794,630.8022,496675,496704,29
106,0,blank,0,936.078333333333,559.611883333333,496733,496908,175
106,0,blank,0,940.771,526.972866666667,496908,497081,173
106,0,blank,0,947.162833333333,494.406566666667,497081,497254,173
106,0,blank,0,935.612,503.1364,497254,497426,172
106,0,blank,0,937.097857142857,499.7644,497426,497625,199
106,0,blank,0,933.950833333333,500.834233333333,497625,497798,173
106,0,blank,0,937.913,506.442383333333,497798,497969,171
106,0,blank,0,942.900714285714,503.686642857143,497969,498168,199
106,0,blank,0,944.139833333334,505.73575,498168,498340,172
106,0,blank,0,936.1735,506.922683333333,498340,498513,173
106,0,blank,0,940.557666666667,506.64575,498513,498684,171
106,0,blank,0,948.207833333333,500.42555,498684,498856,172
106,0,blank,0,145.908314285714,622.077414285714,498942,499141,199
106,44,str_rem,285,134.141285714286,616.666714285714,499141,499340,199
106,0,blank,0,47.6709428571428,664.449271428571,499340,499534,194
106,0,blank,0,18.8646571428571,664.3558,499534,499730,196
106,0,blank,0,70.1823571428571,661.299328571429,499730,499925,195
106,47,str_rem,298,54.5146571428571,668.352514285714,499925,500119,194
106,47,str_rem,298,103.40645,679.8528,500119,500286,167
106,0,blank,0,-323,-105,500343,500528,185
106,0,blank,0,52.92605,-103.89975,500554,500602,48
106,0,blank,0,79.0042,729.9435,500629,500656,27
106,0,blank,0,86.4278,-103.944766666667,500715,500889,174
106,0,blank,0,-25.876,762.3057,500923,500954,31
106,0,blank,0,77.0931,-103.9012,501073,501101,28
106,45,},296,89.8327285714286,640.842128571429,501166,501365,199
106,0,blank,0,84.39875,655.909875,501365,501474,109
106,47,str_rem,298,94.6054714285714,679.282042857143,501527,501722,195
106,47,str_rem,298,81.8457428571429,669.632871428572,501722,501919,197
106,47,str_rem,298,87.6519714285714,685.386928571428,501919,502115,196
106,0,blank,0,99.1203166666667,646.466383333333,502115,502289,174
106,0,blank,0,102.789533333333,665.6356,502289,502461,172
106,47,str_rem,298,89.7960166666667,679.3861,502461,502634,173
106,0,blank,0,84.5802,694.656083333333,502634,502808,174
106,0,blank,0,80.649,691.244975,502808,502922,114
106,47,str_rem,298,92.8425666666667,672.648083333333,502951,503124,173
106,0,blank,0,169.139816666667,660.803366666667,503124,503297,173
106,47,=,302,162.51465,680.894075,503297,503412,115
106,0,blank,0,-323,-105,503441,503622,181
106,0,blank,0,68.1095,742.2495,503698,503723,25
106,0,blank,0,59.3988,-103.979,503750,503780,30
106,0,blank,0,53.5374,779.5635,503808,503837,29
106,0,blank,0,91.530975,769.51505,503951,504066,115
106,0,blank,0,65.7359,728.3223,504238,504455,217
106,0,blank,0,55.4747,771.546,504455,504483,28
106,0,blank,0,109.8178,-103.9905,504512,504541,29
106,0,blank,0,91.2015,-103.9786,504628,504655,27
106,0,blank,0,93.3522,753.817,504685,504714,29
106,0,blank,0,123.6997,-103.9721,504795,504823,28
106,0,blank,0,113.50155,782.70865,504906,504958,52
106,0,blank,0,154.0158,779.4215,504958,505120,162
106,0,blank,0,-323,-105,505224,505376,152
106,0,blank,0,-323,-105,505376,505457,81
106,0,blank,0,263.839233333333,625.514983333333,505490,505665,175
106,0,blank,0,266.564666666667,632.5689,505665,505837,172
106,0,blank,0,269.002971428571,622.376328571429,505837,506035,198
106,0,blank,0,254.842533333333,623.687766666667,506035,506122,87
106,0,blank,0,168.02415,580.230266666667,506149,506320,171
106,42,list,279,149.7299,565.042085714286,506320,506519,199
106,41,=,268,147.061257142857,534.567557142857,506519,506717,198
106,42,list,279,147.175671428571,563.822942857143,506717,506915,198
106,0,blank,0,161.683566666667,553.127483333333,506915,507084,169
106,0,blank,0,171.166033333333,531.91325,507456,507629,173
106,0,blank,0,162.978742857143,545.571328571428,507629,507828,199
106,41,str,269,178.577014285714,538.884385714286,507828,508027,199
106,42,!,278,128.560814285714,570.990657142857,508027,508226,199
106,0,blank,0,111.067466666667,574.429783333333,508226,508398,172
106,0,blank,0,100.274083333333,577.2994,508398,508571,173
106,0,blank,0,82.0286,561.22308,508571,508715,144
106,0,blank,0,-323,-105,508745,508901,156
106,0,blank,0,116.816328571429,513.6925,508928,509111,183
106,41,=,268,152.315771428571,543.420071428571,509111,509309,198
106,41,=,268,151.2439,543.96535,509309,509483,174
106,39,(,259,88.7817666666667,490.21275,509483,509655,172
106,0,blank,0,104.33615,528.39515,509655,509827,172
106,42,list,279,134.554633333333,572.53305,509827,509999,172
106,0,blank,0,140.712428571429,582.155928571429,509999,510198,199
106,41,=,268,150.78724,548.08144,510198,510363,165
106,0,blank,0,129.7261,585.1954,510363,510520,157
106,42,(,277,122.7672,561.06185,510520,510697,177
106,42,(,277,116.884666666667,569.324983333333,510697,510879,182
106,0,blank,0,131.512833333333,573.525416666667,510879,511052,173
106,42,list,279,142.903366666667,563.354683333333,511052,511225,173
106,41,str,269,177.945683333333,553.301116666667,511225,511398,173
106,42,[,280,182.8594,555.29165,511398,511455,57
106,0,blank,0,-323,-105,511484,511614,130
106,41,=,268,143.473014285714,544.655071428571,511698,511889,191
106,0,blank,0,139.949766666667,551.7367,511889,512062,173
106,0,blank,0,125.825816666667,570.697533333333,512062,512235,173
106,41,=,268,143.194616666667,551.490733333333,512235,512409,174
106,41,index,267,131.152483333333,544.677283333333,512409,512582,173
106,42,list,279,147.939766666667,561.564083333333,512582,512755,173
106,0,blank,0,160.650933333333,526.873483333333,512755,512929,174
106,0,blank,0,158.5255,541.05265,512929,513100,171
106,0,blank,0,161.443783333333,542.34315,513100,513274,174
106,41,str,269,172.5561,546.4337,513274,513446,172
106,41,str,269,178.233633333333,545.481333333333,513446,513618,172
106,0,blank,0,175.584933333333,554.271133333333,513618,513790,172
106,0,blank,0,181.81895,522.7672,513790,513847,57
106,0,blank,0,-323,-105,513876,513980,104
106,0,blank,0,-323,-105,514031,514062,31
106,42,],282,237.825857142857,562.104742857143,514088,514277,189
106,42,],282,238.459075,567.728325,514277,514393,116
106,41,str,269,188.842833333333,544.709,514450,514622,172
106,0,blank,0,161.088066666667,535.663833333333,514622,514794,172
106,0,blank,0,169.56894,531.82006,514794,514937,143
106,0,blank,0,-323,-105,514966,515165,199
106,0,blank,0,-323,-105,515165,515348,183
106,0,blank,0,-323,-105,515348,515510,162
106,42,index,281,221.8513,568.8765,515539,515585,46
106,0,blank,0,229.699216666667,545.751133333333,515614,515788,174
106,42,index,281,210.006033333333,559.005033333333,515788,515963,175
106,41,str,269,167.370883333333,542.202966666667,515963,516138,175
106,41,index,267,93.90115,536.659333333333,516138,516315,177
106,41,index,267,92.8428833333333,547.858916666667,516315,516495,180
106,0,blank,0,112.42415,533.7952,516495,516678,183
106,41,index,267,133.34795,546.298983333333,516678,516860,182
106,41,=,268,149.34865,544.426883333333,516860,517042,182
106,41,=,268,148.449833333333,548.359933333333,517042,517222,180
106,0,blank,0,211.853616666667,524.917583333333,517222,517396,174
106,41,str,269,164.2558,534.2493,517396,517424,28
106,39,strlen,258,238.19035,506.669566666667,517481,517658,177
106,41,-,273,242.38772,546.26086,517658,517806,148
106,41,],272,220.9157,544.9482,517864,517892,28
106,0,blank,0,218.022416666667,528.009633333333,517981,518153,172
106,0,blank,0,162.704183333333,554.113766666667,518153,518331,178
106,41,str,269,165.828716666667,550.272483333333,518331,518505,174
106,41,str,269,176.6315,553.108716666667,518505,518677,172
106,0,blank,0,181.034585714286,522.611185714286,518677,518876,199
106,41,str,269,182.6704,541.123533333333,518876,518961,85
106,0,blank,0,-323,-105,519017,519187,170
106,41,i,271,205.546114285714,535.356557142857,519383,519574,191
106,41,i,271,210.082866666667,539.507416666667,519574,519751,177
106,42,index,281,192.894983333333,559.49115,519751,519930,179
106,41,str,269,174.093483333333,548.666716666667,519930,520107,177
106,42,[,280,177.057983333333,559.198583333333,520107,520283,176
106,0,blank,0,155.448583333333,506.3601,520283,520461,178
106,0,blank,0,154.0195,458.118416666667,520461,520636,175
106,0,blank,0,178.764866666667,507.99645,520636,520813,177
106,0,blank,0,236.213066666667,529.070966666667,520813,520999,186
106,42,),283,247.6115,569.0221,520999,521092,93
106,0,blank,0,-323,-105,521123,521241,118
106,0,blank,0,234.7245,533.9887,521457,521634,177
106,0,blank,0,243.443283333333,519.094583333333,521634,521815,181
106,0,blank,0,231.988583333333,536.540483333333,521846,522038,192
106,0,blank,0,170.50894,522.77134,522038,522206,168
106,0,blank,0,159.48092,530.08616,522206,522389,183
106,0,blank,0,166.24575,531.213233333333,522389,522578,189
106,26,tolower,174,177.144266666667,203.135033333333,522640,522835,195
106,0,blank,0,176.292733333333,191.683616666667,522835,523028,193
106,26,=,173,163.850516666667,204.193933333333,523028,523213,185
106,0,blank,0,163.7513,187.0496,523213,523402,189
106,0,blank,0,196.52975,160.42585,523402,523466,64
106,24,strlen,160,213.573966666667,165.897783333333,523535,523723,188
106,24,strlen,160,228.76084,170.83136,523723,523889,166
106,24,strlen,160,239.724266666667,167.2527,523889,523989,100
106,0,blank,0,-323,-105,524088,524266,178
106,0,blank,0,-323,-105,524266,524445,179
106,0,blank,0,-323,-105,524445,524619,174
106,0,blank,0,-323,-105,524619,524803,184
106,0,blank,0,-323,-105,524803,524995,192
106,0,blank,0,-323,-105,524995,525165,170
106,0,blank,0,-323,-105,525165,525334,169
106,0,blank,0,-323,-105,525334,525488,154
106,0,blank,0,-323,-105,525488,525584,96
106,0,blank,0,503.1036,-103.936216666667,525699,525882,183
106,0,blank,0,499.5289,-103.9529,525882,525943,61
106,36,str_rem,226,185.952025,427.2298,526003,526126,123
106,0,blank,0,75.71524,742.09546,526155,526308,153
106,0,blank,0,109.99935,-103.913633333333,526339,526520,181
106,0,blank,0,107.29555,-103.900983333333,526520,526702,182
106,0,blank,0,101.865066666667,-103.88055,526702,526885,183
106,0,blank,0,105.90566,-103.8749,526885,527038,153
106,28,printf,191,120.7919,256.8211,527100,527282,182
106,0,blank,0,154.937933333333,238.63175,527282,527464,182
106,27,str,184,167.134166666667,228.080433333333,527464,527639,175
106,0,blank,0,166.535816666667,211.104316666667,527639,527816,177
106,0,blank,0,163.99114,232.94082,527816,527961,145
106,0,blank,0,-323,-105,528050,528076,26
106,0,blank,0,668.02198,-103.83252,528377,528561,184
106,0,blank,0,640.16824,-103.85352,528561,528738,177
106,0,blank,0,708.489,-103.856933333333,528766,528853,87
106,0,blank,0,-323,-105,528982,529072,90
106,0,blank,0,632.4523,-103.84,529209,529286,77
106,0,blank,0,662.139216666667,-103.8209,529342,529514,172
106,0,blank,0,627.7842,-103.82958,529514,529680,166
106,0,blank,0,665.9218,-103.82348,529733,529923,190
106,0,blank,0,665.296471428571,-103.7881,529923,530107,184
106,0,blank,0,662.25966,-103.81504,530107,530283,176
106,0,blank,0,691.4988,-103.864216666667,530283,530465,182
106,0,blank,0,753.591,-103.8825,530580,530643,63
106,0,blank,0,678.422,-103.8319,530701,530839,138
106,0,blank,0,-323,-105,531031,531094,63
106,0,blank,0,535.0334,612.74365,531200,531265,65
106,0,blank,0,608.9807,-103.9911,531429,531455,26
106,0,blank,0,666.41204,-103.78846,531564,531762,198
106,0,blank,0,678.63328,-103.82372,531762,531926,164
106,0,blank,0,652.3064,-103.8699,531926,531985,59
106,0,blank,0,581.336,-103.841,531985,532205,220
106,0,blank,0,635.987616666667,-103.82135,532205,532367,162
106,0,blank,0,656.7528,-103.77795,532367,532566,199
106,0,blank,0,661.943757142857,-103.8196,532566,532760,194
106,0,blank,0,683.77535,-103.823516666667,532760,532947,187
106,0,blank,0,681.805333333333,-103.839933333333,532947,533129,182
106,0,blank,0,680.809085714286,-103.800614285714,533129,533318,189
106,0,blank,0,707.247757142857,-103.818814285714,533318,533508,190
106,0,blank,0,693.67484,-103.79854,533508,533703,195
106,0,blank,0,695.2925,-103.7873,533703,533895,192
106,0,blank,0,689.42078,-103.84844,533895,534086,191
106,0,blank,0,658.7758,-103.837233333333,534086,534278,192
106,0,blank,0,675.169628571429,-103.806542857143,534278,534467,189
106,0,blank,0,604.429157142857,-103.811342857143,534467,534657,190
106,0,blank,0,676.95822,-103.80098,534657,534834,177
106,0,blank,0,633.34986,-103.8385,534834,535002,168
106,0,blank,0,681.52585,-103.801016666667,535002,535199,197
106,0,blank,0,668.4884,-103.78252,535199,535358,159
106,0,blank,0,656.7184,-103.793666666667,535358,535515,157
106,0,blank,0,655.5692,-103.809133333333,535515,535703,188
106,0,blank,0,652.1225,-103.821316666667,535703,535897,194
106,0,blank,0,640.2662,-103.804466666667,535897,536095,198
106,0,blank,0,662.682385714286,-103.820371428571,536095,536289,194
106,0,blank,0,636.670328571429,-103.8023,536289,536482,193
106,0,blank,0,660.102142857143,-103.8075,536482,536675,193
106,0,blank,0,655.426616666667,-103.80895,536675,536847,172
106,0,blank,0,644.418171428571,-103.802157142857,536847,537040,193
106,0,blank,0,624.493033333333,-103.834133333333,537040,537123,83
106,0,blank,0,647.8191,-103.813725,537178,537286,108
106,0,blank,0,666.66085,-103.812883333333,537342,537506,164
106,0,blank,0,722.03,-103.6636,537506,537620,114
106,0,blank,0,647.419566666667,-103.777166666667,537745,537828,83
106,0,blank,0,496.70712,530.30002,538006,538156,150
106,0,blank,0,481.9951,558.5135,538272,538301,29
106,0,blank,0,156.05542,197.01122,538532,538721,189
106,28,"in=%d",193,192.525,263.8471,538721,538800,79
106,0,blank,0,492.1566,583.9997,538878,538903,25
106,31,=,211,214.343525,331.216475,538928,539104,176
106,31,index,209,193.153975,323.488225,539104,539301,197
106,0,blank,0,194.849066666667,293.0647,539405,539499,94
106,0,blank,0,181.9143,303.040566666667,539499,539690,191
106,28,"in=%d",193,170.9911,260.8265,539690,539870,180
106,29,),205,216.3557,278.0837,539870,539895,25
106,0,blank,0,224.5713,310.320875,540050,540215,165
106,31,;,213,250.9661,326.1094,540271,540296,25
106,0,blank,0,493.9122,675.1124,540451,540486,35
106,0,blank,0,459.8637,494.6508,540515,540542,27
106,0,blank,0,513.58875,592.9516,540570,540754,184
106,0,blank,0,531.2973,578.6725,540754,540854,100
106,0,blank,0,506.83355,599.437375,540854,541043,189
106,0,blank,0,484.238,550.3424,541224,541249,25
106,0,blank,0,501.42868,598.56648,541274,541472,198
106,0,blank,0,471.260725,593.706725,541472,541586,114
106,0,blank,0,470.023,520.8785,541768,541792,24
106,26,tolower,174,226.31065,222.098566666667,541905,542097,192
106,26,tolower,174,241.831966666667,210.686316666667,542097,542271,174
106,26,str,176,271.817366666667,211.683316666667,542271,542446,175
106,0,blank,0,312.1006,262.3842,542446,542476,30
106,0,blank,0,147.78494,224.1514,542533,542693,160
106,26,i,178,132.09495,205.01555,542693,542877,184
106,28,"in=%d",193,161.540666666667,265.1254,542877,542955,78
106,0,blank,0,-323,-105,543038,543232,194
106,0,blank,0,182.09788,297.47184,543364,543546,182
106,0,blank,0,191.46356,334.92108,543546,543691,145
106,0,blank,0,187.2817,346.7397,543691,543750,59
106,29,index,203,176.1411,275.939825,543801,543988,187
106,31,index,209,187.536825,328.199725,543988,544143,155
106,0,blank,0,150.29675,306.58585,544143,544277,134
106,29,index,203,176.3926,281.2382,544277,544452,175
106,0,blank,0,195.7662,312.8877,544452,544602,150
106,0,blank,0,157.3861,232.927466666667,544602,544801,199
106,28,"in=%d",193,168.14425,256.0933,544801,544977,176
106,0,blank,0,202.365933333333,224.7713,544977,545152,175
106,27,str,184,192.857825,232.17315,545152,545313,161
106,29,index,203,185.797366666667,273.1142,545313,545465,152
106,0,blank,0,523.978275,640.7444,545593,545697,104
106,0,blank,0,502.6882,793.1494,545930,545955,25
106,0,blank,0,499.219066666667,623.459533333333,545980,546087,107
106,0,blank,0,473.97758,751.32696,546137,546309,172
106,0,blank,0,503.748583333333,747.35045,546309,546480,171
106,0,blank,0,489.5374,-103.998,546624,546653,29
106,0,blank,0,475.27725,744.6492,546681,546739,58
106,0,blank,0,473.087233333333,770.905733333333,546796,546884,88
106,0,blank,0,466.147633333333,-103.9741,546912,546996,84
106,0,blank,0,503.473171428571,762.186442857143,547025,547223,198
106,0,blank,0,445.34625,757.46475,547223,547281,58
106,0,blank,0,468.43214,766.61424,547338,547483,145
106,0,blank,0,438.2314,776.661225,547483,547682,199
106,0,blank,0,505.902,-103.9647,547739,547764,25
106,0,blank,0,447.427266666667,745.62155,547845,548015,170
106,0,blank,0,482.5428,759.669714285714,548070,548266,196
106,0,blank,0,530.1379,-103.8573,548450,548475,25
106,0,blank,0,524.28205,777.63845,548499,548575,76
106,0,blank,0,496.256233333333,768.253666666667,548628,548712,84
106,0,blank,0,477.9788,748.4985,548825,549010,185
106,0,blank,0,446.71095,770.46435,549152,549210,58
106,0,blank,0,-323,-105,549352,549539,187
106,0,blank,0,-323,-105,549539,549715,176
106,0,blank,0,-323,-105,549715,549892,177
106,0,blank,0,-323,-105,549892,549933,41
106,41,index,267,96.05475,547.17685,550304,550487,183
106,0,blank,0,123.47155,603.866275,550487,550661,174
106,0,blank,0,115.3728,588.6055,550693,550764,71
106,42,list,279,165.3797,564.5986,550764,550941,177
106,0,blank,0,146.50375,581.722016666667,550941,551111,170
106,41,index,267,132.29175,549.888,551111,551262,151
106,41,str,269,168.14495,537.6276,551262,551426,164
106,42,list,279,155.36622,574.30884,551426,551608,182
106,44,str_rem,285,149.57155,614.52885,551608,551664,56
106,0,blank,0,-323,-105,551692,551820,128
106,39,(,259,92.6918,498.0834,551846,551883,37
106,41,index,267,95.5053,545.300771428571,551951,552138,187
106,41,index,267,112.8587,553.169514285714,552138,552335,197
106,42,!,278,126.204114285714,555.183428571429,552335,552533,198
106,42,if,276,96.8075,569.549,552533,552561,28
106,0,blank,0,-323,-105,552590,552768,178
106,0,blank,0,-323,-105,552768,552821,53
106,0,blank,0,160.9966,510.4062,552960,553151,191
106,42,index,281,185.5941,566.6022,553151,553256,105
106,41,index,267,90.9226,546.13858,553332,553527,195
106,0,blank,0,137.909425,587.234525,553527,553672,145
106,0,blank,0,138.582466666667,624.449533333333,553812,553921,109
106,0,blank,0,-323,-105,553960,554093,133
106,0,blank,0,134.0916,533.9901,554118,554143,25
106,41,index,267,134.180814285714,548.481657142857,554195,554378,183
106,0,blank,0,162.059485714286,548.140614285714,554378,554572,194
106,42,list,279,172.0364,568.752271428571,554572,554769,197
106,0,blank,0,183.232414285714,564.6833,554769,554968,199
106,42,[,280,178.575428571429,575.916528571429,554968,555165,197
106,0,blank,0,171.423442857143,584.931157142857,555165,555364,199
106,0,blank,0,162.7705,582.877071428571,555364,555562,198
106,0,blank,0,170.141371428571,580.344471428571,555562,555758,196
106,42,list,279,143.8928,561.043285714286,555758,555956,198
106,0,blank,0,141.284242857143,553.243957142857,555956,556153,197
106,0,blank,0,159.6044,550.69365,556153,556264,111
106,0,blank,0,-323,-105,556292,556471,179
106,41,str,269,171.050771428571,550.063328571429,556572,556763,191
106,42,list,279,173.574042857143,566.070057142857,556763,556960,197
106,42,list,279,172.461614285714,559.0114,556960,557156,196
106,42,list,279,149.971971428571,575.7129,557156,557352,196
106,42,index,281,189.614228571429,563.617085714286,557352,557549,197
106,42,index,281,206.1948,565.549,557549,557577,28
106,0,blank,0,-323,-105,557605,557769,164
106,42,list,279,165.416642857143,565.828471428571,557795,557978,183
106,42,list,279,164.3487,559.102842857143,557978,558177,199
106,0,blank,0,158.915471428571,547.4558,558177,558376,199
106,41,=,268,150.247485714286,534.398371428571,558376,558574,198
106,42,list,279,157.608066666667,572.9206,558574,558746,172
106,41,str,269,176.515928571429,553.893714285714,558746,558945,199
106,42,[,280,177.712671428571,559.580257142857,558945,559136,191
106,42,[,280,181.629828571429,570.7159,559136,559334,198
106,42,index,281,184.025485714286,562.521614285714,559334,559530,196
106,42,list,279,146.922857142857,571.223585714286,559530,559726,196
106,0,blank,0,-323,-105,559782,559961,179
106,0,blank,0,-323,-105,559961,560095,134
106,0,blank,0,-323,-105,560095,560213,118
106,0,blank,0,159.065283333333,536.633333333333,560240,560420,180
106,0,blank,0,202.166566666667,530.8577,560420,560591,171
106,42,index,281,196.269083333333,565.50745,560591,560763,172
106,42,index,281,187.945466666667,575.5816,560763,560936,173
106,42,[,280,177.6004,575.688916666667,560936,561107,171
106,0,blank,0,155.526,597.9799,561107,561136,29
106,0,blank,0,-323,-105,561163,561345,182
106,0,blank,0,-323,-105,561345,561535,190
106,0,blank,0,-323,-105,561535,561708,173
106,0,blank,0,-323,-105,561708,561782,74
106,0,blank,0,132.2197,564.8256,561818,561996,178
106,42,list,279,167.7824,572.281033333333,561996,562173,177
106,42,list,279,166.507766666667,565.4025,562173,562347,174
106,42,list,279,168.450266666667,564.87725,562347,562523,176
106,0,blank,0,175.027516666667,577.451,562523,562699,176
106,42,index,281,201.2287,559.898333333333,562699,562875,176
106,42,list,279,166.909683333333,558.263983333333,562875,563051,176
106,0,blank,0,156.171183333333,547.2121,563051,563225,174
106,0,blank,0,79.6484714285714,542.336371428571,563225,563424,199
106,41,index,267,109.00755,534.386233333333,563424,563595,171
106,42,list,279,151.076983333333,558.567766666667,563595,563769,174
106,0,blank,0,167.317071428571,532.357842857143,563769,563967,198
106,41,str,269,170.615128571429,550.088842857143,563967,564166,199
106,41,str,269,176.79776,536.93144,564166,564308,142
106,0,blank,0,-323,-105,564336,564491,155
106,0,blank,0,134.655014285714,-103.921785714286,564597,564781,184
106,0,blank,0,198.3636,-103.8904,564810,564869,59
106,0,blank,0,93.5305,793.2962,564952,564983,31
106,0,blank,0,91.64098,-103.94886,565119,565257,138
106,0,blank,0,93.0295,-103.957975,565316,565428,112
106,0,blank,0,125.54555,-103.9146,565455,565510,55
106,0,blank,0,117.5774,-103.9196,565593,565680,87
106,0,blank,0,64.632775,-103.95095,565797,565949,152
106,0,blank,0,61.5695666666667,-103.981766666667,566008,566125,117
106,47,str_rem,298,59.6371,683.57008,566153,566329,176
106,0,blank,0,52.0848142857143,705.3644,566329,566528,199
106,0,blank,0,94.68585,697.210416666667,566528,566695,167
106,47,str_rem,298,89.5733428571429,668.830314285714,566723,566919,196
106,0,blank,0,4.34710000000001,754.0633,566975,567029,54
106,0,blank,0,38.7254666666667,-103.944766666667,567057,567146,89
106,0,blank,0,84.5714,-103.9602,567203,567230,27
106,0,blank,0,102.237528571429,-103.936628571429,567288,567483,195
106,0,blank,0,163.1487,-103.9157,567483,567679,196
106,0,blank,0,118.7201,-103.864966666667,567679,567759,80
106,0,blank,0,151.835814285714,-103.859828571429,567787,567985,198
106,0,blank,0,113.5349,-103.902571428571,567985,568180,195
106,0,blank,0,164.847271428571,-103.865571428571,568180,568372,192
106,0,blank,0,167.01524,-103.86352,568372,568518,146
106,0,blank,0,169.376,-103.87442,568518,568693,175
106,0,blank,0,152.46048,-103.92448,568693,568867,174
106,0,blank,0,213.763,-103.8992,568867,568897,30
106,0,blank,0,133.035883333333,-103.9189,568925,569093,168
106,0,blank,0,183.1523,-103.91974,569093,569287,194
106,0,blank,0,197.4953,-103.884857142857,569287,569483,196
106,0,blank,0,204.215333333333,-103.893866666667,569483,569571,88
106,0,blank,0,216.7806,-103.871614285714,569631,569828,197
106,0,blank,0,198.981866666667,-103.8546,569828,570008,180
106,0,blank,0,191.609742857143,-103.862542857143,570008,570202,194
106,0,blank,0,131.777328571429,-103.906414285714,570202,570399,197
106,0,blank,0,147.44885,-103.884116666667,570399,570569,170
106,0,blank,0,145.030985714286,-103.880128571429,570569,570768,199
106,0,blank,0,136.8023,-103.651875,570768,570954,186
106,0,blank,0,136.052875,-103.603475,570954,571126,172
106,0,blank,0,94.9770666666667,-103.6182,571160,571251,91
106,0,blank,0,139.14058,-103.62842,571315,571507,192
106,0,blank,0,160.01185,-103.6312,571507,571646,139
106,0,blank,0,175.2052,-103.6067,571646,571741,95
106,0,blank,0,-323,-105,571850,571958,108
106,0,blank,0,165.3565,-103.9447,572121,572146,25
106,0,blank,0,152.8061,-103.963866666667,572196,572390,194
106,0,blank,0,209.610366666667,-103.959766666667,572468,572553,85
106,0,blank,0,226.27894,-103.95998,572583,572768,185
106,0,blank,0,228.87,-103.9482,572793,572847,54
106,0,blank,0,182.11595,787.68065,572905,573040,135
106,0,blank,0,171.8249,-103.9855,573065,573124,59
106,0,blank,0,152.6656,-103.9825,573183,573270,87
106,0,blank,0,-323,-105,573372,573566,194
106,0,blank,0,-323,-105,573566,573615,49
106,0,blank,0,371.9807,-103.7597,573720,573747,27
106,0,blank,0,173.9242,-103.868,573802,573829,27
106,0,blank,0,185.227366666667,-103.910733333333,573992,574167,175
106,0,blank,0,153.5236,-103.931557142857,574167,574365,198
106,0,blank,0,137.487571428571,-103.938085714286,574365,574560,195
106,0,blank,0,146.67256,-103.91232,574560,574705,145
106,0,blank,0,132.9196,-103.9206,574819,574847,28
106,0,blank,0,116.382925,-103.958975,574931,575096,165
106,0,blank,0,138.961333333333,-103.9141,575096,575290,194
106,0,blank,0,163.317033333333,-103.910333333333,575346,575461,115
106,0,blank,0,143.955,-103.9138,575461,575755,294
106,0,blank,0,156.1471,-103.894285714286,575755,575948,193
106,0,blank,0,119.717642857143,-103.943471428571,575948,576147,199
106,0,blank,0,117.6062,-103.9444,576147,576205,58
106,0,blank,0,183.544633333333,-103.8724,576290,576460,170
106,0,blank,0,172.1437,-103.89575,576547,576602,55
106,0,blank,0,115.111833333333,-103.9711,576657,576800,143
106,0,blank,0,85.6406,755.4308,576825,576853,28
106,0,blank,0,118.5706,-103.9457,576932,576957,25
106,0,blank,0,59.2621,773.2581,577008,577091,83
106,0,blank,0,89.6566,753.5272,577141,577165,24
106,0,blank,0,70.2104,-103.9225,577192,577222,30
106,0,blank,0,59.1472,757.3149,577250,577311,61
106,0,blank,0,85.118,791.5074,577368,577484,116
106,0,blank,0,-323,-105,579491,579676,185
106,0,blank,0,-323,-105,579676,579861,185
106,0,blank,0,-323,-105,579861,580027,166
106,0,blank,0,-323,-105,580027,580197,170
106,0,blank,0,-323,-105,580197,580369,172
106,0,blank,0,-323,-105,580369,580566,197
106,0,blank,0,-323,-105,580566,580757,191
106,0,blank,0,-323,-105,580757,580873,116
106,0,blank,0,-323,-105,580873,581047,174
106,0,blank,0,-323,-105,581047,581232,185
106,0,blank,0,-323,-105,581232,581414,182
106,0,blank,0,-323,-105,581414,581596,182
106,0,blank,0,-323,-105,581596,581684,88
107,0,blank,0,-323,-105,581924,581973,49
107,0,blank,0,-323,-105,581973,582330,357
107,0,blank,0,365.03235,451.83245,582548,582616,68
107,0,blank,0,443.1447,471.39932,582661,582827,166
