Frameno_fix,lineno_fix,Tokenname_fix,tokens_id,gaze_X_fix,gaze_Y_fix,timestamp_fix_start,timestamp_fix_end,time_duration
100,0,blank,0,121.0252,-100.002383333333,3694,3880,186
100,0,blank,0,121.9132,-105.0029,3880,3912,32
100,0,blank,0,-350,-105,3944,4025,81
100,0,blank,0,186.4189,-18.1584,4060,4116,56
100,0,blank,0,183.4752,-9.47534,4178,4326,148
100,0,blank,0,318.459666666667,-13.2004,4357,4547,190
100,0,blank,0,386.6891,-11.7662833333333,4547,4734,187
100,0,blank,0,405.663,-14.0103166666667,4734,4926,192
100,0,blank,0,402.3757,-7.19512,4926,5082,156
100,0,blank,0,181.42432,-11.32862,5113,5280,167
100,0,blank,0,120.95256,-34.06918,5280,5449,169
100,0,blank,0,123.9758,-28.5405,5449,5481,32
100,0,blank,0,-350,-105,5517,5713,196
100,0,blank,0,-350,-105,5713,5840,127
100,0,blank,0,102.58212,-49.80906,5866,6024,158
100,0,blank,0,198.8206,-9.48608,6059,6230,171
100,0,blank,0,168.22698,0.420320000000001,6230,6397,167
100,1,determine,5,174.254666666667,15.72885,6397,6593,196
100,1,determine,5,186.6546,17.37545,6593,6660,67
100,0,blank,0,-350,-105,6694,6856,162
100,0,blank,0,145.03255,44.1409666666667,6886,7079,193
100,0,blank,0,128.48035,66.6708333333333,7079,7277,198
100,0,blank,0,126.960516666667,69.1691333333333,7277,7474,197
100,3,stdbool,19,116.373166666667,61.2108833333333,7474,7673,199
100,4,date,24,111.905833333333,72.5274,7673,7867,194
100,0,blank,0,126.6356,95.13,7867,8063,196
100,0,blank,0,140.689766666667,103.8511,8063,8259,196
100,0,blank,0,139.89408,112.12642,8259,8426,167
100,6,;,28,139.90416,119.64436,8426,8595,169
100,6,;,28,137.23742,121.30504,8595,8764,169
100,6,;,28,140.49532,128.8864,8764,8944,180
100,6,;,28,136.7154,129.76044,8944,9117,173
100,0,blank,0,135.50618,134.613,9117,9289,172
100,0,blank,0,134.911633333333,133.45725,9289,9486,197
100,6,;,28,136.033716666667,127.463433333333,9486,9685,199
100,0,blank,0,142.33976,136.73334,9685,9852,167
100,0,blank,0,145.318266666667,141.11975,9852,10051,199
100,0,blank,0,139.29066,138.58982,10051,10218,167
100,0,blank,0,123.15416,183.21886,10218,10386,168
100,0,blank,0,94.4838,196.0561,10386,10557,171
100,0,blank,0,76.50088,196.01162,10557,10726,169
100,0,blank,0,-350,-105,10759,10952,193
100,0,blank,0,-350,-105,10952,11124,172
100,0,blank,0,87.5692833333333,192.751666666667,11154,11336,182
100,0,blank,0,100.105383333333,196.196266666667,11336,11532,196
100,0,blank,0,129.5561,194.24365,11532,11727,195
100,0,blank,0,188.007166666667,196.088133333333,11727,11916,189
100,0,blank,0,201.34335,189.4144,11916,12110,194
100,0,blank,0,195.7328,193.2261,12110,12142,32
100,0,blank,0,-350,-105,12173,12361,188
100,0,blank,0,-350,-105,12463,12497,34
100,0,blank,0,189.785933333333,194.08945,12523,12700,177
100,0,blank,0,187.200266666667,190.030016666667,12700,12894,194
100,0,blank,0,186.7302,193.959366666667,12894,13090,196
100,0,blank,0,206.696666666667,193.620283333333,13090,13286,196
100,0,blank,0,214.89225,192.337533333333,13286,13475,189
100,0,blank,0,266.861283333333,191.673866666667,13475,13662,187
100,0,blank,0,316.240516666667,194.9133,13662,13848,186
100,0,blank,0,376.3521,196.8903,13848,14038,190
100,0,blank,0,376.661183333333,197.0576,14038,14232,194
100,0,blank,0,382.69945,195.915983333333,14232,14423,191
100,0,blank,0,387.036633333333,199.9587,14423,14614,191
100,10,date,42,323.01945,201.225033333333,14614,14807,193
100,0,blank,0,329.0948,243.8662,14807,14839,32
100,0,blank,0,-350,-105,14871,15062,191
100,0,blank,0,-350,-105,15062,15233,171
100,0,blank,0,-350,-105,15233,15343,110
100,0,blank,0,350.73875,188.277766666667,15372,15567,195
100,0,blank,0,349.79995,194.664675,15567,15691,124
100,0,blank,0,133.9393,194.6645,15746,15927,181
100,12,struct,46,92.8187,256.69365,15927,16104,177
100,12,date,47,119.29385,248.28635,16104,16301,197
100,0,blank,0,158.96105,240.498383333333,16301,16496,195
100,0,blank,0,91.6008666666667,242.533166666667,16496,16693,197
100,0,blank,0,88.0234166666667,242.344583333333,16693,16887,194
100,12,struct,46,101.672,247.0083,16887,16919,32
100,0,blank,0,-350,-105,16951,17136,185
100,0,blank,0,-350,-105,17136,17316,180
100,0,blank,0,-350,-105,17316,17353,37
100,0,blank,0,170.163333333333,244.777466666667,17385,17567,182
100,12,date,47,129.165266666667,263.066383333333,17567,17763,196
100,13,numberOfDays,51,99.4635666666667,269.065566666667,17763,17958,195
100,13,numberOfDays,51,93.4576833333333,272.021316666667,17958,18155,197
100,12,date,47,147.844183333333,262.969983333333,18155,18347,192
100,0,blank,0,155.95505,260.58035,18347,18541,194
100,0,blank,0,156.713583333333,259.02835,18541,18736,195
100,12,date,47,128.66425,257.08525,18736,18932,196
100,12,date,47,113.441383333333,250.665333333333,18932,19131,199
100,0,blank,0,260.78624,251.58614,19165,19333,168
100,0,blank,0,257.24254,253.54122,19333,19502,169
100,0,blank,0,296.18605,258.0132,19502,19694,192
100,0,blank,0,259.28905,256.282533333333,19694,19890,196
100,12,tomorrow,48,244.3205,262.01086,19890,20055,165
100,0,blank,0,123.655683333333,288.8194,20090,20285,195
100,13,numberOfDays,51,105.1015,284.14158,20285,20447,162
100,0,blank,0,-350,-105,20480,20669,189
100,0,blank,0,-350,-105,20669,20857,188
100,0,blank,0,-350,-105,20857,20955,98
100,13,numberOfDays,51,173.037966666667,274.105283333333,20981,21163,182
100,13,numberOfDays,51,168.28065,282.892533333333,21163,21357,194
100,13,numberOfDays,51,157.187183333333,281.750433333333,21357,21548,191
100,13,numberOfDays,51,163.0839,282.861583333333,21548,21739,191
100,0,blank,0,210.9823,287.62695,21739,21930,191
100,14,!=,63,202.070083333333,289.6759,21930,22117,187
100,0,blank,0,206.536633333333,274.247766666667,22117,22306,189
100,13,(,52,221.159766666667,275.1819,22306,22497,191
100,13,(,52,219.96524,275.56406,22497,22661,164
100,13,date,54,330.39268,285.16706,22694,22863,169
100,14,numberOfDays,64,326.829833333333,290.6354,22863,22963,100
100,0,blank,0,-350,-105,23030,23198,168
100,0,blank,0,-350,-105,23198,23371,173
100,0,blank,0,407.15515,279.21255,23403,23586,183
100,0,blank,0,393.993516666667,275.241933333333,23586,23785,199
100,13,date,54,333.881183333333,272.9119,23785,23980,195
100,0,blank,0,330.262933333333,264.9579,23980,24079,99
100,13,(,52,216.591266666667,275.87585,24111,24304,193
100,0,blank,0,214.829375,278.286825,24304,24430,126
100,0,blank,0,-350,-105,24463,24653,190
100,0,blank,0,-350,-105,24653,24827,174
100,0,blank,0,-350,-105,24827,24878,51
100,13,numberOfDays,51,162.68425,270.0824,24909,25097,188
100,13,numberOfDays,51,163.0891,274.68015,25097,25293,196
100,0,blank,0,165.006383333333,337.077166666667,25293,25485,192
100,0,blank,0,324.484175,332.984825,25518,25649,131
100,16,month,79,461.214266666667,343.305066666667,25682,25877,195
100,16,month,79,450.2692,346.7322,25877,25910,33
100,0,blank,0,574.249066666667,349.413533333333,25943,26141,198
100,16,+,84,587.41244,344.72962,26141,26315,174
100,16,1,85,609.20214,343.95588,26315,26483,168
100,0,blank,0,624.10114,349.5007,26483,26652,169
100,16,today,87,653.01585,334.69955,26652,26797,145
100,0,blank,0,236.0827,355.71584,26868,27037,169
100,0,blank,0,209.30044,355.83542,27037,27207,170
100,0,blank,0,-350,-105,27243,27435,192
100,0,blank,0,-350,-105,27435,27618,183
100,0,blank,0,-350,-105,27618,27708,90
100,0,blank,0,136.13222,384.83166,27740,27910,170
100,0,blank,0,140.47266,386.05544,27910,28077,167
100,0,blank,0,137.733983333333,375.4412,28077,28272,195
100,0,blank,0,228.635483333333,372.015233333333,28272,28470,198
100,0,blank,0,225.871766666667,364.184433333333,28470,28567,97
100,0,blank,0,-350,-105,28600,28792,192
100,0,blank,0,194.784416666667,372.1681,28918,29100,182
100,0,blank,0,160.6661,375.794983333333,29100,29294,194
100,0,blank,0,160.973366666667,373.42375,29294,29488,194
100,18,today,96,162.854833333333,380.581133333333,29488,29687,199
100,18,today,96,162.10475,382.713566666667,29687,29883,196
100,18,month,98,205.537016666667,387.079433333333,29883,30079,196
100,18,month,98,250.529866666667,390.645,30079,30275,196
100,18,month,98,252.5613,394.0021,30275,30308,33
100,0,blank,0,-350,-105,30342,30533,191
100,0,blank,0,-350,-105,30533,30663,130
100,0,blank,0,248.035733333333,372.6508,30694,30879,185
100,18,.,97,198.68322,384.36132,30879,31048,169
100,0,blank,0,172.79812,401.77094,31048,31221,173
100,18,month,98,225.23294,388.59396,31221,31394,173
100,18,==,99,265.7695,391.8973,31394,31593,199
100,18,==,99,276.9837,397.24556,31593,31759,166
100,18,==,99,280.3853,392.47208,31759,31927,168
100,0,blank,0,292.42342,394.67198,31927,32096,169
100,20,{,109,337.83402,434.3445,32096,32267,171
100,0,blank,0,329.119933333333,425.524733333333,32267,32371,104
100,20,today,114,438.16442,424.12348,32405,32571,166
100,0,blank,0,-350,-105,32638,32836,198
100,0,blank,0,-350,-105,32836,32973,137
100,0,blank,0,-350,-105,32973,33090,117
100,0,blank,0,417.78928,407.45156,33797,33985,188
100,0,blank,0,421.9423,403.18966,33985,34164,179
100,0,blank,0,421.878925,417.1091,34164,34309,145
100,0,blank,0,-350,-105,34345,34537,192
100,0,blank,0,-350,-105,34537,34713,176
100,0,blank,0,-350,-105,34713,34899,186
100,0,blank,0,-350,-105,34899,35086,187
100,0,blank,0,-350,-105,35086,35228,142
100,0,blank,0,-350,-105,35228,35457,229
100,0,blank,0,-350,-105,35457,35644,187
100,23,{,123,47.4007,490.4365,36225,36338,113
100,21,},121,50.56034,453.39668,36565,36763,198
100,23,{,123,46.1145,491.0191,36763,36954,191
100,0,blank,0,37.8630166666667,485.359016666667,36954,37149,195
100,0,blank,0,37.0600333333333,495.8433,37149,37343,194
100,0,blank,0,30.9691666666666,478.802733333333,37343,37536,193
100,0,blank,0,49.1275333333333,486.373966666667,37536,37633,97
100,0,blank,0,347.3619,513.71215,37670,37861,191
100,24,today,139,414.345033333333,527.684,37861,38056,195
100,24,today,139,413.117766666667,515.015833333333,38056,38240,184
100,24,today,139,424.73025,510.1039,38240,38423,183
100,24,today,139,431.5801,521.31455,38423,38483,60
100,0,blank,0,-350,-105,38546,38733,187
100,0,blank,0,-350,-105,38733,38928,195
100,0,blank,0,-350,-105,38928,39033,105
100,0,blank,0,279.030533333333,485.878183333333,39069,39268,199
100,24,date,128,279.067125,514.18845,39268,39401,133
100,0,blank,0,477.243183333333,540.86055,39434,39632,198
100,0,blank,0,481.9159,537.484216666667,39632,39823,191
100,0,blank,0,485.58028,535.16562,39823,39978,155
100,0,blank,0,-350,-105,40040,40175,135
100,0,blank,0,468.5282,494.7059,40233,40297,64
100,0,blank,0,463.414766666667,504.020883333333,40366,40565,199
100,24,month,135,480.54272,524.03638,40565,40742,177
100,24,1,137,532.59572,526.47424,40742,40925,183
100,24,comma,138,539.700333333333,526.166766666667,40925,41026,101
100,26,tomorrow,146,190.68892,569.7567,41060,41229,169
100,0,blank,0,150.285333333333,580.597083333333,41229,41423,194
100,0,blank,0,204.37298,575.28728,41423,41598,175
100,0,blank,0,154.536116666667,573.670233333333,41598,41797,199
100,0,blank,0,138.084133333333,581.187716666667,41797,41986,189
100,0,blank,0,139.456066666667,573.83355,41986,42180,194
100,26,tomorrow,146,144.455633333333,566.008833333333,42180,42377,197
100,26,;,147,198.042983333333,560.818283333333,42377,42570,193
100,26,;,147,195.856616666667,563.1408,42570,42756,186
100,26,;,147,196.5697,571.406266666667,42756,42852,96
100,0,blank,0,-350,-105,42915,43065,150
100,0,blank,0,-350,-105,43065,43116,51
100,0,blank,0,956.337,275.1078,43175,43337,162
100,0,blank,0,967.6792,250.30986,43337,43527,190
100,0,blank,0,969.859666666667,268.1797,43527,43716,189
100,0,blank,0,975.393166666667,258.91725,43716,43904,188
100,0,blank,0,975.114333333333,273.413433333333,43904,44096,192
100,0,blank,0,967.937833333333,281.058133333333,44096,44287,191
100,0,blank,0,959.848,284.98565,44287,44351,64
100,0,blank,0,507.59084,404.34958,44414,44574,160
101,24,tomorrow,124,122.8668,79.2124333333334,46270,46467,197
101,24,tomorrow,124,105.6303,82.3379,46467,46532,65
101,28,numberOfDays,150,51.3233333333333,155.020683333333,46565,46760,195
101,0,blank,0,-350,-105,46793,46955,162
101,26,return,145,89.144,129.9152,47043,47140,97
101,27,},148,4.4593,148.9813,47213,47397,184
101,0,blank,0,-0.377719999999988,151.28058,47397,47557,160
101,0,blank,0,-350,-105,47621,47789,168
101,0,blank,0,-350,-105,47789,47947,158
101,0,blank,0,45.7947666666667,154.710616666667,47981,48154,173
101,0,blank,0,51.0745833333333,154.297266666667,48154,48340,186
101,0,blank,0,89.6589666666667,146.37575,48340,48528,188
101,0,blank,0,150.562766666667,144.868216666667,48528,48725,197
101,0,blank,0,204.22906,141.9601,48725,48888,163
101,0,blank,0,236.643933333333,139.350066666667,48888,48990,102
101,0,blank,0,-350,-105,49054,49242,188
101,0,blank,0,-350,-105,49242,49435,193
101,30,days,158,142.3942,210.000116666667,49466,49644,178
101,30,days,158,128.744716666667,217.65205,49644,49836,192
101,0,blank,0,116.706716666667,207.901966666667,49836,50033,197
101,0,blank,0,91.9274666666667,200.843933333333,50033,50225,192
101,30,int,157,56.9855,204.9567,50225,50421,196
101,30,int,157,55.4636333333333,210.771333333333,50421,50617,196
101,30,int,157,63.2241,217.37408,50617,50785,168
101,30,days,158,130.279016666667,216.336783333333,50785,50982,197
101,30,days,158,161.365283333333,213.6148,50982,51177,195
101,0,blank,0,239.71375,208.92335,51177,51372,195
101,0,blank,0,241.502916666667,216.502016666667,51372,51568,196
101,0,blank,0,230.9467,243.9393,51568,51600,32
101,0,blank,0,-350,-105,51632,51785,153
101,0,blank,0,284.230983333333,209.020716666667,51811,51992,181
101,0,blank,0,303.1694,204.8366,51992,52024,32
101,0,blank,0,113.62608,233.02526,52058,52225,167
101,32,const,168,61.7117,244.74475,52225,52423,198
101,0,blank,0,-350,-105,52490,52675,185
101,0,blank,0,-350,-105,52675,52808,133
101,31,isLeapYear,161,129.75475,228.406883333333,52839,53021,182
101,0,blank,0,137.092066666667,242.205716666667,53021,53213,192
101,0,blank,0,94.9362666666667,267.607883333333,53213,53410,197
101,0,blank,0,78.02935,286.843366666667,53410,53608,198
101,0,blank,0,75.7014833333333,286.963666666667,53608,53801,193
101,34,31,184,98.79875,294.41215,53801,53992,191
101,34,31,184,92.2117166666666,289.8157,53992,54186,194
101,0,blank,0,77.6186333333333,294.517333333333,54186,54283,97
101,0,blank,0,-350,-105,54316,54513,197
101,0,blank,0,-350,-105,54513,54597,84
101,0,blank,0,107.1659,271.232633333333,54632,54814,182
101,0,blank,0,104.65272,286.10024,54814,54981,167
101,34,comma,187,109.1354,289.916833333333,54981,55177,196
101,0,blank,0,136.587116666667,281.4416,55177,55368,191
101,0,blank,0,133.868433333333,283.317816666667,55368,55559,191
101,0,blank,0,133.471433333333,281.499433333333,55559,55753,194
101,0,blank,0,157.48245,275.902283333333,55753,55946,193
101,0,blank,0,179.99708,275.95596,55946,56113,167
101,0,blank,0,221.36305,280.639483333333,56113,56305,192
101,0,blank,0,233.03585,290.044516666667,56305,56495,190
101,0,blank,0,235.426566666667,303.9842,56495,56595,100
101,0,blank,0,59.4355,310.3383,56651,56775,124
101,0,blank,0,13.1642,340.0537,56775,56895,120
101,0,blank,0,-350,-105,57017,57152,135
101,0,blank,0,174.10275,334.4735,57177,57356,179
101,0,blank,0,189.300366666667,347.89365,57356,57547,191
101,0,blank,0,207.6285,339.52684,57547,57711,164
101,0,blank,0,295.930716666667,333.1864,57711,57902,191
101,0,blank,0,326.397133333333,341.92095,57902,58088,186
101,0,blank,0,348.27625,339.46815,58088,58151,63
101,0,blank,0,926.335,793.9329,58278,58308,30
101,0,blank,0,985.2712,-103.97626,58402,58555,153
101,0,blank,0,1038.977,782.2264,58586,58617,31
101,0,blank,0,988.621,-103.9702,58648,58709,61
101,0,blank,0,-350,-105,58771,58881,110
101,37,isLeapYear,203,114.03868,355.0856,59060,59232,172
101,0,blank,0,154.164866666667,350.083066666667,59232,59425,193
101,0,blank,0,248.183433333333,351.534,59425,59618,193
101,37,true,208,273.583033333333,356.4954,59618,59714,96
101,0,blank,0,-350,-105,59745,59930,185
101,0,blank,0,-350,-105,59930,60121,191
101,0,blank,0,-350,-105,60121,60174,53
101,37,isLeapYear,203,99.9462,356.88415,60207,60397,190
101,0,blank,0,91.2162666666667,360.01045,60397,60596,199
101,0,blank,0,93.98394,357.71646,60596,60763,167
101,0,blank,0,89.9418,354.102616666667,60763,60959,196
101,37,isLeapYear,203,96.46935,355.965283333333,60959,61154,195
101,35,31,198,102.9561,317.0019,61154,61186,32
101,0,blank,0,-350,-105,61218,61357,139
101,0,blank,0,237.9734,343.648116666667,61495,61679,184
101,0,blank,0,241.3088,349.96595,61679,61871,192
101,0,blank,0,236.442616666667,350.761583333333,61871,62063,192
101,0,blank,0,217.779516666667,345.739133333333,62063,62255,192
101,37,d,210,220.5334,356.73368,62255,62414,159
101,0,blank,0,-350,-105,62447,62608,161
101,0,blank,0,266.689633333333,346.854566666667,62709,62889,180
101,37,isLeapYear,203,193.01435,367.200683333333,62889,63085,196
101,37,isLeapYear,203,161.2741,365.12865,63085,63149,64
101,0,blank,0,316.381316666667,360.811816666667,63180,63369,189
101,0,blank,0,344.630383333333,356.959466666667,63369,63556,187
101,0,blank,0,349.867816666667,365.3612,63556,63745,189
101,0,blank,0,348.09855,362.482816666667,63745,63933,188
101,37,.,211,366.330316666667,372.279716666667,63933,64122,189
101,37,d,210,360.293166666667,364.3607,64122,64312,190
101,0,blank,0,349.647275,363.65495,64312,64439,127
101,38,days,216,95.07775,392.108766666667,64470,64660,190
101,0,blank,0,-350,-105,64691,64878,187
101,0,blank,0,-350,-105,64878,65006,128
101,0,blank,0,337.9454,336.4682,65037,65055,18
101,37,isLeapYear,203,192.0592,370.75445,65092,65283,191
101,37,isLeapYear,203,129.84975,360.581416666667,65283,65474,191
101,37,isLeapYear,203,112.408183333333,370.113683333333,65474,65671,197
101,38,days,216,105.497633333333,378.590033333333,65671,65868,197
101,37,isLeapYear,203,188.974066666667,366.751233333333,65868,66058,190
101,0,blank,0,237.64295,363.771483333333,66058,66250,192
101,0,blank,0,242.407,361.0283,66250,66283,33
101,0,blank,0,-350,-105,66349,66506,157
101,0,blank,0,-350,-105,66506,66557,51
101,37,==,213,257.580066666667,354.563516666667,66590,66767,177
101,37,isLeapYear,203,159.1479,355.801883333333,66767,66958,191
101,37,isLeapYear,203,115.511783333333,369.547733333333,66958,67150,192
101,37,isLeapYear,203,105.453983333333,358.77725,67150,67343,193
101,37,isLeapYear,203,105.06716,352.94152,67343,67509,166
101,37,==,213,260.07145,363.6207,67542,67738,196
101,37,||,209,334.21835,359.51475,67738,67937,199
101,37,true,208,310.639766666667,366.17015,67937,68129,192
101,37,true,208,306.400933333333,366.431466666667,68129,68224,95
101,0,blank,0,-350,-105,68256,68417,161
101,0,blank,0,319.0505,316.2617,68471,68536,65
101,0,blank,0,-350,-105,68576,68758,182
101,0,blank,0,-350,-105,68758,68809,51
101,37,true,208,293.6589,355.058583333333,68842,69019,177
101,37,true,208,299.3389,359.0346,69019,69209,190
101,37,true,208,298.065033333333,354.635783333333,69209,69400,191
101,37,true,208,289.754583333333,359.39995,69400,69590,190
101,0,blank,0,279.656,401.5659,69590,69655,65
101,0,blank,0,175.0158,681.8591,69687,69885,198
101,0,blank,0,206.705766666667,624.586983333333,69885,70076,191
101,47,true,277,246.26095,583.551783333333,70076,70265,189
101,47,true,277,242.4999,582.3453,70265,70455,190
101,46,==,272,222.7472,569.14405,70455,70581,126
101,46,year,269,341.831333333333,569.23885,70622,70812,190
101,0,blank,0,388.925416666667,585.72825,70812,71001,189
101,0,blank,0,423.8927,589.5497,71001,71063,62
101,0,blank,0,-350,-105,71126,71305,179
101,0,blank,0,355.6984,338.6168,71337,71515,178
101,37,d,210,362.1624,357.4402,71515,71580,65
101,46,%,270,374.68376,563.3876,71613,71782,169
101,0,blank,0,313.179783333333,584.90325,71782,71973,191
101,47,;,278,275.6643,592.6746,71973,72162,189
101,47,true,277,260.120866666667,585.424366666667,72162,72353,191
101,0,blank,0,231.943583333333,581.672233333333,72353,72542,189
101,47,leapYearFlag,275,140.7371,588.104683333333,72542,72731,189
101,47,leapYearFlag,275,176.297466666667,582.782916666667,72731,72918,187
101,47,true,277,236.156883333333,583.268983333333,72918,73107,189
101,0,blank,0,231.85385,583.9004,73107,73170,63
101,47,leapYearFlag,275,106.2663,590.965,73202,73395,193
101,47,leapYearFlag,275,108.39145,591.65275,73395,73457,62
101,0,blank,0,-350,-105,73488,73675,187
101,0,blank,0,-350,-105,73675,73872,197
101,0,blank,0,-350,-105,73872,73933,61
101,0,blank,0,310.65506,546.0873,73980,74148,168
101,0,blank,0,271.1397,511.3129,74148,74306,158
101,0,blank,0,-350,-105,74338,74527,189
101,0,blank,0,-350,-105,74527,74691,164
101,37,true,208,303.888533333333,365.91765,74724,74902,178
101,37,true,208,303.1574,353.952166666667,74902,75090,188
101,0,blank,0,296.9784,346.771466666667,75090,75186,96
101,0,blank,0,81.7809833333333,377.826166666667,75218,75406,188
101,0,blank,0,70.9948166666667,392.097966666667,75406,75594,188
101,0,blank,0,54.87414,424.61038,75594,75752,158
101,0,blank,0,-350,-105,75815,76000,185
101,0,blank,0,-350,-105,76000,76187,187
101,0,blank,0,-350,-105,76187,76310,123
101,0,blank,0,227.4576,576.286616666667,76341,76540,199
101,46,==,272,228.13505,563.253666666667,76540,76727,187
101,46,%,270,172.880783333333,571.520816666667,76727,76914,187
101,46,year,269,159.132433333333,569.401366666667,76914,77031,117
101,47,leapYearFlag,275,148.75845,588.383,77031,77204,173
101,0,blank,0,173.34245,600.1302,77204,77391,187
101,47,leapYearFlag,275,165.34005,588.405016666667,77391,77585,194
101,0,blank,0,171.395566666667,594.781283333333,77585,77780,195
101,0,blank,0,172.218116666667,601.02075,77780,77976,196
101,47,leapYearFlag,275,168.870275,591.92605,77976,78103,127
101,0,blank,0,-350,-105,78142,78307,165
101,0,blank,0,-350,-105,78307,78477,170
101,47,leapYearFlag,275,168.95626,589.23848,78512,78663,151
101,0,blank,0,-350,-105,78729,78912,183
101,0,blank,0,-350,-105,78912,79095,183
101,45,leapYearFlag,245,161.6042,545.228233333333,79128,79213,85
101,0,blank,0,160.247016666667,606.157033333333,79245,79436,191
101,0,blank,0,158.461266666667,598.079,79436,79628,192
101,47,leapYearFlag,275,151.73435,579.143783333333,79628,79825,197
101,47,leapYearFlag,275,159.388133333333,576.412266666667,79825,80016,191
101,0,blank,0,160.490483333333,596.606466666667,80016,80210,194
101,47,leapYearFlag,275,154.3719,590.246366666667,80210,80402,192
101,47,leapYearFlag,275,161.49515,579.60325,80402,80597,195
101,47,leapYearFlag,275,163.660866666667,578.925133333333,80597,80792,195
101,46,year,269,147.754233333333,565.09555,80792,80985,193
101,0,blank,0,154.4465,596.510883333333,80985,81179,194
101,0,blank,0,160.34285,596.393383333333,81179,81373,194
101,0,blank,0,161.3508,603.7615,81373,81405,32
101,0,blank,0,-350,-105,81437,81625,188
101,0,blank,0,-350,-105,81625,81754,129
101,0,blank,0,-350,-105,81754,81906,152
101,0,blank,0,261.7729,390.6462,81937,81956,19
101,0,blank,0,257.716733333333,570.90925,81991,82179,188
101,47,true,277,253.747483333333,577.90545,82179,82374,195
101,0,blank,0,255.427916666667,570.86045,82374,82565,191
101,0,blank,0,256.295133333333,571.7136,82565,82757,192
101,47,true,277,259.81705,578.749783333333,82757,82947,190
101,47,true,277,260.44075,583.897433333333,82947,83135,188
101,47,true,277,264.53534,581.39538,83135,83296,161
101,0,blank,0,-350,-105,83329,83494,165
101,40,.,226,296.765,437.6989,83619,83637,18
101,47,true,277,250.0319,586.9889,83675,83849,174
101,47,true,277,252.29764,589.49082,83849,84015,166
101,0,blank,0,251.870133333333,599.641616666667,84015,84214,199
101,0,blank,0,252.247583333333,601.5771,84214,84408,194
101,0,blank,0,250.3477,601.449166666667,84408,84605,197
101,0,blank,0,251.047666666667,594.358566666667,84605,84801,196
101,47,true,277,255.706033333333,588.271633333333,84801,84998,197
101,47,true,277,251.128916666667,592.9543,84998,85197,199
101,47,true,277,249.4112,574.4002,85197,85263,66
101,0,blank,0,-350,-105,85297,85485,188
101,0,blank,0,-350,-105,85485,85655,170
101,0,blank,0,-350,-105,85655,85708,53
101,0,blank,0,265.5613,534.343525,85739,85869,130
101,46,!=,263,435.53165,562.953133333333,85903,86100,197
101,0,blank,0,438.907233333333,575.950466666667,86100,86292,192
101,0,blank,0,444.8707,565.6082,86292,86326,34
101,0,blank,0,633.3366,597.1812,86357,86553,196
101,0,blank,0,665.914666666667,585.079983333333,86553,86751,198
101,0,blank,0,651.656,595.1611,86751,86786,35
101,0,blank,0,501.87546,560.6415,86817,86983,166
101,0,blank,0,-350,-105,87014,87201,187
101,0,blank,0,-350,-105,87201,87327,126
101,0,blank,0,576.615183333333,582.790416666667,87418,87617,199
101,0,blank,0,577.34114,576.9802,87617,87785,168
101,0,blank,0,-350,-105,87819,87961,142
101,0,blank,0,597.1054,527.7944,88011,88064,53
101,0,blank,0,565.057933333333,572.453533333333,88159,88350,191
101,0,blank,0,543.517733333333,584.025083333333,88350,88548,198
101,0,blank,0,551.35306,573.22866,88548,88716,168
101,0,blank,0,575.1737,560.3969,88716,88750,34
101,46,!=,263,439.60048,561.89966,88784,88951,167
101,0,blank,0,432.55515,574.38095,88951,89018,67
101,0,blank,0,258.19028,529.00992,89053,89222,169
101,0,blank,0,248.31705,510.02475,89222,89355,133
101,0,blank,0,-350,-105,89389,89528,139
101,0,blank,0,142.688083333333,479.898666666667,89630,89814,184
101,43,isLeapYear,237,139.4413,489.7717,89814,89847,33
101,0,blank,0,195.896966666667,610.381583333333,89881,90080,199
101,50,leapYearFlag,285,190.25076,649.37292,90080,90250,170
101,50,leapYearFlag,285,184.38848,649.3412,90250,90419,169
101,0,blank,0,284.25022,649.46122,90419,90592,173
101,0,blank,0,261.0271,659.09956,90592,90760,168
101,0,blank,0,221.44858,674.67034,90760,90925,165
101,0,blank,0,-350,-105,90959,91150,191
101,0,blank,0,-350,-105,91150,91329,179
101,52,void,291,130.21386,701.96156,91360,91518,158
101,0,blank,0,233.9566,509.1733,91553,91727,174
101,0,blank,0,187.0726,466.17254,91727,91898,171
101,40,daysPerMonth,223,228.052016666667,437.909966666667,91898,92097,199
101,40,d,225,288.27356,432.5809,92097,92265,168
101,0,blank,0,264.67334,419.65212,92265,92439,174
101,0,blank,0,266.8582,398.5103,92439,92503,64
101,0,blank,0,-350,-105,92536,92700,164
101,0,blank,0,-350,-105,92700,92746,46
101,40,-,228,371.786283333333,428.5671,92879,93070,191
101,40,-,228,365.261316666667,420.3899,93070,93265,195
101,0,blank,0,354.37625,427.7258,93265,93396,131
101,40,daysPerMonth,223,221.455833333333,424.7624,93429,93624,195
101,40,daysPerMonth,223,173.6819,429.23155,93624,93818,194
101,40,month,227,352.616666666667,422.145216666667,93851,94044,193
101,0,blank,0,-350,-105,94077,94264,187
101,0,blank,0,-350,-105,94264,94381,117
101,0,blank,0,-350,-105,94381,94545,164
101,0,blank,0,-350,-105,94545,94689,144
101,40,[,224,281.894833333333,431.483633333333,94716,94905,189
101,40,daysPerMonth,223,267.64018,429.60526,94905,95068,163
101,0,blank,0,150.17184,309.42564,95107,95278,171
101,34,28,178,137.9883,303.00386,95278,95457,179
101,34,28,178,127.34285,302.2921,95457,95533,76
101,40,[,224,278.766266666667,430.54055,95566,95765,199
101,0,blank,0,-350,-105,96135,96326,191
101,0,blank,0,-350,-105,96326,96498,172
101,0,blank,0,-350,-105,96498,96669,171
101,0,blank,0,-350,-105,96669,96845,176
101,0,blank,0,-350,-105,96845,96921,76
101,0,blank,0,307.960483333333,419.021016666667,97015,97201,186
101,40,[,224,282.06476,431.09164,97201,97363,162
101,40,month,227,305.83085,439.309,97363,97459,96
101,0,blank,0,-350,-105,97578,97742,164
101,40,daysPerMonth,223,210.610516666667,436.625616666667,97938,98128,190
101,40,days,221,122.315033333333,437.143166666667,98128,98323,195
101,41,days,233,151.29145,449.5894,98323,98516,193
101,0,blank,0,169.444233333333,448.483133333333,98516,98715,199
101,0,blank,0,186.18402,446.77772,98715,98884,169
101,0,blank,0,178.869833333333,441.375633333333,98884,99082,198
101,0,blank,0,157.734433333333,440.953266666667,99082,99279,197
101,40,daysPerMonth,223,167.995266666667,439.726933333333,99279,99475,196
101,40,daysPerMonth,223,199.787225,435.8858,99475,99604,129
101,0,blank,0,106.10674,310.3212,99637,99805,168
101,0,blank,0,78.45762,299.38932,99805,99972,167
101,0,blank,0,74.7242666666667,300.858,99972,100168,196
101,0,blank,0,76.5017,310.8779,100168,100206,38
101,0,blank,0,-350,-105,100244,100430,186
101,40,d,225,288.849983333333,428.316266666667,100576,100758,182
101,40,d,225,287.3307,438.469966666667,100758,100951,193
101,40,.,226,299.95575,431.30995,100951,101143,192
101,0,blank,0,327.276466666667,444.247,101143,101337,194
101,40,month,227,326.3498,428.0325,101337,101370,33
101,0,blank,0,-350,-105,101402,101540,138
101,0,blank,0,-350,-105,101540,101725,185
101,0,blank,0,955.332833333333,427.307033333333,101761,101951,190
101,0,blank,0,978.6874,436.90634,101951,102119,168
101,0,blank,0,970.5696,418.29656,102119,102288,169
101,0,blank,0,961.033,431.25656,102288,102456,168
101,0,blank,0,961.306,442.4802,102456,102489,33
101,0,blank,0,299.67292,628.75042,102556,102726,170
101,52,void,291,120.9828,703.1033,102760,102958,198
102,0,blank,0,350.3266,704.04755,104605,104669,64
102,0,blank,0,519.177466666667,686.522666666667,104701,104895,194
102,0,blank,0,566.4775,685.993433333333,104895,104995,100
102,0,blank,0,-350,-105,105061,105253,192
102,0,blank,0,-350,-105,105253,105422,169
102,0,blank,0,-350,-105,105422,105614,192
102,57,month,321,340.59528,615.10746,105886,106061,175
102,57,month,321,342.4219,599.23555,106061,106124,63
102,54,dateUpdate,296,195.52565,552.538966666667,106155,106350,195
102,55,struct,303,89.15048,557.57154,106350,106518,168
102,55,struct,303,82.35454,568.38868,106518,106686,168
102,0,blank,0,157.05418,561.43412,106686,106853,167
102,0,blank,0,161.332783333333,559.914,106853,107046,193
102,55,thisDay,305,179.053666666667,567.6491,107046,107241,195
102,55,thisDay,305,175.64634,568.57622,107241,107405,164
102,0,blank,0,-350,-105,107440,107632,192
102,0,blank,0,-350,-105,107632,107798,166
102,0,blank,0,-350,-105,107798,107973,175
102,50,leapYearFlag,285,138.1147,449.2158,108005,108022,17
102,55,date,304,126.285625,571.1194,108064,108191,127
102,0,blank,0,-350,-105,108256,108396,140
102,0,blank,0,-350,-105,108396,108459,63
102,55,nextDay,307,264.110283333333,561.181516666667,108611,108801,190
102,0,blank,0,401.41196,568.88372,108801,108970,169
102,54,date,299,389.69348,551.92092,108970,109140,170
102,0,blank,0,388.592616666667,557.898183333333,109140,109334,194
102,0,blank,0,440.716525,555.638125,109334,109461,127
102,56,"Entertoday'sdate(mmddyyyy):",311,203.527916666667,586.757716666667,109526,109718,192
102,56,"Entertoday'sdate(mmddyyyy):",311,205.95012,590.62804,109718,109882,164
102,0,blank,0,161.57222,572.573,109882,110072,190
102,0,blank,0,141.767325,526.3928,110072,110256,184
102,52,),292,148.53844,502.40202,110291,110461,170
102,50,leapYearFlag,285,175.54634,453.38314,110461,110629,168
102,50,leapYearFlag,285,205.95202,447.0148,110629,110799,170
102,0,blank,0,222.66472,403.84876,110799,110965,166
102,45,leapYearFlag,245,181.1587,337.21375,110965,111161,196
102,0,blank,0,182.0715,334.95994,111161,111327,166
102,0,blank,0,160.91196,326.41954,111327,111495,168
102,43,isLeapYear,237,133.6653,305.581275,111495,111628,133
102,0,blank,0,273.44188,348.55414,111662,111826,164
102,0,blank,0,-350,-105,111859,112049,190
102,0,blank,0,422.9007,352.29485,112195,112248,53
102,46,400,271,603.73332,370.84562,112280,112447,167
102,0,blank,0,642.01605,379.08575,112447,112646,199
102,46,==,272,655.0738,373.901466666667,112646,112746,100
102,46,d,267,295.05895,368.7327,112779,112973,194
102,0,blank,0,211.24722,377.60794,112973,113141,168
102,47,leapYearFlag,275,183.5066,383.401533333333,113141,113338,197
102,0,blank,0,-350,-105,113402,113587,185
102,0,blank,0,-350,-105,113587,113781,194
102,0,blank,0,-350,-105,113781,113851,70
102,47,leapYearFlag,275,123.224333333333,388.08535,113889,114083,194
102,47,leapYearFlag,275,123.03435,386.192683333333,114083,114277,194
102,46,year,269,160.7448,375.40458,114277,114444,167
102,0,blank,0,187.580183333333,373.88055,114444,114643,199
102,0,blank,0,116.239616666667,405.64615,114643,114840,197
102,49,leapYearFlag,280,84.7641,424.09514,114840,115009,169
102,0,blank,0,82.7314,433.47342,115009,115177,168
102,50,return,284,99.47686,446.0905,115177,115348,171
102,0,blank,0,124.7299,444.5532,115348,115418,70
102,0,blank,0,-350,-105,115490,115633,143
102,0,blank,0,204.918533333333,444.019883333333,115756,115940,184
102,0,blank,0,107.47278,458.0496,115940,116108,168
102,0,blank,0,105.16046,448.57646,116108,116276,168
102,50,return,284,81.2956,456.00474,116276,116446,170
102,50,return,284,61.32966,462.34684,116446,116617,171
102,54,struct,298,59.98698,537.82622,116617,116786,169
102,54,struct,298,54.8563333333333,547.8083,116786,116890,104
102,0,blank,0,-350,-105,116924,117091,167
102,0,blank,0,166.2048,497.305,117116,117171,55
102,0,blank,0,-350,-105,117250,117436,186
102,0,blank,0,-350,-105,117436,117537,101
102,57,(,315,120.000166666667,609.293466666667,117572,117760,188
102,0,blank,0,107.2926,606.93495,117760,117854,94
102,57,"%i%i%i",316,184.686,618.3037,117854,117980,126
102,56,"Entertoday'sdate(mmddyyyy):",311,186.3874,595.8871,117980,118070,90
102,57,thisDay,329,236.7666,619.4144,118070,118266,196
102,0,blank,0,222.1418,616.66956,118266,118433,167
102,58,dateUpdate,336,219.7212,627.158833333333,118433,118629,196
102,57,.,330,305.14558,618.84374,118629,118796,167
102,0,blank,0,355.2901,631.792883333333,118796,118995,199
102,57,&,328,386.363116666667,607.770316666667,118995,119192,197
102,56,"Entertoday'sdate(mmddyyyy):",311,392.1101,585.740633333333,119192,119290,98
102,0,blank,0,-350,-105,119323,119512,189
102,0,blank,0,-350,-105,119512,119698,186
102,57,&,328,526.51948,615.92158,119731,119914,183
102,59,nextDay,353,518.0126,653.5816,119914,119947,33
102,59,"Tomorrow'sdateis%i/%i/%.2i.\n",343,169.860383333333,659.11875,120015,120214,199
102,59,"Tomorrow'sdateis%i/%i/%.2i.\n",343,144.55914,663.89492,120214,120382,168
102,60,return,360,102.1763,668.609766666667,120382,120578,196
102,60,return,360,59.0544333333333,670.177016666667,120578,120775,197
102,0,blank,0,40.1244833333333,671.84495,120775,120972,197
102,0,blank,0,30.913,669.6268,120972,121005,33
102,0,blank,0,-350,-105,121038,121222,184
102,0,blank,0,-350,-105,121303,121470,167
102,0,blank,0,-350,-105,121470,121602,132
102,58,dateUpdate,336,241.772833333333,639.934766666667,121643,121838,195
102,58,),339,339.849316666667,639.23065,121838,122030,192
102,0,blank,0,343.331766666667,639.958166666667,122030,122221,191
102,58,;,340,345.127533333333,638.7523,122221,122318,97
102,0,blank,0,-350,-105,122351,122538,187
102,0,blank,0,-350,-105,122538,122710,172
102,0,blank,0,-350,-105,122710,122770,60
102,59,"Tomorrow'sdateis%i/%i/%.2i.\n",343,231.825616666667,645.859316666667,122803,122985,182
102,58,dateUpdate,336,235.0458,637.682683333333,122985,123178,193
102,59,"Tomorrow'sdateis%i/%i/%.2i.\n",343,241.860983333333,646.463433333333,123178,123370,192
102,58,thisDay,338,270.604216666667,638.479816666667,123370,123562,192
102,58,thisDay,338,306.009133333333,641.448733333333,123562,123755,193
102,59,"Tomorrow'sdateis%i/%i/%.2i.\n",343,347.339466666667,647.42925,123755,123949,194
102,58,),339,335.583166666667,636.1197,123949,124144,195
102,59,"Tomorrow'sdateis%i/%i/%.2i.\n",343,305.53105,644.882466666667,124144,124339,195
102,59,"Tomorrow'sdateis%i/%i/%.2i.\n",343,226.49295,653.419266666667,124339,124533,194
102,56,"Entertoday'sdate(mmddyyyy):",311,218.8606,592.10665,124533,124598,65
102,0,blank,0,-350,-105,124631,124816,185
102,0,blank,0,-350,-105,124816,124994,178
102,0,blank,0,-350,-105,124994,125105,111
102,57,comma,327,204.394433333333,616.2525,125456,125615,159
102,0,blank,0,156.6599,575.4,125615,125658,43
102,0,blank,0,297.018733333333,674.6078,125749,125941,192
102,59,"Tomorrow'sdateis%i/%i/%.2i.\n",343,278.1757,651.0115,125941,126033,92
102,0,blank,0,-350,-105,126080,126254,174
102,0,blank,0,-350,-105,126254,126436,182
102,0,blank,0,-350,-105,126436,126620,184
102,0,blank,0,-350,-105,126620,126691,71
102,0,blank,0,-350,-105,126846,127010,164
102,0,blank,0,-350,-105,127010,127189,179
102,0,blank,0,-350,-105,127189,127378,189
102,0,blank,0,-350,-105,127378,127569,191
102,0,blank,0,-350,-105,127569,127751,182
102,0,blank,0,-350,-105,127751,127867,116
102,0,blank,0,-350,-105,127867,127965,98
102,0,blank,0,-350,-105,127965,128151,186
102,0,blank,0,-350,-105,128151,128278,127
102,0,blank,0,-350,-105,128278,128432,154
102,0,blank,0,-350,-105,128432,128619,187
102,0,blank,0,-350,-105,128619,128771,152
102,0,blank,0,-350,-105,128771,128832,61
102,0,blank,0,-350,-105,128832,128976,144
102,0,blank,0,-350,-105,128976,129107,131
102,0,blank,0,-350,-105,129107,129247,140
102,0,blank,0,-350,-105,129247,129413,166
102,0,blank,0,-350,-105,129413,129449,36
102,0,blank,0,708.805,704.0002,129470,129606,136
102,0,blank,0,741.525,695.9175,129606,129672,66
102,0,blank,0,-350,-105,129771,129948,177
102,0,blank,0,-350,-105,129948,130129,181
102,0,blank,0,-350,-105,130129,130288,159
102,0,blank,0,-350,-105,130288,130374,86
102,58,dateUpdate,336,185.328575,640.941275,130575,130764,189
102,0,blank,0,171.6252,671.605866666667,130764,130902,138
102,0,blank,0,188.5789,672.4744,130902,131045,143
102,0,blank,0,376.209533333333,669.232366666667,131092,131192,100
102,0,blank,0,-350,-105,131224,131412,188
102,0,blank,0,-350,-105,131412,131601,189
102,0,blank,0,-350,-105,131601,131735,134
102,59,"Tomorrow'sdateis%i/%i/%.2i.\n",343,150.839466666667,646.753483333333,131826,132017,191
102,58,dateUpdate,336,145.477866666667,640.154216666667,132017,132213,196
102,59,"Tomorrow'sdateis%i/%i/%.2i.\n",343,241.771766666667,647.624833333333,132245,132442,197
102,58,thisDay,338,292.7181,634.386516666667,132442,132636,194
102,0,blank,0,222.108833333333,642.839283333333,132636,132828,192
102,58,dateUpdate,336,205.347,640.619625,132828,132959,131
102,0,blank,0,-350,-105,132992,133190,198
102,0,blank,0,-350,-105,133190,133350,160
102,0,blank,0,-350,-105,133350,133523,173
102,58,(,337,262.04572,635.90458,133565,133757,192
102,58,thisDay,338,274.18086,635.18616,133757,133923,166
102,59,"Tomorrow'sdateis%i/%i/%.2i.\n",343,303.274216666667,646.617083333333,133923,134120,197
102,59,"Tomorrow'sdateis%i/%i/%.2i.\n",343,397.710766666667,647.986483333333,134120,134315,195
102,0,blank,0,395.412275,641.515425,134315,134444,129
102,0,blank,0,-350,-105,134476,134664,188
102,0,blank,0,-350,-105,134664,134846,182
102,0,blank,0,-350,-105,134846,134892,46
102,57,day,326,496.19716,611.2154,134928,135112,184
102,0,blank,0,529.53595,624.395183333333,135112,135311,199
102,59,nextDay,353,505.696233333333,654.692466666667,135311,135410,99
102,58,thisDay,338,272.7365,641.10885,135442,135640,198
102,59,"Tomorrow'sdateis%i/%i/%.2i.\n",343,293.384516666667,654.619983333333,135640,135837,197
102,0,blank,0,140.077,641.7597,135870,136065,195
102,58,=,335,124.7403,637.858633333333,136065,136261,196
102,57,thisDay,329,275.561,613.669116666667,136261,136458,197
102,57,.,330,306.37145,615.2785,136458,136650,192
102,0,blank,0,212.99635,618.175833333333,136650,136839,189
102,58,dateUpdate,336,180.473383333333,623.99145,136839,137032,193
102,0,blank,0,-350,-105,137064,137225,161
102,0,blank,0,-350,-105,137225,137408,183
102,59,"Tomorrow'sdateis%i/%i/%.2i.\n",343,171.892766666667,644.8948,137447,137536,89
102,0,blank,0,303.396066666667,673.764033333333,137568,137665,97
102,0,blank,0,567.86354,685.77126,137699,137873,174
102,0,blank,0,568.179566666667,678.0718,137873,137970,97
102,0,blank,0,565.18786,670.07642,138034,138196,162
102,0,blank,0,637.8628,690.19055,138196,138375,179
102,0,blank,0,638.5141,692.0428,138375,138455,80
102,0,blank,0,766.324,701.06354,138582,138757,175
102,0,blank,0,810.416166666667,705.581166666667,138757,138954,197
102,0,blank,0,848.104,703.2645,138954,139116,162
102,0,blank,0,-350,-105,139148,139336,188
102,0,blank,0,-350,-105,139336,139409,73
102,0,blank,0,774.719,707.34278,139505,139673,168
102,0,blank,0,757.055833333333,697.655016666667,139673,139869,196
102,0,blank,0,840.949166666667,698.042716666667,139902,140100,198
102,0,blank,0,844.5915,702.269816666667,140100,140296,196
102,0,blank,0,857.7314,701.13696,140296,140456,160
102,0,blank,0,744.031666666667,693.75135,140488,140686,198
102,0,blank,0,773.747333333333,682.201716666667,140686,140881,195
102,0,blank,0,786.568166666667,697.792716666667,140881,141080,199
102,0,blank,0,852.539,681.356,141080,141113,33
102,0,blank,0,-350,-105,141147,141336,189
102,0,blank,0,-350,-105,141336,141406,70
102,0,blank,0,843.672,695.46356,141649,141826,177
102,0,blank,0,844.39,711.76144,141826,142000,174
102,0,blank,0,826.1,711.01062,142000,142174,174
102,0,blank,0,828.787,718.1947,142174,142209,35
102,0,blank,0,-350,-105,142278,142475,197
102,0,blank,0,824.3045,649.830933333333,142504,142703,199
102,0,blank,0,828.2904,688.7729,142703,142879,176
102,0,blank,0,841.7732,693.23526,142879,143050,171
102,0,blank,0,859.437,709.7899,143050,143221,171
102,0,blank,0,855.745,707.57096,143221,143393,172
102,0,blank,0,865.237,703.5162,143393,143428,35
102,0,blank,0,746.354,685.92038,143462,143635,173
102,0,blank,0,-350,-105,143669,143807,138
102,0,blank,0,-350,-105,143807,143875,68
102,0,blank,0,603.764633333333,691.239616666667,144042,144233,191
102,0,blank,0,608.06334,697.6592,144233,144406,173
102,0,blank,0,638.73386,706.69242,144406,144576,170
102,0,blank,0,639.646583333333,699.41005,144576,144773,197
102,0,blank,0,555.210416666667,699.14105,144773,144972,199
102,0,blank,0,533.87424,640.38078,144972,145138,166
102,0,blank,0,-350,-105,145171,145309,138
102,0,blank,0,-350,-105,145309,145373,64
102,0,blank,0,530.906033333333,636.544683333333,145534,145723,189
102,0,blank,0,530.905483333333,672.095966666667,145723,145920,197
102,0,blank,0,479.04152,684.20776,145920,146087,167
102,0,blank,0,276.37578,690.7299,146120,146285,165
102,0,blank,0,276.0833,692.0284,146285,146320,35
102,0,blank,0,161.944983333333,683.618216666667,146352,146548,196
102,0,blank,0,219.557,675.558883333333,146548,146745,197
102,0,blank,0,334.67395,681.121625,146745,146876,131
102,0,blank,0,-350,-105,146907,147068,161
102,0,blank,0,-350,-105,147068,147115,47
102,0,blank,0,375.07255,673.532416666667,147262,147448,186
102,0,blank,0,374.96066,692.69592,147448,147614,166
102,0,blank,0,374.225533333333,685.267966666667,147614,147813,199
102,0,blank,0,373.9575,688.559933333333,147813,148009,196
102,0,blank,0,369.65265,668.30675,148009,148207,198
102,0,blank,0,381.269216666667,684.643433333333,148207,148402,195
102,59,"Tomorrow'sdateis%i/%i/%.2i.\n",343,373.02125,644.1473,148402,148468,66
102,0,blank,0,-350,-105,148501,148675,174
102,0,blank,0,853.3152,696.65144,148712,148880,168
102,0,blank,0,858.694,697.460666666667,148880,149078,198
102,0,blank,0,832.2276,692.76884,149078,149249,171
102,0,blank,0,820.682,693.183316666667,149249,149447,198
102,0,blank,0,-350,-105,149515,149696,181
102,0,blank,0,-350,-105,149696,149881,185
102,0,blank,0,-350,-105,149881,149927,46
102,0,blank,0,406.888583333333,706.117316666667,149960,150152,192
102,0,blank,0,392.13758,693.74594,150152,150320,168
102,0,blank,0,385.2287,694.8173,150320,150490,170
102,0,blank,0,382.03992,684.35698,150490,150658,168
102,0,blank,0,378.66136,688.24266,150658,150825,167
102,0,blank,0,385.3071,737.8823,150825,150859,34
102,0,blank,0,-350,-105,150892,151032,140
102,0,blank,0,809.519,695.475116666667,151163,151356,193
102,0,blank,0,858.829833333333,703.988833333333,151356,151554,198
102,0,blank,0,857.8148,707.36694,151554,151720,166
102,0,blank,0,858.674,704.39656,151720,151887,167
102,0,blank,0,855.797,709.926766666667,151887,151988,101
102,0,blank,0,-350,-105,152057,152198,141
102,0,blank,0,369.933933333333,695.87735,152335,152526,191
102,0,blank,0,364.965566666667,693.220266666667,152526,152725,199
102,0,blank,0,364.431083333333,702.52235,152725,152920,195
102,0,blank,0,374.978583333333,682.527716666667,152920,153117,197
102,0,blank,0,384.7717,703.107366666667,153117,153215,98
102,0,blank,0,-350,-105,153249,153438,189
102,0,blank,0,-350,-105,153438,153622,184
102,0,blank,0,382.138,699.935016666667,153655,153851,196
102,0,blank,0,387.89796,689.47,153851,154018,167
102,0,blank,0,377.883616666667,689.92095,154018,154217,199
102,0,blank,0,385.474516666667,692.285166666667,154217,154415,198
102,0,blank,0,118.38854,689.8241,154480,154647,167
102,60,0,361,122.4456,684.3548,154647,154712,65
102,0,blank,0,610.9238,705.4887,154777,154843,66
102,0,blank,0,-350,-105,154911,155021,110
102,0,blank,0,854.25,667.4084,155048,155085,37
102,0,blank,0,817.401,690.245,155149,155346,197
102,0,blank,0,789.443166666667,692.172133333333,155346,155542,196
102,0,blank,0,772.7558,690.56314,155542,155708,166
102,0,blank,0,775.7055,691.150783333333,155708,155906,198
102,0,blank,0,797.1934,687.23724,155906,156070,164
102,0,blank,0,-350,-105,156102,156288,186
102,0,blank,0,-350,-105,156288,156376,88
102,0,blank,0,855.703,702.1599,156429,156597,168
102,0,blank,0,873.488166666667,706.61535,156597,156794,197
102,0,blank,0,864.584333333333,697.141283333333,156794,156989,195
102,0,blank,0,852.552,707.5053,156989,157023,34
102,56,"Entertoday'sdate(mmddyyyy):",311,418.793633333333,580.8901,157088,157284,196
102,0,blank,0,378.987416666667,569.746116666667,157284,157481,197
102,56,"Entertoday'sdate(mmddyyyy):",311,372.5751,586.399233333333,157481,157674,193
102,57,month,321,362.7138,611.6258,157674,157866,192
102,57,comma,327,365.0895,606.581,157866,157962,96
102,59,nextDay,353,500.190266666667,653.709633333333,157994,158092,98
102,0,blank,0,-350,-105,158125,158295,170
102,0,blank,0,-350,-105,158295,158468,173
102,0,blank,0,403.61795,642.893775,158507,158661,154
102,0,blank,0,228.7567,665.6926,158785,158873,88
102,59,"Tomorrow'sdateis%i/%i/%.2i.\n",343,341.363866666667,653.845166666667,159003,159113,110
102,59,nextDay,353,548.853116666667,657.170083333333,159146,159340,194
102,59,month,347,590.514066666667,659.0555,159340,159534,194
102,59,month,347,590.200316666667,660.8662,159534,159726,192
102,59,month,347,595.3893,657.0099,159726,159858,132
102,0,blank,0,-350,-105,159924,160111,187
102,0,blank,0,-350,-105,160111,160138,27
102,0,blank,0,578.8152,468.2265,160252,160279,27
102,59,nextDay,353,515.388916666667,646.9666,160321,160517,196
102,59,month,347,578.833166666667,652.3304,160517,160710,193
102,59,.,354,556.5283,649.1666,160710,160903,193
102,59,nextDay,353,531.790266666667,659.0761,160903,160999,96
102,0,blank,0,411.019466666667,632.353616666667,161031,161224,193
102,0,blank,0,419.0673,637.2936,161224,161258,34
102,0,blank,0,-350,-105,161321,161488,167
102,0,blank,0,-350,-105,161488,161640,152
102,59,"Tomorrow'sdateis%i/%i/%.2i.\n",343,364.24908,660.55172,161693,161869,176
102,0,blank,0,336.448383333333,675.565516666667,161869,162061,192
102,0,blank,0,349.2232,675.41864,162061,162218,157
102,0,blank,0,380.083566666667,699.066333333333,162280,162470,190
102,0,blank,0,375.8628,700.5007,162470,162534,64
102,0,blank,0,383.54985,706.5504,162598,162795,197
102,0,blank,0,376.964966666667,707.324083333333,162795,162984,189
102,0,blank,0,390.1516,713.464633333333,162984,163173,189
102,0,blank,0,401.861116666667,710.12095,163173,163364,191
102,0,blank,0,396.4865,709.291283333333,163364,163553,189
102,0,blank,0,393.5992,710.413833333333,163553,163742,189
102,0,blank,0,383.349416666667,704.2937,163742,163933,191
102,0,blank,0,386.4716,668.979,163933,164060,127
102,0,blank,0,-350,-105,164092,164279,187
102,0,blank,0,-350,-105,164279,164424,145
102,0,blank,0,-350,-105,164424,164601,177
102,56,"Entertoday'sdate(mmddyyyy):",311,461.8582,579.5325,164629,164648,19
102,0,blank,0,455.321766666667,694.711533333333,164702,164894,192
102,0,blank,0,449.967583333333,694.9216,164894,165084,190
102,0,blank,0,467.967533333333,677.6845,165084,165274,190
102,0,blank,0,496.880483333333,694.819916666667,165274,165464,190
102,0,blank,0,496.817733333333,683.697866666667,165464,165654,190
102,0,blank,0,462.197266666667,682.467016666667,165654,165844,190
102,0,blank,0,447.966683333333,695.316416666667,165844,166028,184
102,0,blank,0,432.122266666667,683.311383333333,166028,166217,189
102,0,blank,0,428.4984,687.234916666667,166217,166409,192
102,0,blank,0,417.33468,690.67898,166409,166568,159
102,0,blank,0,-350,-105,166600,166794,194
102,0,blank,0,-350,-105,166794,166938,144
102,0,blank,0,483.63635,525.57815,166988,167064,76
102,0,blank,0,469.569333333333,691.142666666667,167133,167321,188
102,0,blank,0,469.831233333333,697.9545,167321,167510,189
102,0,blank,0,467.699166666667,688.755466666667,167510,167701,191
102,0,blank,0,477.927083333333,695.703966666667,167701,167893,192
102,0,blank,0,488.455933333333,697.582683333333,167893,168084,191
102,0,blank,0,485.573833333333,695.28205,168084,168278,194
102,0,blank,0,485.4115,689.08466,168278,168440,162
102,0,blank,0,-350,-105,168472,168659,187
102,0,blank,0,-350,-105,168659,168825,166
102,0,blank,0,456.2241,684.727683333333,168856,169039,183
102,0,blank,0,461.440516666667,693.6327,169039,169234,195
102,0,blank,0,455.337966666667,706.640716666667,169234,169428,194
102,0,blank,0,462.664775,698.693125,169428,169554,126
102,0,blank,0,-350,-105,169619,169806,187
102,0,blank,0,-350,-105,169806,169987,181
102,0,blank,0,463.81248,620.44092,170040,170220,180
102,59,"Tomorrow'sdateis%i/%i/%.2i.\n",343,459.714125,651.32855,170220,170392,172
102,0,blank,0,460.378366666667,679.8413,170392,170590,198
102,0,blank,0,457.1001,698.742933333333,170590,170784,194
102,0,blank,0,458.47515,687.936466666667,170784,170981,197
102,0,blank,0,462.696283333333,698.120933333333,170981,171176,195
102,0,blank,0,467.192666666667,682.90865,171176,171370,194
102,0,blank,0,461.026966666667,694.384033333333,171370,171566,196
102,0,blank,0,459.523575,696.758375,171566,171701,135
102,0,blank,0,-350,-105,171767,171954,187
102,0,blank,0,-350,-105,171954,172114,160
102,0,blank,0,-350,-105,172114,172242,128
102,0,blank,0,383.308683333333,678.579766666667,172401,172598,197
102,0,blank,0,388.2638,693.741266666667,172598,172695,97
102,0,blank,0,-350,-105,172728,172916,188
102,0,blank,0,-350,-105,172916,173099,183
102,0,blank,0,366.7339,630.7721,173147,173189,42
102,0,blank,0,828.227166666667,680.557183333333,173255,173443,188
102,0,blank,0,863.708833333333,690.61165,173443,173627,184
102,0,blank,0,857.8955,679.61535,173627,173811,184
102,0,blank,0,863.197,687.98985,173811,173997,186
102,0,blank,0,788.689666666667,688.07855,173997,174183,186
102,0,blank,0,739.363333333333,677.7644,174183,174370,187
102,0,blank,0,741.66,691.752,174370,174401,31
102,0,blank,0,829.569333333333,691.154233333333,174433,174620,187
102,0,blank,0,783.958,674.6676,174620,174652,32
102,0,blank,0,422.46315,673.4654,174683,174870,187
102,0,blank,0,423.63855,680.323375,174870,174995,125
102,0,blank,0,-350,-105,175027,175212,185
102,0,blank,0,-350,-105,175212,175381,169
102,0,blank,0,394.1987,686.2037,175429,175467,38
102,0,blank,0,824.2596,709.77056,175533,175702,169
102,0,blank,0,813.014,676.5504,175702,175734,32
102,0,blank,0,473.701233333333,691.294583333333,175766,175955,189
102,0,blank,0,848.4625,697.568966666667,176018,176206,188
102,0,blank,0,803.457333333333,692.91845,176206,176392,186
102,0,blank,0,835.722666666667,695.030183333333,176392,176579,187
102,0,blank,0,858.397333333333,701.9181,176579,176767,188
102,0,blank,0,861.299,699.661066666667,176767,176954,187
102,0,blank,0,864.230333333333,691.943816666667,176954,177142,188
102,0,blank,0,853.871,704.9265,177142,177174,32
102,0,blank,0,-350,-105,177205,177365,160
102,59,comma,352,740.695,660.7288,177502,177575,73
102,0,blank,0,858.620833333333,699.66425,177700,177899,199
102,0,blank,0,860.126,684.1585,177899,177930,31
102,0,blank,0,417.65018,687.09594,177995,178155,160
102,0,blank,0,398.0375,692.5444,178217,178251,34
102,0,blank,0,387.2234,683.419,178316,178410,94
102,0,blank,0,-350,-105,178472,178655,183
102,0,blank,0,-350,-105,178655,178722,67
102,59,"Tomorrow'sdateis%i/%i/%.2i.\n",343,383.21808,651.21682,178867,179025,158
102,0,blank,0,361.3131,633.3178,179025,179209,184
102,0,blank,0,384.1753,705.44,179209,179318,109
102,0,blank,0,385.1184,692.360766666667,179318,179488,170
102,0,blank,0,378.648333333333,692.370066666667,179488,179684,196
102,0,blank,0,-350,-105,179750,179934,184
102,0,blank,0,-350,-105,179934,180132,198
102,59,"Tomorrow'sdateis%i/%i/%.2i.\n",343,374.058166666667,659.1426,180170,180359,189
102,0,blank,0,381.0913,693.95194,180359,180531,172
102,0,blank,0,376.737266666667,701.286416666667,180531,180730,199
102,0,blank,0,376.693166666667,705.658983333333,180730,180921,191
102,0,blank,0,375.88325,679.92455,180921,181111,190
102,0,blank,0,-350,-105,181143,181331,188
102,0,blank,0,-350,-105,181331,181511,180
102,0,blank,0,-350,-105,181511,181708,197
102,0,blank,0,-350,-105,181708,181886,178
102,0,blank,0,-350,-105,181886,181969,83
102,0,blank,0,773.927666666667,705.2343,182068,182265,197
102,0,blank,0,719.2534,703.21968,182265,182426,161
102,0,blank,0,434.128683333333,695.983433333333,182459,182649,190
102,0,blank,0,359.39375,689.071333333333,182649,182842,193
102,0,blank,0,354.9754,700.478316666667,182842,183031,189
102,0,blank,0,344.905183333333,690.015316666667,183031,183223,192
102,0,blank,0,343.2492,669.5947,183223,183254,31
102,0,blank,0,-350,-105,183317,183505,188
102,0,blank,0,-350,-105,183505,183657,152
102,59,"Tomorrow'sdateis%i/%i/%.2i.\n",343,377.35515,662.480475,183707,183876,169
102,0,blank,0,378.343416666667,707.134916666667,183876,184071,195
102,0,blank,0,377.818233333333,725.129066666667,184071,184267,196
102,0,blank,0,381.757816666667,715.687766666667,184267,184460,193
102,57,&,328,388.5601,617.5843,184460,184491,31
102,0,blank,0,-350,-105,184530,184721,191
102,0,blank,0,-350,-105,184721,184830,109
102,59,"Tomorrow'sdateis%i/%i/%.2i.\n",343,374.2179,644.529366666667,184861,184988,127
102,0,blank,0,862.6855,703.207933333333,185124,185323,199
102,0,blank,0,867.585666666667,706.09575,185323,185514,191
102,0,blank,0,847.722166666667,705.3256,185514,185704,190
102,0,blank,0,818.1255,690.751816666667,185704,185898,194
102,0,blank,0,-350,-105,185930,186104,174
102,0,blank,0,-350,-105,186104,186169,65
102,0,blank,0,364.01575,623.3938,186202,186261,59
102,0,blank,0,386.959925,677.320475,186294,186424,130
102,0,blank,0,384.961233333333,640.628033333333,186455,186550,95
102,0,blank,0,377.7089,687.858083333333,186583,186776,193
102,0,blank,0,815.223333333333,717.13165,186842,187040,198
102,0,blank,0,869.626833333333,714.892116666667,187040,187234,194
102,0,blank,0,871.718666666667,722.915666666667,187234,187426,192
102,0,blank,0,881.883,724.61065,187426,187623,197
102,0,blank,0,907.505333333333,691.109966666667,187623,187722,99
102,0,blank,0,-350,-105,187756,187944,188
102,0,blank,0,-350,-105,187944,188110,166
102,0,blank,0,-350,-105,188110,188174,64
102,0,blank,0,871.8356,701.18306,188339,188532,193
102,0,blank,0,878.985166666666,694.621766666667,188532,188729,197
102,0,blank,0,874.706833333333,695.140716666667,188729,188926,197
102,0,blank,0,879.2945,708.3127,188926,189117,191
102,0,blank,0,869.609333333333,702.194366666667,189117,189307,190
102,0,blank,0,877.598666666667,703.3527,189307,189501,194
102,0,blank,0,875.111,707.521116666667,189501,189700,199
102,0,blank,0,866.2392,711.72296,189700,189865,165
102,0,blank,0,-350,-105,189934,190128,194
102,0,blank,0,-350,-105,190128,190280,152
102,0,blank,0,-350,-105,190280,190407,127
102,0,blank,0,-350,-105,190407,190598,191
102,0,blank,0,914.2266,696.98394,190628,190786,158
102,0,blank,0,869.236,705.175083333333,190817,191006,189
102,0,blank,0,888.002666666667,706.5818,191006,191198,192
102,0,blank,0,876.984,694.246983333333,191198,191393,195
102,0,blank,0,861.968666666667,696.766666666667,191393,191588,195
102,0,blank,0,879.682,676.7204,191588,191619,31
102,0,blank,0,-350,-105,191685,191874,189
102,0,blank,0,-350,-105,191874,192068,194
102,0,blank,0,868.8608,690.4609,192117,192290,173
102,0,blank,0,856.913833333333,695.111,192290,192487,197
102,0,blank,0,864.148333333333,695.707316666667,192487,192680,193
102,0,blank,0,874.607333333333,704.55735,192680,192877,197
102,0,blank,0,874.634,702.074775,192877,193006,129
102,0,blank,0,-350,-105,193071,193251,180
102,0,blank,0,-350,-105,193251,193421,170
102,0,blank,0,-350,-105,193421,193514,93
102,0,blank,0,422.587833333333,697.921583333333,193614,193811,197
102,0,blank,0,397.801233333333,691.74845,193811,194004,193
102,0,blank,0,379.57365,687.817483333333,194004,194194,190
102,0,blank,0,386.06695,692.7883,194194,194384,190
102,0,blank,0,387.279633333333,690.139416666667,194384,194571,187
102,0,blank,0,374.885483333333,681.001466666667,194571,194770,199
102,0,blank,0,382.277183333333,677.38045,194770,194964,194
102,0,blank,0,365.67236,674.03096,194964,195125,161
102,0,blank,0,-350,-105,195156,195345,189
102,0,blank,0,76.841475,711.102525,195561,195699,138
102,56,"Entertoday'sdate(mmddyyyy):",311,280.1822,578.18145,195731,195919,188
102,56,"Entertoday'sdate(mmddyyyy):",311,248.27375,586.6876,195919,196106,187
102,56,"Entertoday'sdate(mmddyyyy):",311,190.457916666667,592.95965,196106,196291,185
102,56,"Entertoday'sdate(mmddyyyy):",311,148.179333333333,592.781666666667,196291,196383,92
102,57,month,321,332.184883333333,617.649916666667,196415,196601,186
102,57,month,321,332.556816666667,618.80305,196601,196786,185
102,57,thisDay,329,294.159933333333,616.68845,196786,196970,184
102,57,"%i%i%i",316,151.3794,619.73835,197000,197183,183
102,58,=,335,132.863,636.8306,197183,197213,30
102,0,blank,0,-350,-105,197244,197427,183
102,0,blank,0,-350,-105,197427,197588,161
102,0,blank,0,-350,-105,197588,197783,195
102,0,blank,0,-350,-105,197783,197858,75
102,56,"Entertoday'sdate(mmddyyyy):",311,296.3042,582.6734,197892,198001,109
102,59,"Tomorrow'sdateis%i/%i/%.2i.\n",343,298.725875,658.034825,198030,198158,128
102,59,"Tomorrow'sdateis%i/%i/%.2i.\n",343,156.633533333333,660.023133333333,198189,198377,188
102,0,blank,0,223.745266666667,669.11135,198377,198568,191
102,0,blank,0,-350,-105,198636,198828,192
102,0,blank,0,-350,-105,198828,198890,62
102,58,thisDay,338,285.030866666667,627.233733333333,199044,199232,188
102,57,thisDay,329,241.0441,612.57142,199232,199393,161
102,0,blank,0,386.0372,625.7922,199446,199516,70
102,59,month,347,567.5942,657.14395,199625,199818,193
102,59,month,347,586.233766666667,647.408533333333,199818,200010,192
102,0,blank,0,538.093983333333,640.9119,200010,200201,191
102,0,blank,0,528.7184,638.5298,200201,200233,32
102,58,thisDay,338,289.905466666667,640.501883333333,200265,200461,196
102,0,blank,0,251.933866666667,640.72545,200461,200658,197
102,58,dateUpdate,336,231.015,635.0414,200658,200692,34
102,0,blank,0,-350,-105,200758,200788,30
102,0,blank,0,-350,-105,200840,200874,34
102,0,blank,0,137.149066666667,323.746116666667,200900,201072,172
102,0,blank,0,152.68705,329.3051,201072,201136,64
102,0,blank,0,361.667,359.1302,201167,201357,190
102,0,blank,0,290.4636,356.986366666667,201357,201543,186
102,0,blank,0,236.6516,351.861966666667,201543,201635,92
102,0,blank,0,-350,-105,201804,201932,128
102,0,blank,0,-350,-105,201932,202115,183
102,0,blank,0,-350,-105,202115,202314,199
102,0,blank,0,-350,-105,202314,202486,172
102,0,blank,0,-350,-105,202486,202659,173
102,0,blank,0,365.020966666667,251.3457,203205,203294,89
102,0,blank,0,-350,-105,203356,203510,154
102,0,blank,0,-350,-105,203510,203683,173
102,0,blank,0,-350,-105,203683,203791,108
102,0,blank,0,-350,-105,204569,204759,190
102,0,blank,0,-350,-105,204759,204940,181
102,0,blank,0,-350,-105,204940,205119,179
102,0,blank,0,-350,-105,205119,205260,141
102,46,0,273,249.341325,359.63345,205280,205475,195
102,46,==,272,221.6567,366.4236,205475,205649,174
102,46,==,272,218.652675,374.201225,205649,205825,176
102,46,0,273,246.44085,368.8182,205825,206007,182
102,0,blank,0,-350,-105,206050,206245,195
102,0,blank,0,-350,-105,206245,206425,180
102,0,blank,0,-350,-105,206425,206615,190
102,0,blank,0,-350,-105,206615,206719,104
102,0,blank,0,238.0741,339.779,206752,206935,183
102,0,blank,0,262.591216666667,358.349983333333,206935,207118,183
102,0,blank,0,295.703266666667,350.4663,207118,207302,184
102,0,blank,0,299.5526,331.1503,207302,207334,32
102,0,blank,0,447.74395,343.7704,207364,207548,184
102,0,blank,0,445.648683333333,350.900333333333,207548,207730,182
102,0,blank,0,446.83026,354.96508,207730,207887,157
102,46,400,271,629.201,370.516166666667,207917,208011,94
102,0,blank,0,-350,-105,208071,208257,186
102,0,blank,0,-350,-105,208257,208435,178
102,0,blank,0,569.394466666667,384.12305,208466,208659,193
102,0,blank,0,572.6158,389.9921,208659,208692,33
102,0,blank,0,457.24395,383.08655,208725,208923,198
102,0,blank,0,434.6891,381.230333333333,208923,209115,192
102,0,blank,0,424.919616666667,381.8524,209115,209306,191
102,46,100,262,411.402216666667,373.686,209306,209496,190
102,46,!=,263,437.836966666667,377.604183333333,209496,209687,191
102,46,0,273,458.8164,376.514466666667,209687,209877,190
102,0,blank,0,480.488716666667,374.81525,209877,210070,193
102,0,blank,0,482.698316666667,371.443116666667,210070,210261,191
102,0,blank,0,-350,-105,210294,210481,187
102,0,blank,0,-350,-105,210481,210617,136
102,46,100,262,406.893583333333,371.341366666667,210647,210837,190
102,46,100,262,392.252616666667,377.835016666667,210837,211032,195
102,0,blank,0,421.559666666667,373.033783333333,211032,211225,193
102,46,),274,470.73265,374.478633333333,211225,211416,191
102,0,blank,0,484.544733333333,382.644633333333,211416,211604,188
102,0,blank,0,467.128233333333,379.45355,211604,211796,192
102,0,blank,0,445.55545,374.594683333333,211796,211982,186
102,0,blank,0,455.0887,384.3261,211982,212044,62
102,59,nextDay,353,670.40018,663.8278,212075,212229,154
102,0,blank,0,847.251166666667,706.802366666667,212260,212455,195
102,0,blank,0,791.213666666667,697.37085,212455,212636,181
102,0,blank,0,746.362,699.623233333333,212636,212821,185
102,0,blank,0,851.340833333333,705.60945,212821,213005,184
102,0,blank,0,841.729,726.1547,213005,213037,32
102,0,blank,0,-350,-105,213067,213253,186
102,0,blank,0,-350,-105,213253,213435,182
102,0,blank,0,-350,-105,213435,213596,161
102,0,blank,0,-350,-105,213596,213694,98
102,0,blank,0,-350,-105,213694,213829,135
102,0,blank,0,466.944,632.19318,213864,214027,163
102,0,blank,0,-350,-105,214059,214222,163
102,0,blank,0,-350,-105,214222,214388,166
102,0,blank,0,-350,-105,214388,214568,180
102,0,blank,0,344.24374,556.38318,214653,214839,186
102,59,"Tomorrow'sdateis%i/%i/%.2i.\n",343,336.410925,650.385375,214839,214959,120
102,0,blank,0,178.955333333333,702.7087,214997,215181,184
102,0,blank,0,173.53705,688.509933333333,215181,215368,187
102,0,blank,0,167.158433333333,691.382966666667,215368,215463,95
102,0,blank,0,384.614766666667,692.570066666667,215494,215681,187
102,0,blank,0,383.63365,702.786,215681,215873,192
102,0,blank,0,376.50365,678.144316666667,215873,216061,188
102,0,blank,0,383.9793,699.4504,216061,216254,193
102,0,blank,0,387.903266666667,707.634716666667,216254,216449,195
102,0,blank,0,379.2353,683.2039,216449,216546,97
102,0,blank,0,-350,-105,216577,216767,190
102,0,blank,0,-350,-105,216767,216844,77
102,54,date,299,374.00652,539.1589,216875,217032,157
102,0,blank,0,839.788,542.731733333333,217100,217241,141
102,0,blank,0,788.935,604.6363,217241,217309,68
102,0,blank,0,808.2615,699.119625,217373,217565,192
102,0,blank,0,870.5668,704.44568,217565,217722,157
102,0,blank,0,759.947333333333,698.282783333333,217753,217943,190
102,0,blank,0,749.714166666667,710.795483333333,217943,218141,198
102,0,blank,0,749.4175,704.346775,218141,218269,128
102,0,blank,0,512.351983333333,676.954333333333,218301,218494,193
102,0,blank,0,-350,-105,218526,218715,189
102,0,blank,0,-350,-105,218715,218873,158
102,0,blank,0,975.276,516.6541,218904,218967,63
102,0,blank,0,943.187,334.0787,218999,219037,38
102,0,blank,0,861.131833333333,712.703383333333,219214,219408,194
102,0,blank,0,864.781833333333,711.2819,219408,219603,195
102,0,blank,0,863.6495,716.6462,219603,219797,194
102,0,blank,0,861.4875,702.76335,219797,219975,178
102,0,blank,0,852.537,697.9508,219975,220055,80
102,0,blank,0,855.171,709.2591,220055,220225,170
102,0,blank,0,732.806,709.219083333333,220262,220459,197
102,0,blank,0,734.619,713.0877,220459,220592,133
102,0,blank,0,-350,-105,220625,220789,164
102,0,blank,0,-350,-105,220789,220950,161
102,0,blank,0,-350,-105,220950,221014,64
102,59,nextDay,353,809.224,654.2246,221120,221407,287
102,0,blank,0,788.583,686.436,221407,221603,196
102,0,blank,0,764.111166666667,711.167833333333,221603,221800,197
102,0,blank,0,754.931,713.466066666667,221800,221994,194
102,0,blank,0,737.7278,713.15562,221994,222155,161
102,0,blank,0,456.20532,696.59266,222188,222356,168
102,0,blank,0,543.699116666667,670.017033333333,222356,222554,198
102,0,blank,0,597.8308,683.2697,222554,222651,97
102,0,blank,0,-350,-105,222684,222870,186
102,0,blank,0,-350,-105,222870,222930,60
102,0,blank,0,619.9494,675.0799,223339,223536,197
102,0,blank,0,661.992333333333,682.220433333333,223536,223731,195
102,0,blank,0,665.352466666667,673.9027,223731,223926,195
102,0,blank,0,664.515,703.3152,223926,224123,197
102,0,blank,0,665.144666666667,699.5403,224123,224313,190
102,0,blank,0,660.322,698.7751,224313,224346,33
102,0,blank,0,560.59358,693.11566,224408,224566,158
102,0,blank,0,-350,-105,224631,224738,107
102,0,blank,0,431.68395,485.57225,224847,224969,122
102,54,today,300,402.66302,543.9143,225003,225174,171
102,56,"Entertoday'sdate(mmddyyyy):",311,385.542075,583.832075,225174,225309,135
102,0,blank,0,381.069425,498.8653,225343,225480,137
102,56,"Entertoday'sdate(mmddyyyy):",311,372.08076,594.03928,225553,225726,173
102,0,blank,0,357.81268,670.6067,225758,225928,170
102,0,blank,0,358.372233333333,694.186516666667,225928,226123,195
102,0,blank,0,362.13585,680.600716666667,226123,226320,197
102,0,blank,0,373.157433333333,695.471883333333,226320,226517,197
102,0,blank,0,-350,-105,226582,226770,188
102,0,blank,0,-350,-105,226770,226912,142
102,0,blank,0,556.0509,441.117733333333,227004,227105,101
102,59,nextDay,353,543.6998,649.4817,227139,227316,177
102,58,dateUpdate,336,208.2992,625.147675,227360,227546,186
102,57,"%i%i%i",316,194.4276,618.566475,227546,227724,178
102,55,thisDay,305,178.81745,570.7792,227724,227899,175
102,55,thisDay,305,194.0503,575.714725,227899,228072,173
102,55,nextDay,307,262.521516666667,556.25695,228072,228251,179
102,0,blank,0,204.068933333333,554.2164,228251,228432,181
102,55,thisDay,305,199.7995,561.2789,228432,228461,29
102,0,blank,0,-350,-105,228493,228676,183
102,0,blank,0,-350,-105,228676,228856,180
102,0,blank,0,-350,-105,228856,228935,79
102,0,blank,0,545.2956,641.828933333333,228963,229134,171
102,59,.,354,560.8983,646.57085,229134,229196,62
102,0,blank,0,685.6915,689.9038,229227,229409,182
102,0,blank,0,676.41825,684.4468,229409,229580,171
102,0,blank,0,699.4355,696.54775,229580,229752,172
102,0,blank,0,726.628,697.206433333333,229752,229887,135
102,0,blank,0,544.7554,700.856325,229936,230112,176
102,0,blank,0,533.780016666667,704.012566666667,230112,230301,189
102,0,blank,0,542.010625,697.851125,230301,230426,125
102,0,blank,0,363.560483333333,684.6515,230459,230644,185
102,0,blank,0,348.8298,678.1541,230644,230675,31
102,0,blank,0,-350,-105,230773,230959,186
102,0,blank,0,-350,-105,230959,231018,59
102,0,blank,0,899.894,561.6043,231164,231191,27
102,0,blank,0,837.39825,671.236125,231312,231484,172
102,0,blank,0,827.01425,676.365325,231484,231656,172
102,0,blank,0,808.31125,684.0322,231656,231830,174
102,0,blank,0,786.385,693.568275,231830,232004,174
102,0,blank,0,793.8275,687.050825,232004,232176,172
102,59,nextDay,353,809.9752,654.56792,232176,232373,197
102,0,blank,0,789.8565,642.1075,232373,232435,62
102,59,"Tomorrow'sdateis%i/%i/%.2i.\n",343,435.086666666667,660.7979,232467,232655,188
102,0,blank,0,439.628033333333,666.277083333333,232655,232845,190
102,59,"Tomorrow'sdateis%i/%i/%.2i.\n",343,450.1185,652.36335,232845,232910,65
102,0,blank,0,-350,-105,232940,233128,188
102,0,blank,0,-350,-105,233128,233311,183
102,0,blank,0,-350,-105,233311,233387,76
102,0,blank,0,447.75725,668.04465,233417,233595,178
102,59,"Tomorrow'sdateis%i/%i/%.2i.\n",343,446.946633333333,644.839166666667,233595,233784,189
102,59,"Tomorrow'sdateis%i/%i/%.2i.\n",343,433.895416666667,650.303633333333,233784,233972,188
102,59,"Tomorrow'sdateis%i/%i/%.2i.\n",343,427.2183,663.224683333333,233972,234158,186
102,59,"Tomorrow'sdateis%i/%i/%.2i.\n",343,414.4993,660.2262,234158,234281,123
102,0,blank,0,172.8565,684.773883333333,234341,234523,182
102,0,blank,0,161.8859,693.357133333333,234523,234711,188
102,0,blank,0,-350,-105,234742,234928,186
102,0,blank,0,-350,-105,234928,235126,198
102,56,"Entertoday'sdate(mmddyyyy):",311,191.669466666667,578.598683333333,235154,235326,172
102,56,"Entertoday'sdate(mmddyyyy):",311,289.1419,581.7129,235326,235358,32
102,0,blank,0,500.514916666667,665.03965,235390,235581,191
102,0,blank,0,496.27025,666.1433,235581,235645,64
102,0,blank,0,274.28505,276.5985,235709,235898,189
102,40,daysPerMonth,223,237.389783333333,229.2602,235898,236090,192
102,0,blank,0,237.557625,219.5554,236090,236214,124
102,0,blank,0,293.872366666667,319.898166666667,236307,236427,120
102,0,blank,0,288.3581,223.72425,236427,236574,147
102,0,blank,0,374.529425,251.5776,236603,236730,127
102,0,blank,0,1027.15,410.335683333333,236792,236982,190
102,0,blank,0,994.683,470.84935,236982,237169,187
102,0,blank,0,998.151666666667,488.9249,237169,237356,187
102,0,blank,0,996.898,504.098116666667,237356,237547,191
102,0,blank,0,-350,-105,237612,237722,110
102,43,date,240,269.738483333333,301.58665,237865,238053,188
102,40,daysPerMonth,223,233.371266666667,233.245133333333,238053,238247,194
102,0,blank,0,222.0444,206.26858,238247,238407,160
102,0,blank,0,-350,-105,238537,238734,197
102,0,blank,0,-350,-105,238734,238887,153
102,0,blank,0,-350,-105,238887,239057,170
102,0,blank,0,-350,-105,239057,239207,150
102,0,blank,0,-350,-105,239207,239402,195
102,0,blank,0,-350,-105,239402,239600,198
102,0,blank,0,-350,-105,239600,239732,132
102,0,blank,0,283.9305,418.73965,239769,239951,182
102,0,blank,0,280.7957,418.63555,239951,240148,197
