Frameno_fix,lineno_fix,Tokenname_fix,tokens_id,gaze_X_fix,gaze_Y_fix,timestamp_fix_start,timestamp_fix_end,time_duration
100,0,blank,0,682.404,31.3172,5513,5537,24
100,0,blank,0,806.194,-42.5681,5762,5787,25
100,0,blank,0,-350,-105,5862,5986,124
100,0,blank,0,-350,-105,6062,6187,125
100,0,blank,0,-350,-105,6187,6362,175
100,0,blank,0,-350,-105,6362,6537,175
100,0,blank,0,-350,-105,6537,6563,26
100,0,blank,0,594.6705,39.9556,6792,6817,25
100,0,blank,0,-350,-105,6842,6917,75
100,0,blank,0,603.2283,88.9525,6992,7017,25
100,0,blank,0,-350,-105,7142,7167,25
100,0,blank,0,142.8155,-5.7174,7192,7217,25
100,0,blank,0,-350,-105,7242,7342,100
100,1,Program,4,133.3093,13.1138,7393,7418,25
100,0,blank,0,-350,-105,7718,7869,151
100,2,h,21,173.3881,32.3264,7920,7946,26
100,0,blank,0,150.2654,-3.1994,8094,8120,26
100,0,blank,0,-350,-105,8894,9038,144
100,0,blank,0,-350,-105,9038,9208,170
100,0,blank,0,-350,-105,9208,9363,155
100,0,blank,0,270.1018,-25.6675,9402,9427,25
100,1,Number,13,394.8442,17.4333,9741,9771,30
100,1,to,5,157.1587,15.1977,10464,10492,28
100,0,blank,0,199.9984,-1.0505,10909,10938,29
100,0,blank,0,287.5503,-8.3931,11141,11171,30
100,0,blank,0,323.2065,-7.4956,11500,11529,29
100,0,blank,0,493.179,3.3278,11999,12028,29
100,0,blank,0,523.7048,44.349,12146,12175,29
100,0,blank,0,625.2433,60.8805,12674,12703,29
100,0,blank,0,530.0411,36.0115,12936,12965,29
100,0,blank,0,487.2035,34.5491,13023,13053,30
100,0,blank,0,106.4327,54.3211,13516,13545,29
100,2,<,18,102.0622,31.4866,13721,13750,29
100,0,blank,0,103.6456,64.3264,13867,13925,58
100,0,blank,0,-350,-105,14276,14401,125
100,0,blank,0,154.7401,179.2186,14427,14452,25
100,0,blank,0,-350,-105,14968,15098,130
100,6,rem,31,123.912,120.9886,15819,15849,30
100,0,blank,0,108.7612,130.5168,15878,15907,29
100,0,blank,0,-350,-105,16230,16336,106
100,2,stdio,19,114.4552,37.46195,16576,16632,56
100,0,blank,0,70.9144666666667,65.6269,16748,16835,87
100,2,include,17,78.5442,39.6918,16864,16894,30
100,0,blank,0,79.09125,54.579,16924,17043,119
100,0,blank,0,68.5929,57.3909,17216,17245,29
100,0,blank,0,154.0281,44.9968,17393,17423,30
100,0,blank,0,143.7034,45.2363,17452,17482,30
100,2,stdio,19,151.9668,28.9567,17692,17722,30
100,1,Program,4,95.6591,19.7458,18020,18049,29
100,0,blank,0,128.27715,25.2441,18287,18348,61
100,2,stdio,19,135.4615,26.0519,18532,18562,30
100,2,stdio,19,124.4966,31.0838,18624,18655,31
100,0,blank,0,45.8302,50.3456,18869,18923,54
100,0,blank,0,51.9859,49.0206,19090,19203,113
100,4,main,24,44.0154,88.5686,19459,19490,31
100,4,),26,98.13895,71.225325,19924,20048,124
100,0,blank,0,81.7123,101.3078,20142,20173,31
100,7,scanf,39,76.8452,142.1517,20203,20234,31
100,0,blank,0,101.7477,97.0603,20455,20485,30
100,6,rem,31,114.3027,122.5023,20644,20675,31
100,6,rem,31,141.7498,122.2834,20706,20739,33
100,0,blank,0,150.3711,110.2358,20801,20831,30
100,6,s,33,164.0648,132.0563,20862,20892,30
100,0,blank,0,-350,-105,20953,20984,31
100,0,blank,0,173.3292,134.4911,21228,21296,68
100,0,blank,0,237.9498,133.689,21950,21983,33
100,0,blank,0,176.1609,157.0614,22506,22537,31
100,0,blank,0,136.7303,109.2353,22600,22630,30
100,7,"%d",41,135.7683,152.4026,22975,23005,30
100,8,=,50,124.652333333333,159.951433333333,23153,23244,91
100,0,blank,0,103.78775,139.44235,23305,23366,61
100,0,blank,0,88.3943,108.1295,23400,23431,31
100,0,blank,0,66.1466,103.2367,23527,23558,31
100,0,blank,0,127.8257,166.8836,23872,23902,30
100,7,"%d",41,124.5644,135.2536,24023,24054,31
100,0,blank,0,139.5298,133.8376,24145,24175,30
100,0,blank,0,177.6913,126.1969,24205,24236,31
100,0,blank,0,174.8055,128.015,24549,24581,32
100,0,blank,0,-350,-105,25360,25414,54
100,8,;,60,144.442,164.9813,25586,25654,68
100,7,"%d",41,132.527,143.5622,26604,26634,30
100,8,i,61,94.5654,159.4121,27125,27154,29
100,0,blank,0,155.9028,164.861,27373,27403,30
100,7,&,43,168.76935,152.23345,27666,27725,59
100,8,<=,54,185.1574,165.6145,28095,28127,32
100,0,blank,0,216.0699,137.5923,28158,28191,33
100,0,blank,0,268.2809,129.9953,28288,28316,28
100,8,++,62,317.504,159.1974,29090,29121,31
100,8,1,58,267.6287,165.9618,29307,29339,32
100,0,blank,0,250.2061,191.0291,29465,29496,31
100,0,blank,0,-350,-105,29776,29857,81
100,0,blank,0,-350,-105,30264,30369,105
100,0,blank,0,148.4149,252.1307,31102,31129,27
100,0,blank,0,-350,-105,31305,31434,129
100,0,blank,0,174.9471,195.388,31675,31704,29
100,0,blank,0,-350,-105,32080,32187,107
100,0,blank,0,275.5924,151.4682,32311,32362,51
100,0,blank,0,-350,-105,32770,32907,137
100,0,blank,0,-350,-105,33555,33685,130
100,0,blank,0,156.8344,136.0613,33735,33790,55
100,0,blank,0,-350,-105,33882,33958,76
100,0,blank,0,-350,-105,34187,34294,107
100,0,blank,0,253.7071,176.2045,34661,34690,29
100,0,blank,0,201.2364,113.31,34756,34781,25
100,7,&,43,168.1856,154.0429,34811,34844,33
100,0,blank,0,-350,-105,35543,35646,103
100,0,blank,0,318.86155,147.04865,36154,36215,61
100,0,blank,0,317.4236,152.4222,36487,36517,30
100,8,(,55,215.1849,173.8434,36610,36641,31
100,7,"%d",41,135.290766666667,142.821366666667,36706,36794,88
100,0,blank,0,58.1071,203.5663,37319,37350,31
100,0,blank,0,117.8012,184.4376,37997,38028,31
100,11,rem,73,97.9903,231.0665,38591,38625,34
100,0,blank,0,122.344,223.0812,38927,38959,32
100,10,rem,65,93.577,203.8648,39175,39206,31
100,0,blank,0,154.47,191.6436,39668,39711,43
100,10,=,66,128.7859,204.4265,40125,40157,32
100,0,blank,0,-350,-105,40707,40819,112
100,0,blank,0,-350,-105,41022,41162,140
100,0,blank,0,154.7888,170.7035,41409,41437,28
100,0,blank,0,134.4977,183.0674,41534,41567,33
100,0,blank,0,-350,-105,42159,42223,64
100,8,;,60,145.7567,157.1467,42349,42374,25
100,0,blank,0,267.1055,123.5219,43177,43206,29
100,0,blank,0,-350,-105,43325,43404,79
100,0,blank,0,188.7463,184.1417,43692,43723,31
100,0,blank,0,177.6559,177.5615,43783,43813,30
100,8,n,56,230.149,169.5191,43844,43874,30
100,0,blank,0,-350,-105,44115,44249,134
100,0,blank,0,178.5184,190.0574,44303,44327,24
100,11,rem,73,107.9302,227.4762,44749,44780,31
100,11,rem,73,113.73515,227.902,44840,44900,60
100,11,rem,73,110.593466666667,240.131733333333,45171,45264,93
100,0,blank,0,136.0556,208.6445,45597,45628,31
100,10,rem,65,113.6,211.3503,45749,45780,31
100,10,%,68,165.7529,204.313,45901,45931,30
100,10,n,67,153.1052,206.7224,45962,45992,30
100,0,blank,0,156.064,201.5054,46022,46052,30
100,0,blank,0,152.6726,190.1358,46082,46112,30
100,0,blank,0,158.822,189.0852,46202,46232,30
100,0,blank,0,136.8474,212.4128,46263,46294,31
100,0,blank,0,-350,-105,46324,46430,106
100,0,blank,0,201.9496,191.18845,46553,46604,51
100,0,blank,0,194.1044,198.2549,46635,46666,31
100,0,blank,0,-350,-105,46759,46891,132
100,0,blank,0,157.4594,220.6902,47041,47066,25
100,0,blank,0,132.378466666667,246.3474,47252,47346,94
100,0,blank,0,148.34775,234.2781,47409,47473,64
100,0,blank,0,152.732366666667,263.2793,47538,47635,97
100,0,blank,0,189.3331,265.6947,47919,47950,31
100,0,blank,0,138.0928,255.7385,48107,48139,32
100,0,blank,0,134.4981,222.5892,48232,48262,30
100,0,blank,0,150.4547,234.2399,48325,48355,30
100,11,==,74,132.4943,235.0901,48386,48418,32
100,11,==,74,129.6311,242.303,48481,48513,32
100,10,n,67,148.6022,208.3658,48544,48575,31
100,0,blank,0,-350,-105,48638,48773,135
100,0,blank,0,173.03575,237.2225,48830,48896,66
100,0,blank,0,205.7985,257.2265,49275,49307,32
100,0,blank,0,-350,-105,49586,49667,81
100,10,=,66,126.2697,203.9312,49835,49864,29
100,0,blank,0,119.929,187.2191,49929,49961,32
100,0,blank,0,190.2662,193.4734,50180,50210,30
100,0,blank,0,178.6422,199.3427,50240,50272,32
100,0,blank,0,214.3969,193.0312,50580,50611,31
100,0,blank,0,-350,-105,50702,50780,78
100,0,blank,0,-350,-105,50984,51116,132
100,0,blank,0,198.77075,193.34895,51221,51276,55
100,0,blank,0,-350,-105,51488,51567,79
100,10,;,70,198.5561,205.4608,51846,51876,30
100,0,blank,0,185.3869,287.2407,52481,52511,30
100,0,blank,0,172.784,262.6785,53722,53781,59
100,0,blank,0,209.3068,236.7774,55466,55496,30
100,0,blank,0,169.7426,295.761,55587,55617,30
100,0,blank,0,186.1953,248.3712,55768,55798,30
100,0,blank,0,188.0964,250.4221,55951,56012,61
100,0,blank,0,189.5485,233.0231,56075,56110,35
100,0,blank,0,202.3017,257.7094,56204,56233,29
100,0,blank,0,199.9373,273.6595,56416,56445,29
100,0,blank,0,-350,-105,56573,56654,81
100,0,blank,0,-350,-105,58256,58449,193
100,0,blank,0,-350,-105,58449,58608,159
100,0,blank,0,-350,-105,58608,58752,144
100,0,blank,0,-350,-105,58752,58811,59
100,0,blank,0,-350,-105,58811,58982,171
100,0,blank,0,-350,-105,58982,59168,186
100,0,blank,0,-350,-105,59168,59367,199
100,0,blank,0,-350,-105,59367,59534,167
100,0,blank,0,-350,-105,59534,59703,169
100,0,blank,0,-350,-105,59703,59870,167
100,0,blank,0,-350,-105,59870,60092,222
100,0,blank,0,-350,-105,60092,60277,185
100,0,blank,0,-350,-105,60277,60449,172
100,0,blank,0,-350,-105,60449,60648,199
100,0,blank,0,-350,-105,60648,60798,150
100,0,blank,0,-350,-105,60798,60982,184
100,0,blank,0,-350,-105,60982,61173,191
100,0,blank,0,-350,-105,61173,61354,181
100,0,blank,0,-350,-105,61354,61518,164
100,0,blank,0,-350,-105,61518,61681,163
100,0,blank,0,-350,-105,61681,61803,122
100,0,blank,0,-350,-105,61803,61901,98
100,0,blank,0,-350,-105,61901,62550,649
100,0,blank,0,-350,-105,62550,62743,193
100,0,blank,0,-350,-105,62743,62926,183
100,0,blank,0,-350,-105,62926,62956,30
100,0,blank,0,-350,-105,62956,63164,208
100,0,blank,0,-350,-105,63164,63338,174
100,0,blank,0,-350,-105,63338,63616,278
100,0,blank,0,-350,-105,63616,63803,187
100,0,blank,0,-350,-105,63803,63997,194
100,0,blank,0,-350,-105,63997,64180,183
100,0,blank,0,-350,-105,64180,64212,32
100,0,blank,0,-350,-105,64212,64411,199
100,0,blank,0,-350,-105,64708,64889,181
100,0,blank,0,-350,-105,64889,65068,179
100,0,blank,0,-350,-105,65068,65195,127
100,0,blank,0,187.1628,325.3893,66072,66103,31
100,0,blank,0,199.3956,224.0328,66360,66418,58
100,0,blank,0,176.0691,303.1651,66899,66929,30
100,0,blank,0,152.3111,293.64795,66959,67020,61
100,0,blank,0,131.5178,307.3199,67050,67081,31
100,0,blank,0,126.8054,330.2032,67203,67233,30
100,0,blank,0,119.1121,380.9766,67474,67505,31
100,17,printf,92,112.1531,366.7986,67566,67597,31
100,17,printf,92,139.9005,367.0675,67627,67657,30
100,1,whether,7,254.0582,7.70910000000001,68839,68867,28
100,0,blank,0,286.7185,24.7873,68950,68979,29
100,0,blank,0,318.6879,-39.4963,69037,69066,29
100,0,blank,0,538.0448,-8.1664,69480,69509,29
100,1,Perfect,12,564.4147,18.5454,69626,69656,30
100,0,blank,0,584.5042,25.2667,69742,69771,29
100,0,blank,0,581.0066,10.5123,69913,69941,28
100,0,blank,0,578.4329,22.3756,70172,70199,27
100,1,Number,13,612.1845,8.18640000000001,70551,70580,29
100,0,blank,0,640.1456,-2.1225,70807,70832,25
100,1,Perfect,12,548.3895,16.6871,70974,71034,60
100,1,Number,13,616.1405,18.1531,71211,71241,30
100,0,blank,0,644.5087,7.6455,71389,71418,29
100,1,Number,13,630.4407,23.3782,71504,71532,28
100,0,blank,0,619.3533,39.5116,71621,71649,28
100,17,"EnteredNumberiscorrect",94,210.9,372.2711,72063,72093,30
100,0,blank,0,278.9176,327.2308,72384,72412,28
100,17,"EnteredNumberiscorrect",94,307.6086,366.5558,72499,72528,29
100,17,printf,92,123.2431,366.7059,73186,73212,26
100,17,printf,92,134.08695,365.2549,73408,73555,147
100,19,printf,98,135.67355,410.99275,73819,73880,61
100,0,blank,0,115.6314,396.8832,74027,74058,31
100,0,blank,0,418.841,420.187,74468,74495,27
100,19,"EnteredNumberisnotaperfect",100,226.0353,418.16375,74643,74704,61
100,0,blank,0,208.9457,392.3201,74994,75023,29
100,19,"EnteredNumberisnotaperfect",100,171.0035,403.864,76146,76175,29
100,0,blank,0,289.5876,432.6749,76443,76472,29
100,19,"EnteredNumberisnotaperfect",100,361.1459,407.6195,76589,76618,29
100,0,blank,0,-350,-105,77078,77237,159
100,0,blank,0,-350,-105,77237,77290,53
100,0,blank,0,162.2867,249.5839,77321,77343,22
100,0,blank,0,-350,-105,77400,77533,133
100,0,blank,0,-350,-105,77586,77724,138
100,0,blank,0,-350,-105,77827,77984,157
100,0,blank,0,-350,-105,78112,78238,126
100,13,i,82,206.919,275.9952,78413,78438,25
100,0,blank,0,199.045,235.0782,78497,78528,31
100,0,blank,0,-350,-105,78648,78756,108
100,10,%,68,174.7477,215.933,78793,78842,49
100,0,blank,0,157.5672,186.0965,79396,79425,29
100,0,blank,0,177.8495,111.8402,79600,79625,25
100,8,i,61,166.9278,166.7188,79774,79804,30
100,0,blank,0,199.3074,118.1645,79863,79892,29
100,0,blank,0,215.8536,139.2529,80010,80040,30
100,7,n,44,179.0393,139.0803,80700,80727,27
100,0,blank,0,207.8588,145.5433,81490,81516,26
100,6,0,35,211.8208,129.6263,81650,81680,30
100,7,;,46,198.3314,147.8835,81708,81793,85
100,0,blank,0,158.9736,173.451833333333,81879,81982,103
100,11,==,74,142.6009,234.0503,82679,82729,50
100,10,%,68,174.8268,216.2313,82779,82809,30
100,0,blank,0,135.568466666667,245.543633333333,82993,83072,79
100,0,blank,0,136.5667,195.27,83961,83986,25
100,8,;,60,149.7595,172.9023,84440,84465,25
100,0,blank,0,153.6578,132.4936,84490,84515,25
100,0,blank,0,179.5644,132.5703,84789,84819,30
100,7,"%d",41,118.7011,155.0807,84937,84967,30
100,7,"%d",41,125.6411,141.498,85059,85089,30
100,0,blank,0,258.1227,152.2641,85754,85779,25
100,0,blank,0,247.3499,191.784,85924,85949,25
100,8,1,58,136.414,174.9355,86055,86080,25
100,0,blank,0,155.9604,181.7417,86187,86217,30
100,0,blank,0,-350,-105,86371,86554,183
100,0,blank,0,-350,-105,86554,86718,164
100,0,blank,0,-350,-105,86718,86797,79
100,0,blank,0,-350,-105,86797,86964,167
100,0,blank,0,189.0698,182.3722,87367,87392,25
100,0,blank,0,-350,-105,87818,87898,80
100,0,blank,0,232.4713,198.9845,87971,87996,25
100,0,blank,0,134.0223,257.16875,88409,88468,59
100,0,blank,0,118.6662,216.5693,88918,88948,30
100,11,==,74,124.062,237.6124,89123,89181,58
100,11,rem,73,108.9576,241.2933,89211,89241,30
100,11,rem,73,98.5053,229.2063,89331,89361,30
100,10,=,66,130.1475,204.607,89540,89571,31
100,0,blank,0,-350,-105,89873,89900,27
100,0,blank,0,66.4549,-103.8276,89926,89951,25
100,0,blank,0,183.6354,210.808,90001,90026,25
100,0,blank,0,190.3519,238.6335,90076,90106,30
100,0,blank,0,175.98885,239.953425,90196,90316,120
100,0,blank,0,222.0377,196.0291,90885,90915,30
100,0,blank,0,216.9638,207.9691,91066,91096,30
100,0,blank,0,187.8957,193.05025,91273,91333,60
100,0,blank,0,162.424933333333,181.269666666667,91392,91482,90
100,0,blank,0,122.7981,184.0447,91542,91572,30
100,10,=,66,131.9778,206.4635,91633,91663,30
100,11,),76,169.1318,241.2086,91994,92024,30
100,0,blank,0,194.11915,229.0701,92114,92175,61
100,0,blank,0,198.9897,247.3286,92237,92267,30
100,0,blank,0,215.3762,233.3297,92628,92657,29
100,11,0,75,160.0687,242.2806,92747,92872,125
100,0,blank,0,-350,-105,93107,93187,80
100,0,blank,0,-350,-105,93276,93380,104
100,0,blank,0,-350,-105,93836,94020,184
100,0,blank,0,-350,-105,94020,94195,175
100,0,blank,0,-350,-105,94195,94361,166
100,0,blank,0,-350,-105,94361,94548,187
100,0,blank,0,-350,-105,94548,94663,115
100,0,blank,0,-350,-105,94663,94780,117
100,0,blank,0,-350,-105,94780,94961,181
100,0,blank,0,-350,-105,94961,95137,176
100,0,blank,0,-350,-105,95137,95319,182
100,0,blank,0,-350,-105,95319,95423,104
100,0,blank,0,-350,-105,95423,95591,168
100,0,blank,0,-350,-105,95591,95754,163
100,0,blank,0,-350,-105,95754,95902,148
100,0,blank,0,158.7672,196.4261,96244,96283,39
100,10,n,67,147.6766,208.3174,96307,96336,29
100,0,blank,0,131.5615,248.0884,96698,96728,30
100,0,blank,0,172.0045,253.3332,96876,96905,29
100,13,=,79,151.6277,279.2464,97328,97357,29
100,0,blank,0,180.2425,283.991633333333,97386,97479,93
100,0,blank,0,158.0418,290.2395,97510,97541,31
100,0,blank,0,174.1843,223.3951,97659,97689,30
100,0,blank,0,136.363433333333,250.672,97718,97806,88
100,0,blank,0,139.8339,267.6143,97893,97923,30
100,0,blank,0,151.341,259.8061,97952,97982,30
100,11,),76,165.4178,235.5457,98012,98041,29
100,0,blank,0,-350,-105,98132,98261,129
100,0,blank,0,-350,-105,98420,98526,106
100,0,blank,0,157.2388,335.6015,98732,98757,25
100,0,blank,0,-350,-105,98848,98899,51
100,0,blank,0,175.5578,290.3456,99000,99025,25
100,0,blank,0,172.8653,331.3006,99050,99075,25
100,0,blank,0,152.9851,324.1771,99132,99161,29
100,0,blank,0,164.9655,325.4665,99283,99313,30
100,0,blank,0,172.4601,324.3223,99584,99614,30
100,0,blank,0,190.2539,180.4204,100000,100030,30
100,7,n,44,179.3648,151.7135,100244,100273,29
100,0,blank,0,214.9414,302.1042,101897,101928,31
100,0,blank,0,203.6834,301.0359,102599,102630,31
100,0,blank,0,214.908,293.0539,102687,102716,29
100,0,blank,0,-350,-105,102956,102981,25
100,0,blank,0,191.9355,302.4391,103157,103187,30
100,0,blank,0,212.4509,293.9179,103490,103519,29
100,0,blank,0,199.5229,295.4112,103549,103578,29
100,0,blank,0,190.1166,345.7942,103637,103669,32
100,0,blank,0,200.3221,292.5081,103942,104002,60
100,0,blank,0,204.2441,245.1577,104424,104453,29
100,0,blank,0,-350,-105,104606,104631,25
100,0,blank,0,189.5955,245.2631,104732,104757,25
100,0,blank,0,-350,-105,104900,105030,130
100,0,blank,0,170.09625,295.154,105058,105107,49
100,0,blank,0,192.1581,257.5208,105134,105164,30
100,0,blank,0,185.7222,299.7416,105284,105314,30
100,11,0,75,155.2342,231.38035,105461,105519,58
100,11,0,75,154.897,236.9442,105605,105634,29
100,0,blank,0,203.4551,279.5115,106064,106091,27
100,0,blank,0,192.35455,264.7041,106383,106442,59
100,11,0,75,154.2883,231.7623,106590,106619,29
100,0,blank,0,138.8528,222.1015,106770,106799,29
100,16,==,89,111.9052,344.036,106920,106948,28
100,17,printf,92,137.3465,372.8576,107130,107158,28
100,0,blank,0,-350,-105,108430,108560,130
100,0,blank,0,-350,-105,108737,108817,80
100,0,blank,0,111.9214,156.9633,109017,109046,29
100,0,blank,0,137.1605,254.1999,109195,109253,58
100,0,blank,0,164.8779,245.4539,109370,109400,30
100,0,blank,0,182.654,172.7971,109489,109519,30
100,0,blank,0,-350,-105,109751,109885,134
100,0,blank,0,-350,-105,109967,110119,152
100,0,blank,0,-350,-105,110119,110214,95
100,7,&,43,167.2286,148.987,110256,110269,13
100,0,blank,0,145.9759,178.75765,110361,110421,60
100,0,blank,0,173.61805,184.08795,110780,110838,58
100,0,blank,0,161.7662,297.0854,110925,110955,30
100,0,blank,0,179.5358,280.4558,112042,112068,26
100,0,blank,0,161.4161,295.5636,112097,112124,27
100,0,blank,0,173.3333,321.92015,112153,112214,61
100,13,+,81,191.6763,280.8849,112984,113025,41
100,0,blank,0,137.4828,244.6865,113563,113592,29
100,11,),76,164.7661,224.7336,113621,113652,31
100,0,blank,0,-350,-105,113800,113982,182
100,0,blank,0,-350,-105,113982,114167,185
100,0,blank,0,-350,-105,114167,114317,150
100,0,blank,0,-350,-105,114317,114508,191
100,0,blank,0,-350,-105,114508,114681,173
100,0,blank,0,-350,-105,114681,114836,155
100,0,blank,0,-350,-105,114836,114982,146
100,0,blank,0,-350,-105,114982,115160,178
100,6,comma,36,148.4871,116.1528,115773,115804,31
100,6,s,33,169.9677,115.0795,116168,116203,35
100,8,i,61,172.2433,172.7637,116383,116413,30
100,8,1,58,141.1029,171.2359,116810,116841,31
100,0,blank,0,140.05744,183.19772,116872,117024,152
100,6,s,33,171.9994,116.3865,117147,117181,34
100,0,blank,0,153.06,149.163,117216,117246,30
100,7,comma,42,150.0272,146.3886,117401,117431,30
100,0,blank,0,-350,-105,117462,117541,79
100,0,blank,0,164.9662,190.658,117566,117591,25
100,0,blank,0,161.5266,204.951,117847,117882,35
100,7,&,43,170.1624,152.9854,117978,118007,29
100,0,blank,0,-350,-105,118308,118437,129
100,10,i,69,187.8196,214.9965,118489,118513,24
100,0,blank,0,190.8976,183.2413,118689,118721,32
100,0,blank,0,262.1255,159.5427,118989,119019,30
100,0,blank,0,244.1673,151.9088,119318,119354,36
100,0,blank,0,185.614,188.5697,119505,119537,32
100,0,blank,0,176.754,181.1392,119566,119596,30
100,0,blank,0,210.2187,145.7529,119806,119837,31
100,7,;,46,200.5988,151.5665,119928,119958,30
100,0,blank,0,619.0797,35.9001,120288,120318,30
100,0,blank,0,281.4942,221.1062,120709,120740,31
100,0,blank,0,292.8571,195.1861,120839,120913,74
100,19,"EnteredNumberisnotaperfect",100,254.71115,407.14935,121568,121628,60
100,0,blank,0,141.0634,184.0628,121870,121901,31
100,10,n,67,144.9831,204.271,121960,121991,31
100,13,s,80,164.8726,272.2105,122588,122618,30
100,11,==,74,141.9392,242.5233,122863,122894,31
100,11,==,74,139.7396,236.7182,122955,122986,31
100,0,blank,0,192.1555,248.502,123139,123169,30
100,13,s,80,165.2419,285.3955,123200,123230,30
100,0,blank,0,163.3894,271.7401,123260,123290,30
100,0,blank,0,259.7036,130.2309,123321,123351,30
100,8,(,55,220.025,170.6223,123924,123954,30
100,8,;,60,285.9773,173.5113,124013,124042,29
100,0,blank,0,-350,-105,124364,124444,80
100,0,blank,0,295.92,244.4996,124678,124708,30
100,0,blank,0,124.525,70.4411,125209,125239,30
100,0,blank,0,-96.4767,-19.2866,125713,125743,30
100,0,blank,0,-126.6808,-14.7157,126135,126166,31
100,0,blank,0,673.7415,-103.96595,126765,126819,54
100,0,blank,0,677.603,-103.9848,127171,127200,29
100,0,blank,0,642.8248,-103.9206,127403,127432,29
100,0,blank,0,675.671666666667,-103.965,127578,127664,86
100,0,blank,0,501.1047,-103.9491,127953,127982,29
100,0,blank,0,528.1487,778.0743,128013,128043,30
100,0,blank,0,489.94575,780.7701,128134,128194,60
100,0,blank,0,522.4583,770.253,128345,128376,31
100,0,blank,0,523.7266,787.0791,128435,128466,31
100,0,blank,0,-350,-105,128849,128957,108
100,1,Number,13,641.766,9.8271,129173,129204,31
100,0,blank,0,135.19735,181.81335,130624,130681,57
100,0,blank,0,190.5264,311.9088,131457,131486,29
100,0,blank,0,152.6949,386.0631,132132,132191,59
100,19,"EnteredNumberisnotaperfect",100,183.165,400.6682,132219,132248,29
100,0,blank,0,161.8441,378.5325,132278,132306,28
100,0,blank,0,162.1645,380.967,132629,132659,30
100,17,"EnteredNumberiscorrect",94,206.697,371.4042,132947,132976,29
100,19,"EnteredNumberisnotaperfect",100,285.1539,402.8702,133122,133152,30
100,0,blank,0,365.2274,376.8801,133355,133383,28
100,0,blank,0,349.97985,444.16265,134278,134339,61
100,17,"EnteredNumberiscorrect",94,401.2438,360.4446,134395,134420,25
100,19,"EnteredNumberisnotaperfect",100,206.3535,406.806,135024,135053,29
100,19,"EnteredNumberisnotaperfect",100,216.1741,416.1151,135171,135200,29
100,19,"EnteredNumberisnotaperfect",100,346.936,413.1225,135549,135576,27
100,0,blank,0,346.2037,463.1782,135719,135747,28
100,0,blank,0,431.8618,431.03875,136021,136145,124
100,19,"EnteredNumberisnotaperfect",100,376.9656,414.6793,136296,136321,25
100,0,blank,0,422.3349,433.5058,136718,136807,89
100,0,blank,0,354.1599,441.6108,137034,137118,84
100,0,blank,0,390.5011,458.6406,137168,137196,28
100,19,"EnteredNumberisnotaperfect",100,386.8347,399.9932,137225,137284,59
100,17,"EnteredNumberiscorrect",94,410.7004,356.4972,137669,137699,30
100,19,(,99,149.0289,402.593,138423,138451,28
100,17,"EnteredNumberiscorrect",94,156.5117,374.4447,138767,138796,29
100,0,blank,0,180.7227,387.2038,139163,139193,30
100,0,blank,0,189.7303,381.7966,139193,139377,184
100,0,blank,0,190.6927,380.4819,139377,139402,25
100,17,"EnteredNumberiscorrect",94,309.406,369.5488,139536,139564,28
100,17,"EnteredNumberiscorrect",94,352.5543,357.8357,139830,139859,29
100,17,"EnteredNumberiscorrect",94,368.7793,356.478,140048,140073,25
100,0,blank,0,220.0325,381.48525,140530,140591,61
100,0,blank,0,283.0514,427.3839,140829,140858,29
100,0,blank,0,390.7441,381.5855,142236,142266,30
100,17,"EnteredNumberiscorrect",94,224.7348,356.5497,142450,142480,30
100,0,blank,0,194.7875,398.5501,142511,142543,32
100,17,"EnteredNumberiscorrect",94,195.1572,363.0162,142661,142691,30
100,0,blank,0,255.7546,383.6285,142752,142783,31
100,0,blank,0,300.1016,391.44155,143026,143086,60
100,19,"EnteredNumberisnotaperfect",100,308.6926,400.6205,143177,143206,29
100,17,"EnteredNumberiscorrect",94,381.3634,375.0683,143448,143479,31
100,0,blank,0,-350,-105,143661,143691,30
100,0,blank,0,601.8293,53.4095,144115,144143,28
100,1,Perfect,12,504.043,11.2376,144346,144376,30
100,0,blank,0,138.6306,21.2066,145245,145273,28
100,0,blank,0,225.14825,12.8279,145475,145534,59
100,1,given,9,361.540466666667,16.3497666666667,145801,145889,88
100,0,blank,0,462.4656,-9.0642,146125,146155,30
100,0,blank,0,458.7518,10.1052,146243,146272,29
100,1,Perfect,12,518.223,14.54,146445,146475,30
100,0,blank,0,-350,-105,147001,147079,78
100,0,blank,0,334.5319,420.3912,147260,147289,29
100,0,blank,0,334.748,444.8282,147380,147410,30
100,0,blank,0,337.382,377.7659,147470,147500,30
100,17,"EnteredNumberiscorrect",94,349.4475,361.5961,147530,147559,29
100,0,blank,0,303.358,429.86,147618,147648,30
100,0,blank,0,342.6086,384.1884,147706,147735,29
100,17,"EnteredNumberiscorrect",94,333.2252,361.4345,147823,147852,29
100,19,"EnteredNumberisnotaperfect",100,387.3141,419.6196,148168,148197,29
100,0,blank,0,401.4604,436.3229,148255,148284,29
100,19,"EnteredNumberisnotaperfect",100,416.6201,413.4271,148492,148522,30
100,0,blank,0,374.7792,392.1194,148872,148932,60
100,0,blank,0,355.5059,398.04335,148957,149013,56
100,0,blank,0,-350,-105,149103,149181,78
100,0,blank,0,157.2622,-103.9022,149207,149233,26
100,19,"EnteredNumberisnotaperfect",100,312.145,412.2565,149386,149416,30
100,17,"EnteredNumberiscorrect",94,322.0176,357.385,149861,149890,29
100,19,"EnteredNumberisnotaperfect",100,271.3488,399.5478,150066,150095,29
100,0,blank,0,352.2661,396.7572,150244,150274,30
100,19,"EnteredNumberisnotaperfect",100,361.0953,410.5505,150657,150686,29
100,19,"EnteredNumberisnotaperfect",100,365.0859,409.4358,150746,150775,29
100,0,blank,0,333.3815,441.3956,150954,150984,30
100,0,blank,0,362.5074,386.04645,151275,151329,54
100,0,blank,0,389.4678,430.09205,152098,152158,60
100,0,blank,0,-350,-105,152337,152418,81
100,17,"EnteredNumberiscorrect",94,300.1422,367.6986,152970,153000,30
100,0,blank,0,325.5859,420.079,153300,153330,30
100,0,blank,0,166.5854,181.9171,153361,153391,30
100,0,blank,0,163.7081,157.9046,153598,153627,29
100,0,blank,0,404.1472,462.9405,153923,153949,26
100,0,blank,0,285.6863,435.9959,154068,154098,30
100,0,blank,0,274.0223,432.9888,154192,154220,28
100,0,blank,0,151.8756,378.5135,154476,154506,30
100,17,printf,92,138.3353,362.5185,154567,154598,31
100,17,printf,92,139.696,360.5438,154688,154718,30
100,11,==,74,140.21045,237.58315,154748,154808,60
100,10,n,67,149.9577,218.5092,154868,154899,31
100,0,blank,0,-350,-105,155166,155270,104
100,7,n,44,175.23585,153.34445,155296,155345,49
100,0,blank,0,174.7489,179.1785,155603,155633,30
100,0,blank,0,-350,-105,155721,155821,100
100,8,<=,54,184.0985,163.6905,155846,155872,26
100,0,blank,0,161.7551,174.5119,155896,155921,25
100,10,%,68,165.6639,219.9206,156246,156277,31
100,0,blank,0,-350,-105,156425,156452,27
100,0,blank,0,102.7766,616.0773,156502,156527,25
100,11,),76,169.7162,240.3156,156664,156693,29
100,0,blank,0,178.35425,225.578,156749,156809,60
100,11,0,75,154.4044,230.0842,156867,156897,30
100,0,blank,0,172.3199,190.7788,156986,157016,30
100,0,blank,0,178.5704,220.269,157164,157224,60
100,0,blank,0,181.7336,211.0192,157429,157458,29
100,0,blank,0,178.6162,238.9784,157487,157517,30
100,0,blank,0,-350,-105,157605,157717,112
100,0,blank,0,177.9889,203.9782,157796,157824,28
100,0,blank,0,169.8131,253.0091,157886,157913,27
100,0,blank,0,200.0336,200.4288,157974,158004,30
100,0,blank,0,198.8137,240.4176,158392,158422,30
100,0,blank,0,204.1378,229.7425,158452,158482,30
100,0,blank,0,-350,-105,158571,158675,104
100,0,blank,0,212.1182,141.9519,158701,158727,26
100,0,blank,0,205.103,178.1399,158751,158776,25
100,7,n,44,182.7389,150.1426,159012,159042,30
100,0,blank,0,154.7641,174.1654,159192,159222,30
100,0,blank,0,188.0744,182.2828,159491,159551,60
100,0,blank,0,145.111333333333,237.012066666667,159939,160033,94
100,0,blank,0,98.3059,250.0245,160128,160160,32
100,11,(,72,76.48995,239.5248,160571,160636,65
100,0,blank,0,78.2533,172.8129,160795,160827,32
100,11,==,74,128.8192,243.7659,161209,161241,32
100,0,blank,0,122.8327,267.963,161465,161497,32
100,13,s,80,165.5217,279.52555,161562,161656,94
100,0,blank,0,126.0529,266.9079,162123,162152,29
100,0,blank,0,119.8474,256.3953,162244,162307,63
100,11,==,74,137.4276,243.7958,162463,162492,29
100,0,blank,0,135.4189,201.9013,162774,162805,31
100,0,blank,0,168.6351,182.8212,163049,163080,31
100,0,blank,0,163.5936,190.3797,163204,163235,31
100,0,blank,0,157.0095,184.0774,163298,163328,30
100,0,blank,0,181.0266,211.4909,163485,163513,28
100,0,blank,0,172.0054,200.1616,163545,163577,32
100,0,blank,0,-350,-105,163699,163881,182
100,0,blank,0,-350,-105,163881,164061,180
100,0,blank,0,-350,-105,164061,164224,163
100,0,blank,0,-350,-105,164224,164414,190
100,0,blank,0,-350,-105,164414,164555,141
100,0,blank,0,-350,-105,164555,164811,256
100,0,blank,0,-350,-105,164811,165065,254
100,0,blank,0,-350,-105,165065,165247,182
100,0,blank,0,-350,-105,165247,165435,188
100,0,blank,0,-350,-105,165435,165611,176
100,0,blank,0,-350,-105,165611,165798,187
100,0,blank,0,-350,-105,165798,165922,124
100,0,blank,0,-350,-105,165922,166054,132
100,0,blank,0,-350,-105,166054,166352,298
100,0,blank,0,-350,-105,166352,166550,198
100,0,blank,0,-350,-105,166550,166696,146
100,0,blank,0,175.7981,237.3074,167002,167028,26
100,7,"%d",41,123.1642,140.1823,167362,167387,25
100,10,n,67,145.0858,209.894,167586,167611,25
100,0,blank,0,170.868,265.4846,167689,167720,31
100,13,s,80,165.8875,279.1417,167843,167874,31
100,0,blank,0,-350,-105,167935,167965,30
100,0,blank,0,-350,-105,168040,168214,174
100,0,blank,0,-350,-105,168214,168357,143
100,0,blank,0,-350,-105,168357,168424,67
100,0,blank,0,-350,-105,168540,168717,177
100,0,blank,0,-350,-105,168717,168854,137
100,0,blank,0,-350,-105,168854,168990,136
100,0,blank,0,-350,-105,168990,169174,184
100,0,blank,0,-350,-105,169174,169325,151
100,0,blank,0,-350,-105,169325,169429,104
100,0,blank,0,-350,-105,169429,169527,98
100,0,blank,0,-350,-105,169527,169719,192
100,0,blank,0,-350,-105,169719,169913,194
100,0,blank,0,-350,-105,169913,170094,181
100,0,blank,0,-350,-105,170094,170158,64
100,0,blank,0,-350,-105,170158,170358,200
100,0,blank,0,-350,-105,170358,170404,46
100,0,blank,0,-350,-105,170404,170608,204
100,0,blank,0,-350,-105,170608,170818,210
100,0,blank,0,-350,-105,170818,171034,216
100,0,blank,0,-350,-105,171034,171217,183
100,0,blank,0,-350,-105,171217,171281,64
100,0,blank,0,-350,-105,171281,171573,292
100,0,blank,0,-350,-105,171573,171867,294
100,0,blank,0,-350,-105,171867,172160,293
100,0,blank,0,-350,-105,172160,172340,180
100,0,blank,0,-350,-105,172340,172371,31
100,0,blank,0,-350,-105,172371,172793,422
100,0,blank,0,-350,-105,172793,173046,253
100,0,blank,0,-350,-105,173046,173416,370
100,0,blank,0,-350,-105,173416,173553,137
100,0,blank,0,-350,-105,173553,173742,189
100,0,blank,0,-350,-105,173742,173929,187
100,0,blank,0,-350,-105,173929,174241,312
100,0,blank,0,-350,-105,174241,174428,187
100,0,blank,0,-350,-105,174428,174612,184
100,0,blank,0,-350,-105,174612,174649,37
100,0,blank,0,-350,-105,174649,174819,170
100,0,blank,0,-350,-105,174819,174947,128
100,0,blank,0,-350,-105,174947,175063,116
100,0,blank,0,-350,-105,175063,175405,342
100,0,blank,0,-350,-105,175405,175604,199
100,0,blank,0,-350,-105,175604,175699,95
100,0,blank,0,-350,-105,175699,175873,174
100,0,blank,0,-350,-105,175873,175934,61
100,0,blank,0,-350,-105,175934,176280,346
100,0,blank,0,-350,-105,176280,176394,114
100,0,blank,0,-350,-105,176806,176857,51
100,0,blank,0,-350,-105,177428,177651,223
100,0,blank,0,-350,-105,178022,178106,84
100,0,blank,0,-350,-105,178183,178378,195
100,0,blank,0,-350,-105,178378,178558,180
100,0,blank,0,-350,-105,178558,178736,178
100,0,blank,0,-350,-105,178736,178927,191
100,0,blank,0,-350,-105,178927,179116,189
100,0,blank,0,-350,-105,179116,179303,187
100,0,blank,0,-350,-105,179303,179342,39
100,11,==,74,134.542,224.51805,179696,179758,62
100,0,blank,0,122.7219,295.2904,179943,179974,31
100,11,==,74,133.759,237.28035,180219,180279,60
100,0,blank,0,132.3686,199.9951,180463,180524,61
100,8,=,50,113.226,171.36495,180646,180708,62
100,0,blank,0,122.46445,178.525925,180801,180923,122
100,11,0,75,153.6802,231.377,181102,181132,30
100,0,blank,0,179.2258,234.9052,181255,181285,30
100,0,blank,0,-350,-105,181346,181530,184
100,0,blank,0,-350,-105,181530,181716,186
100,0,blank,0,-350,-105,181716,181894,178
100,0,blank,0,-350,-105,181894,182032,138
100,0,blank,0,-350,-105,182032,182182,150
100,0,blank,0,-350,-105,182182,182412,230
100,0,blank,0,-350,-105,182412,182596,184
100,0,blank,0,-350,-105,182596,182778,182
100,0,blank,0,-350,-105,182778,182916,138
100,0,blank,0,-350,-105,182916,183096,180
100,0,blank,0,-350,-105,183096,183290,194
100,0,blank,0,-350,-105,183290,183489,199
100,0,blank,0,-350,-105,183489,183656,167
100,0,blank,0,-350,-105,183656,183831,175
100,0,blank,0,-350,-105,183831,183987,156
100,0,blank,0,-350,-105,183987,184205,218
100,0,blank,0,-350,-105,184274,184384,110
100,0,blank,0,112.94295,255.7927,184545,184603,58
100,0,blank,0,130.3104,289.7146,184663,184692,29
100,0,blank,0,-350,-105,184780,184883,103
100,11,0,75,154.4406,225.7638,185143,185173,30
100,0,blank,0,-350,-105,185234,185263,29
100,11,0,75,162.9103,223.4569,185388,185414,26
100,0,blank,0,156.7933,222.3957,185537,185565,28
100,10,n,67,143.0675,220.9353,185625,185656,31
100,0,blank,0,135.4319,245.1025,185806,185836,30
100,0,blank,0,150.9514,271.2194,185898,185928,30
100,10,%,68,164.5074,216.1594,186201,186230,29
100,0,blank,0,146.4874,247.1337,186380,186410,30
100,0,blank,0,152.9735,232.7021,186499,186530,31
100,11,0,75,156.3075,237.2917,186560,186591,31
100,0,blank,0,-350,-105,186652,186682,30
100,0,blank,0,160.485,250.6815,186783,186809,26
100,0,blank,0,159.3832,222.8559,186832,186858,26
100,0,blank,0,-350,-105,187196,187382,186
100,0,blank,0,-350,-105,187382,187551,169
100,0,blank,0,-350,-105,187551,187711,160
100,0,blank,0,-350,-105,187711,187900,189
100,0,blank,0,-350,-105,187900,188075,175
100,0,blank,0,-350,-105,188075,188197,122
100,0,blank,0,-350,-105,188197,188684,487
100,0,blank,0,-350,-105,188684,188836,152
100,0,blank,0,-350,-105,188836,188975,139
100,0,blank,0,-350,-105,188975,189130,155
100,0,blank,0,-350,-105,189130,189340,210
100,0,blank,0,139.0035,113.6404,189996,190021,25
100,0,blank,0,-350,-105,190254,190431,177
100,0,blank,0,-350,-105,190431,190608,177
100,0,blank,0,-350,-105,190608,190787,179
100,0,blank,0,-350,-105,190787,190962,175
100,0,blank,0,-350,-105,190962,191066,104
100,0,blank,0,-350,-105,191066,191171,105
100,0,blank,0,-350,-105,191171,191348,177
100,0,blank,0,-350,-105,191348,191738,390
100,0,blank,0,-350,-105,191738,192053,315
100,0,blank,0,-350,-105,192053,192233,180
100,0,blank,0,-350,-105,192233,192410,177
100,0,blank,0,-350,-105,192410,192588,178
100,0,blank,0,-350,-105,192588,192766,178
100,0,blank,0,-350,-105,192766,192820,54
100,0,blank,0,-350,-105,192820,192994,174
100,0,blank,0,-350,-105,192994,193100,106
100,0,blank,0,-350,-105,193100,193519,419
100,0,blank,0,-350,-105,193519,193641,122
100,0,blank,0,-350,-105,193641,193838,197
100,0,blank,0,-350,-105,193838,193983,145
100,0,blank,0,-350,-105,193983,194163,180
100,0,blank,0,-350,-105,194163,194291,128
100,0,blank,0,-350,-105,194291,194385,94
100,0,blank,0,-350,-105,194385,194540,155
100,0,blank,0,-350,-105,194540,194734,194
100,0,blank,0,-350,-105,194734,194912,178
100,0,blank,0,-350,-105,194912,195093,181
100,0,blank,0,-350,-105,195093,195286,193
100,0,blank,0,-350,-105,195286,195483,197
100,0,blank,0,-350,-105,195483,195680,197
100,0,blank,0,-350,-105,195680,195832,152
100,0,blank,0,-350,-105,195832,195992,160
100,0,blank,0,-350,-105,195992,196245,253
100,0,blank,0,-350,-105,196245,196439,194
100,0,blank,0,-350,-105,196439,196633,194
100,0,blank,0,-350,-105,196633,196817,184
100,0,blank,0,-350,-105,196817,197005,188
100,0,blank,0,-350,-105,197005,197036,31
100,0,blank,0,-350,-105,197036,197220,184
100,0,blank,0,-350,-105,197220,197312,92
100,0,blank,0,-350,-105,197312,197466,154
100,0,blank,0,-350,-105,197466,197657,191
100,0,blank,0,-350,-105,197657,197832,175
100,0,blank,0,-350,-105,197832,198005,173
100,0,blank,0,-350,-105,198005,198045,40
100,0,blank,0,127.8527,490.143,198227,198254,27
100,0,blank,0,104.0144,539.5178,198285,198314,29
100,0,blank,0,200.9486,242.198,198763,198788,25
100,0,blank,0,-350,-105,198813,199003,190
100,0,blank,0,-350,-105,199003,199180,177
100,0,blank,0,-350,-105,199180,199354,174
100,0,blank,0,-350,-105,199354,199393,39
100,0,blank,0,-350,-105,199393,199634,241
100,0,blank,0,-350,-105,199938,200168,230
100,0,blank,0,-350,-105,200168,200607,439
100,0,blank,0,-350,-105,200607,200743,136
100,19,(,99,152.2519,407.6583,201022,201046,24
100,19,printf,98,144.8735,418.0162,201106,201136,30
100,0,blank,0,167.1607,389.2511,201166,201195,29
100,0,blank,0,142.3574,430.504,201226,201256,30
100,0,blank,0,693.9345,-10.3656,201813,201870,57
100,1,/,15,672.253,10.7994,201927,201956,29
100,0,blank,0,712.351,8.84229999999999,201987,202014,27
100,0,blank,0,199.1489,110.56295,203046,203106,60
100,0,blank,0,179.546,178.967,203569,203626,57
100,0,blank,0,202.5942,214.968,203657,203684,27
100,0,blank,0,223.7787,192.8614,203825,203854,29
100,0,blank,0,152.2714,315.2037,204187,204217,30
100,0,blank,0,217.0399,340.4029,204449,204478,29
100,17,"EnteredNumberiscorrect",94,207.0563,362.7938,204507,204537,30
100,19,"EnteredNumberisnotaperfect",100,251.9824,414.6896,204684,204713,29
100,0,blank,0,175.0394,297.4789,205654,205681,27
100,11,0,75,159.5226,229.9971,205976,206032,56
100,0,blank,0,156.3655,197.2841,206245,206270,25
100,10,i,69,188.7762,214.6059,206512,206542,30
100,0,blank,0,186.9576,255.0584,206571,206599,28
100,0,blank,0,-350,-105,206818,206919,101
100,0,blank,0,-350,-105,207156,207293,137
100,0,blank,0,199.7404,226.0796,207675,207704,29
100,0,blank,0,190.6832,199.1145,207820,207849,29
100,8,1,58,139.0409,161.7393,207965,207994,29
100,0,blank,0,154.2648,177.2461,209727,209755,28
100,0,blank,0,159.7843,212.4915,210127,210157,30
100,10,;,70,200.8292,207.5448,210447,210476,29
100,7,n,44,183.3992,147.2994,211751,211780,29
100,8,i,61,164.3405,165.7568,211957,211986,29
100,0,blank,0,317.36945,135.0519,212389,212448,59
100,0,blank,0,285.2007,138.6621,212623,212652,29
100,0,blank,0,235.6336,191.0225,212943,212972,29
100,0,blank,0,235.28975,193.9946,213176,213233,57
100,0,blank,0,242.424,195.7618,213469,213499,30
100,0,blank,0,262.5305,179.458,213615,213643,28
100,8,-,57,248.1444,175.4551,213672,213702,30
100,8,1,58,266.351,167.322,213878,213907,29
100,0,blank,0,256.41775,189.6548,213967,214028,61
100,0,blank,0,-350,-105,214120,214307,187
100,0,blank,0,-350,-105,214307,214460,153
100,0,blank,0,-350,-105,214460,214595,135
100,0,blank,0,-350,-105,214595,214789,194
100,0,blank,0,-350,-105,214789,214979,190
100,0,blank,0,-350,-105,214979,215098,119
100,0,blank,0,-350,-105,215098,215234,136
100,0,blank,0,-350,-105,215234,215410,176
100,0,blank,0,-350,-105,215410,215581,171
100,0,blank,0,-350,-105,215581,215761,180
100,0,blank,0,-350,-105,215761,215945,184
100,0,blank,0,-350,-105,215945,216122,177
100,0,blank,0,-350,-105,216122,216304,182
100,0,blank,0,-350,-105,216304,216461,157
100,0,blank,0,-350,-105,216461,216508,47
100,0,blank,0,-350,-105,216508,216688,180
100,0,blank,0,-350,-105,216688,216887,199
100,0,blank,0,-350,-105,216887,217063,176
100,0,blank,0,-350,-105,217063,217142,79
100,0,blank,0,-350,-105,217142,217294,152
100,10,=,66,123.5162,216.97385,217890,217949,59
100,11,==,74,138.6669,231.8315,218039,218070,31
100,11,==,74,140.1708,226.1108,218401,218427,26
100,11,==,74,128.0259,226.5989,218486,218517,31
100,0,blank,0,137.6719,247.8704,218763,218794,31
100,0,blank,0,140.2783,216.9282,218825,218856,31
100,0,blank,0,-350,-105,219069,219170,101
100,0,blank,0,183.3278,224.9097,219309,219334,25
100,0,blank,0,-350,-105,219457,219642,185
100,0,blank,0,-350,-105,219642,219824,182
100,0,blank,0,-350,-105,219824,219996,172
100,0,blank,0,-350,-105,219996,220180,184
100,0,blank,0,-350,-105,220180,220283,103
100,0,blank,0,-350,-105,220283,220418,135
100,0,blank,0,-350,-105,220418,220613,195
100,0,blank,0,-350,-105,220613,220781,168
100,0,blank,0,-350,-105,220781,220961,180
100,0,blank,0,-350,-105,220961,221112,151
100,0,blank,0,-350,-105,221112,221231,119
100,0,blank,0,-350,-105,221231,221361,130
100,0,blank,0,-350,-105,221361,221501,140
100,0,blank,0,-350,-105,221501,221675,174
100,0,blank,0,-350,-105,221675,221807,132
100,0,blank,0,-350,-105,221807,221970,163
100,0,blank,0,-350,-105,221970,222057,87
100,0,blank,0,-350,-105,222057,222178,121
100,0,blank,0,-350,-105,222178,222346,168
100,0,blank,0,-350,-105,224237,224431,194
100,0,blank,0,-350,-105,224431,224609,178
100,0,blank,0,-350,-105,224609,224776,167
100,0,blank,0,-350,-105,224776,224940,164
100,0,blank,0,-350,-105,224940,225088,148
100,0,blank,0,-350,-105,225088,225207,119
100,0,blank,0,-350,-105,225207,225427,220
100,0,blank,0,-350,-105,225427,225569,142
100,11,0,75,155.1349,229.9527,226010,226036,26
100,0,blank,0,205.9222,326.3087,226910,226935,25
100,0,blank,0,184.4872,306.4906,226985,227011,26
100,0,blank,0,196.8731,352.4165,227277,227304,27
100,0,blank,0,185.2877,398.4277,227441,227466,25
100,17,"EnteredNumberiscorrect",94,286.7652,361.4473,228627,228653,26
100,0,blank,0,-350,-105,228779,228959,180
100,0,blank,0,-350,-105,228959,229139,180
100,0,blank,0,-350,-105,229139,229336,197
100,0,blank,0,-350,-105,229336,229513,177
100,0,blank,0,-350,-105,229513,229575,62
100,0,blank,0,-350,-105,229575,229824,249
100,0,blank,0,-350,-105,229824,230075,251
100,0,blank,0,-350,-105,230075,230261,186
100,0,blank,0,-350,-105,230261,230441,180
100,0,blank,0,-350,-105,230441,230617,176
100,0,blank,0,-350,-105,230910,231100,190
100,0,blank,0,-350,-105,231100,231282,182
100,0,blank,0,-350,-105,231282,231412,130
100,0,blank,0,-350,-105,231412,231578,166
100,0,blank,0,-350,-105,231578,231768,190
100,0,blank,0,-350,-105,231768,231926,158
100,0,blank,0,-350,-105,231926,232097,171
100,0,blank,0,-350,-105,232097,232133,36
100,0,blank,0,-350,-105,232133,232332,199
100,0,blank,0,-350,-105,232332,232517,185
