Frameno_fix,lineno_fix,Tokenname_fix,tokens_id,gaze_X_fix,gaze_Y_fix,timestamp_fix_start,timestamp_fix_end,time_duration
100,0,blank,0,55.6232,110.2928,2940,2972,32
100,0,blank,0,38.2497,-62.4724,3099,3215,116
100,0,blank,0,115.6626,-27.1012,3257,3333,76
100,0,blank,0,714.883,110.7222,3540,3615,75
100,0,blank,0,-350,-105,3690,3867,177
100,0,blank,0,-350,-105,3867,4046,179
100,0,blank,0,-350,-105,4046,4243,197
100,0,blank,0,-350,-105,4243,4421,178
100,0,blank,0,-350,-105,4421,4447,26
100,0,blank,0,431.6392,38.251,4649,4688,39
100,0,blank,0,265.5616,79.0193,4721,4762,41
100,0,blank,0,259.4777,62.8617,4795,4828,33
100,0,blank,0,581.1522,21.6829,4901,4943,42
100,0,blank,0,-350,-105,5116,5255,139
100,0,blank,0,-350,-105,5255,5355,100
100,0,blank,0,593.3201,44.96785,5416,5505,89
100,0,blank,0,622.45888,33.02788,5565,5715,150
100,1,Number,13,642.7379,15.0757,5715,5770,55
100,0,blank,0,643.1192,68.8471333333333,5849,5927,78
100,1,Number,13,602.513266666667,16.3479333333333,5927,6110,183
100,0,blank,0,-350,-105,6187,6365,178
100,0,blank,0,618.9751,-38.9335,6579,6618,39
100,0,blank,0,-350,-105,6801,6982,181
100,0,blank,0,-350,-105,6982,7171,189
100,0,blank,0,-350,-105,7171,7327,156
100,0,blank,0,-350,-105,7327,7522,195
100,0,blank,0,-350,-105,7522,7706,184
100,0,blank,0,-350,-105,7706,7738,32
100,0,blank,0,-350,-105,7828,7916,88
100,0,blank,0,-350,-105,8011,8040,29
100,0,blank,0,101.57155,-103.95995,8065,8134,69
100,0,blank,0,25.3968,-103.8619,8277,8307,30
100,0,blank,0,172.45965,-103.9217,8435,8526,91
100,0,blank,0,203.2932,-103.9698,8526,8763,237
100,0,blank,0,203.2932,-103.9698,8763,8788,25
100,0,blank,0,-350,-105,8836,8861,25
100,0,blank,0,199.1548,-103.9606,8886,8912,26
100,0,blank,0,-350,-105,8936,9113,177
100,0,blank,0,-350,-105,9113,9293,180
100,0,blank,0,-350,-105,9293,9462,169
100,0,blank,0,-350,-105,9462,9620,158
100,0,blank,0,-350,-105,9620,9699,79
100,0,blank,0,63.50265,-2.7437,9734,9806,72
100,0,blank,0,-350,-105,9884,10078,194
100,0,blank,0,-350,-105,10078,10258,180
100,0,blank,0,-350,-105,10258,10445,187
100,0,blank,0,-350,-105,10445,10612,167
100,2,include,17,46.3443,39.01335,10781,10859,78
100,1,*,14,19.75748,22.65112,10932,11110,178
100,2,include,17,51.642,38.1411,11110,11178,68
100,0,blank,0,104.238871428571,48.4523857142857,11206,11403,197
100,2,include,17,50.35025,34.5949666666667,11403,11577,174
100,2,include,17,29.145875,31.74415,11577,11696,119
100,0,blank,0,-350,-105,11726,11910,184
100,0,blank,0,-350,-105,11910,12091,181
100,0,blank,0,-350,-105,12091,12282,191
100,0,blank,0,-350,-105,12282,12460,178
100,0,blank,0,-350,-105,12460,12635,175
100,0,blank,0,-350,-105,12635,12813,178
100,0,blank,0,-350,-105,12813,12989,176
100,0,blank,0,-350,-105,12989,13166,177
100,0,blank,0,-350,-105,13166,13348,182
100,0,blank,0,-350,-105,13348,13528,180
100,0,blank,0,-350,-105,13528,13711,183
100,0,blank,0,-350,-105,13711,13890,179
100,0,blank,0,-350,-105,13890,14081,191
100,0,blank,0,-350,-105,14081,14251,170
100,0,blank,0,-350,-105,14251,14427,176
100,0,blank,0,-350,-105,14427,14598,171
100,0,blank,0,-350,-105,14598,14755,157
100,0,blank,0,-350,-105,14755,14853,98
100,0,blank,0,-350,-105,14853,15047,194
100,0,blank,0,-350,-105,15047,15237,190
100,0,blank,0,-350,-105,15237,15416,179
100,0,blank,0,-350,-105,15416,15615,199
100,0,blank,0,-350,-105,15615,15794,179
100,0,blank,0,-350,-105,15794,15990,196
100,0,blank,0,-350,-105,15990,16179,189
100,0,blank,0,-350,-105,16179,16370,191
100,0,blank,0,-350,-105,16370,16550,180
100,0,blank,0,-350,-105,16550,16654,104
100,0,blank,0,161.3518,-38.87595,16688,16772,84
100,1,C,3,47.9066666666667,5.49326666666667,16927,17085,158
100,0,blank,0,184.7353,33.5026,17167,17419,252
100,0,blank,0,198.952633333333,67.2626,17419,17618,199
100,0,blank,0,229.3446,51.153,17618,17768,150
100,0,blank,0,-350,-105,17792,17969,177
100,0,blank,0,-350,-105,17969,18151,182
100,0,blank,0,-350,-105,18151,18228,77
100,0,blank,0,156.5034,2.7711,18253,18277,24
100,0,blank,0,605.666,-105.0014,18388,18430,42
100,0,blank,0,685.0901,-35.5631666666667,18504,18611,107
100,0,blank,0,707.284,-60.6101333333333,18686,18802,116
100,0,blank,0,126.5581,61.57625,18835,18917,82
100,1,to,5,145.6119,21.1807,18917,19041,124
100,0,blank,0,202.02525,131.5659,19095,19177,82
100,0,blank,0,211.4041,104.95695,19177,19327,150
100,0,blank,0,302.2329,394.9568,19352,19434,82
100,0,blank,0,163.97125,55.64375,19538,19688,150
100,0,blank,0,193.5211,48.54785,19688,19840,152
100,2,>,22,177.01625,27.43455,19840,20015,175
100,0,blank,0,222.6792,33.2453,20015,20040,25
100,0,blank,0,118.3529,-16.558,20141,20241,100
100,1,Program,4,121.8509,17.7681,20275,20324,49
100,1,C,3,53.355175,14.8589,20399,20598,199
100,0,blank,0,48.3039666666667,62.5742666666667,20598,20759,161
100,0,blank,0,48.7815,52.88152,20759,20958,199
100,4,main,24,56.4813428571429,73.5228714285714,20958,21155,197
100,4,(,25,85.6389666666667,81.3835666666667,21155,21327,172
100,0,blank,0,99.6715166666667,93.8476833333333,21327,21498,171
100,0,blank,0,102.74175,108.190075,21498,21614,116
100,0,blank,0,-350,-105,21670,21748,78
100,0,blank,0,150.3348,770.4314,21773,21798,25
100,7,scanf,39,79.2565142857143,136.094114285714,21848,22037,189
100,0,blank,0,78.43735,125.842,22037,22211,174
100,7,"%d",41,108.270933333333,140.05955,22211,22383,172
100,7,"%d",41,115.491233333333,140.564516666667,22383,22555,172
100,6,rem,31,133.279871428571,131.112757142857,22555,22752,197
100,7,"%d",41,133.785133333333,136.481166666667,22752,22837,85
100,0,blank,0,215.5323,75.9739,23056,23084,28
100,6,s,33,165.1816,125.7682,23141,23169,28
100,0,blank,0,229.395966666667,180.741566666667,23196,23286,90
100,8,;,60,151.0374,159.774142857143,23313,23511,198
100,7,&,43,162.713466666667,149.83545,23511,23683,172
100,7,"%d",41,131.54745,148.4778,23683,23740,57
100,7,scanf,39,87.9150166666667,143.1812,23824,23999,175
100,10,rem,65,100.63425,207.37425,23999,24056,57
100,0,blank,0,79.2287333333333,177.98915,24085,24261,176
100,7,comma,42,151.22175,155.356033333333,24261,24433,172
100,0,blank,0,215.5891,334.0571,24491,24602,111
100,7,comma,42,150.94482,140.2298,24629,24781,152
100,7,"%d",41,135.819766666667,152.582233333333,24843,24931,88
100,7,;,46,194.835075,148.8064,24963,25074,111
100,0,blank,0,162.7634,183.1306,25105,25138,33
100,8,<=,54,194.97045,162.92455,25165,25224,59
100,0,blank,0,204.17335,183.402275,25253,25426,173
100,0,blank,0,154.6635,130.02835,25426,25607,181
100,0,blank,0,162.460825,190.14705,25607,25784,177
100,0,blank,0,175.5208,296.8076,25784,25815,31
100,0,blank,0,-350,-105,25842,26021,179
100,0,blank,0,156.896571428571,158.845128571429,26046,26243,197
100,0,blank,0,197.6464,191.851033333333,26243,26410,167
100,0,blank,0,107.9107,196.2188,26436,26464,28
100,0,blank,0,148.6053,188.7337,26495,26523,28
100,0,blank,0,185.2139,250.6472,26582,26609,27
100,0,blank,0,189.3655,295.782,26642,26669,27
100,7,"%d",41,117.2478,149.2287,26724,26749,25
100,7,comma,42,144.935366666667,154.547766666667,26835,26950,115
100,8,(,55,219.3629,161.4195,26981,27099,118
100,6,=,34,184.54455,129.154075,27218,27338,120
100,7,),45,191.1609,138.4727,27367,27399,32
100,8,n,56,223.003733333333,176.315083333333,27457,27629,172
100,0,blank,0,193.593814285714,180.458185714286,27629,27827,198
100,8,-,57,244.543883333333,176.601966666667,27827,28001,174
100,0,blank,0,242.309,204.868,28001,28029,28
100,7,),45,191.240716666667,139.053566666667,28058,28230,172
100,0,blank,0,158.224233333333,147.65365,28230,28403,173
100,8,i,61,167.979716666667,171.7312,28488,28667,179
100,0,blank,0,155.351575,173.925825,28667,28781,114
100,0,blank,0,106.351933333333,162.303266666667,28809,28898,89
100,0,blank,0,-350,-105,28984,29115,131
100,7,"%d",41,115.820542857143,151.719871428571,29226,29421,195
100,10,=,66,124.796871428571,207.748557142857,29421,29618,197
100,0,blank,0,157.23935,179.946,29618,29729,111
100,0,blank,0,163.7995,188.826333333333,29758,29843,85
100,0,blank,0,238.7855,239.9583,29875,29962,87
100,0,blank,0,262.2774,269.5125,30016,30048,32
100,8,<=,54,194.0694,160.776828571429,30075,30271,196
100,0,blank,0,-350,-105,30328,30442,114
100,7,scanf,39,61.6768142857143,155.9127,30553,30749,196
100,8,for,47,62.4051833333333,164.747833333333,30749,30925,176
100,0,blank,0,60.0425,180.056916666667,30925,31101,176
100,8,for,47,56.1713,174.796966666667,31101,31275,174
100,8,for,47,46.2673833333333,176.093633333333,31275,31448,173
100,8,for,47,48.32895,173.551533333333,31448,31624,176
100,8,for,47,50.7431666666667,161.9836,31624,31802,178
100,8,for,47,48.0282666666667,172.636133333333,31802,31982,180
100,8,for,47,50.3213166666667,169.058016666667,31982,32164,182
100,8,for,47,67.901,170.561266666667,32164,32348,184
100,8,for,47,71.79415,163.68185,32348,32532,184
100,0,blank,0,78.1307666666667,168.16815,32532,32721,189
100,0,blank,0,77.2008,159.541866666667,32721,32914,193
100,0,blank,0,79.8698166666667,163.792633333333,32914,33107,193
100,8,for,47,51.34182,164.71086,33107,33274,167
100,8,for,47,46.4945,162.322983333333,33274,33472,198
100,8,for,47,59.3861166666667,166.000466666667,33472,33659,187
100,0,blank,0,101.510233333333,190.64555,33659,33844,185
100,0,blank,0,110.910316666667,174.472933333333,33844,34024,180
100,8,;,60,151.474533333333,165.643666666667,34024,34199,175
100,0,blank,0,152.559233333333,142.771833333333,34199,34373,174
100,0,blank,0,103.572633333333,178.31825,34373,34550,177
100,8,1,58,142.2202,164.096783333333,34550,34725,175
100,7,comma,42,151.455616666667,155.3955,34725,34901,176
100,0,blank,0,163.406566666667,169.388583333333,34901,35083,182
100,0,blank,0,176.059433333333,168.373266666667,35083,35262,179
100,8,<=,54,187.349166666667,164.997166666667,35262,35438,176
100,8,<=,54,193.340316666667,164.645466666667,35438,35619,181
100,0,blank,0,207.2817,173.804083333333,35619,35797,178
100,0,blank,0,240.108883333333,179.105233333333,35797,35979,182
100,8,n,56,232.8942,175.510133333333,35979,36159,180
100,0,blank,0,223.3099,187.824833333333,36159,36340,181
100,8,n,56,227.849383333333,175.067583333333,36340,36511,171
100,0,blank,0,260.919533333333,188.14105,36511,36686,175
100,0,blank,0,292.17295,176.475,36686,36863,177
100,8,i,61,313.5185,166.24345,36863,37037,174
100,0,blank,0,294.203666666667,178.81145,37037,37211,174
100,0,blank,0,183.609933333333,204.964283333333,37211,37379,168
100,8,=,50,118.77345,169.1622,37404,37517,113
100,17,printf,92,96.5734,364.837733333333,37543,37705,162
100,18,else,97,78.9609,386.712433333333,37705,37873,168
100,10,rem,65,113.471683333333,216.374733333333,38135,38310,175
100,11,rem,73,104.692714285714,223.777485714286,38310,38505,195
100,10,rem,65,112.636833333333,203.614616666667,38505,38679,174
100,0,blank,0,127.060233333333,196.833366666667,38679,38856,177
100,0,blank,0,155.122333333333,189.76625,38856,39030,174
100,0,blank,0,154.805171428571,200.130785714286,39030,39225,195
100,0,blank,0,140.5764,207.315633333333,39225,39402,177
100,10,rem,65,102.1871,203.574433333333,39402,39587,185
100,0,blank,0,104.07125,221.40385,39587,39770,183
100,0,blank,0,133.36105,222.978483333333,39770,39951,181
100,0,blank,0,173.0736,236.10555,39951,40133,182
100,0,blank,0,171.706433333333,221.14005,40133,40315,182
100,0,blank,0,176.503216666667,222.4072,40315,40494,179
100,11,),76,172.1383,230.266283333333,40494,40673,179
100,0,blank,0,176.738066666667,222.49015,40673,40851,178
100,0,blank,0,173.900233333333,221.710983333333,40851,41034,183
100,10,%,68,172.9446,216.181016666667,41034,41217,183
100,0,blank,0,141.996566666667,201.526133333333,41217,41403,186
100,0,blank,0,132.976566666667,193.961216666667,41403,41584,181
100,0,blank,0,149.864866666667,195.221283333333,41584,41766,182
100,0,blank,0,165.810516666667,222.917683333333,41766,41945,179
100,11,),76,166.179533333333,223.2481,41945,42124,179
100,0,blank,0,160.388233333333,221.7311,42124,42302,178
100,11,0,75,154.556766666667,242.751683333333,42302,42479,177
100,0,blank,0,143.25435,245.1587,42479,42657,178
100,0,blank,0,-350,-105,42687,42793,106
100,0,blank,0,158.5791,213.0788,42824,42866,42
100,11,0,75,156.1511,241.751642857143,42927,43126,199
100,0,blank,0,135.322066666667,267.185816666667,43126,43301,175
100,0,blank,0,142.53905,261.564983333333,43301,43480,179
100,12,{,77,91.7701166666667,257.80385,43480,43660,180
100,0,blank,0,106.81105,252.422066666667,43660,43839,179
100,11,rem,73,103.966633333333,243.25865,43839,44020,181
100,0,blank,0,63.9851666666667,251.778783333333,44020,44201,181
100,0,blank,0,96.273,245.009,44201,44381,180
100,0,blank,0,113.536116666667,250.676133333333,44381,44561,180
100,0,blank,0,139.586116666667,249.8121,44561,44741,180
100,0,blank,0,143.761666666667,249.241816666667,44741,44918,177
100,0,blank,0,150.927683333333,244.827833333333,44918,45096,178
100,10,i,69,190.52405,216.648266666667,45096,45272,176
100,11,),76,168.444833333333,233.112266666667,45272,45447,175
100,0,blank,0,152.779716666667,248.316216666667,45447,45629,182
100,0,blank,0,139.170125,269.25195,45629,45779,150
100,0,blank,0,93.7085,262.2779,45779,45975,196
100,0,blank,0,84.507,266.942566666667,45975,46163,188
100,0,blank,0,103.841516666667,250.648866666667,46163,46342,179
100,0,blank,0,128.538433333333,256.2316,46342,46462,120
100,13,s,80,133.05938,286.58418,46550,46726,176
100,0,blank,0,141.7683,294.3622,46726,46908,182
100,0,blank,0,162.271883333333,293.836116666667,46908,47086,178
100,13,s,80,173.341583333333,286.93095,47086,47261,175
100,0,blank,0,187.34765,300.059083333333,47261,47437,176
100,0,blank,0,195.8952,300.3708,47437,47613,176
100,0,blank,0,167.21655,295.480316666667,47613,47788,175
100,0,blank,0,180.876275,256.964725,47788,47906,118
100,0,blank,0,258.939883333333,291.977216666667,47970,48142,172
100,0,blank,0,263.8245,232.4059,48200,48260,60
100,0,blank,0,153.02095,301.28965,48374,48434,60
100,0,blank,0,223.071875,480.7924,48464,48581,117
100,0,blank,0,205.3655,257.18435,48721,48890,169
100,0,blank,0,234.9657,226.148066666667,48890,49011,121
100,0,blank,0,205.7756,227.2795,49093,49256,163
100,10,%,68,163.424366666667,209.809633333333,49256,49377,121
100,0,blank,0,206.98458,58.50886,49418,49605,187
100,0,blank,0,177.65745,101.66565,49605,49798,193
100,0,blank,0,169.5906,79.8696,49798,49884,86
100,2,stdio,19,116.901,41.4267,49913,49972,59
100,1,whether,7,275.391725,7.60865,50144,50263,119
100,0,blank,0,337.94545,31.3083,50291,50438,147
100,0,blank,0,323.405675,25.64675,50438,50580,142
100,0,blank,0,353.383914285714,37.9503285714286,50607,50802,195
100,0,blank,0,301.2955,45.4942333333333,50802,50980,178
100,0,blank,0,224.55838,85.15752,51009,51180,171
100,0,blank,0,218.267633333333,50.1552333333333,51180,51269,89
100,0,blank,0,210.5715,52.984,51357,51417,60
100,0,blank,0,382.192616666667,84.6479666666667,51478,51660,182
100,0,blank,0,387.486283333333,66.4317666666667,51660,51842,182
100,0,blank,0,384.065566666667,147.042883333333,51842,52023,181
100,0,blank,0,347.480166666667,217.5144,52023,52111,88
100,0,blank,0,282.324283333333,229.214283333333,52200,52377,177
100,0,blank,0,250.31552,190.82806,52377,52524,147
100,0,blank,0,240.9713,150.04115,52524,52607,83
100,0,blank,0,215.312166666667,239.739566666667,52665,52803,138
100,0,blank,0,180.58715,75.11915,52832,52944,112
100,0,blank,0,186.36035,41.72785,53003,53059,56
100,0,blank,0,-350,-105,53264,53449,185
100,0,blank,0,-350,-105,53449,53504,55
100,0,blank,0,144.0397,222.12286,53600,53777,177
100,0,blank,0,167.830225,201.457475,53807,53925,118
100,7,n,44,176.2411,136.19965,53925,54122,197
100,0,blank,0,201.43574,180.77212,54122,54298,176
100,0,blank,0,126.0581,200.75432,54298,54475,177
100,0,blank,0,108.851625,248.119725,54475,54648,173
100,0,blank,0,110.8995,254.819525,54648,54796,148
100,11,rem,73,88.68926,243.10766,54796,54971,175
100,0,blank,0,111.145266666667,285.792933333333,54971,55148,177
100,13,=,79,144.728025,275.08465,55179,55299,120
100,0,blank,0,190.2065,199.7278,55330,55358,28
100,0,blank,0,133.0777,254.138433333333,55388,55566,178
100,0,blank,0,103.73286,182.68484,55566,55740,174
100,8,;,60,145.75952,162.57716,55740,55914,174
100,6,rem,31,138.29575,131.965225,55914,56091,177
100,7,"%d",41,131.1968,144.1272,56091,56120,29
100,11,==,74,138.2946,242.3633,56149,56178,29
100,0,blank,0,161.47415,198.8506,56236,56300,64
100,0,blank,0,129.2286,292.24212,56329,56485,156
100,0,blank,0,168.7812,252.04172,56485,56664,179
100,0,blank,0,369.5762,320.97005,56745,56800,55
100,0,blank,0,371.78325,260.2794,56830,56888,58
100,0,blank,0,494.629466666667,263.9009,56949,57139,190
100,0,blank,0,491.8565,332.0072,57197,57224,27
100,0,blank,0,352.671,289.3257,57309,57338,29
100,0,blank,0,264.71815,314.6303,57396,57450,54
100,0,blank,0,272.69985,231.5369,57479,57566,87
100,0,blank,0,204.8919,225.51485,57623,57737,114
100,0,blank,0,185.8153,201.316166666667,57737,57906,169
100,0,blank,0,173.6139,245.02605,57906,57963,57
100,13,s,80,165.59725,275.881975,58020,58165,145
100,13,s,80,172.9996,277.6976,58165,58224,59
100,0,blank,0,298.6367,210.6167,58713,58742,29
100,0,blank,0,286.0919,269.5302,58802,58829,27
100,0,blank,0,328.4964,277.0367,58916,58942,26
100,0,blank,0,-350,-105,59001,59180,179
100,0,blank,0,-350,-105,59180,59226,46
100,0,blank,0,442.94945,304.685583333333,59352,59531,179
100,0,blank,0,206.817475,311.027775,59560,59678,118
100,13,=,79,147.67665,284.28535,59708,59766,58
100,0,blank,0,175.826,313.63456,59943,60116,173
100,0,blank,0,141.5472,264.068275,60257,60449,192
100,0,blank,0,102.3277,295.219766666667,60449,60564,115
100,0,blank,0,-350,-105,60677,60836,159
100,0,blank,0,135.0063,270.6477,60973,61065,92
100,0,blank,0,179.828516666667,163.220316666667,61093,61273,180
100,6,=,34,187.82415,116.20135,61273,61331,58
100,0,blank,0,156.900566666667,114.847666666667,61361,61539,178
100,0,blank,0,146.3363,96.9005,61539,61570,31
100,0,blank,0,146.9944,307.3097,61600,61633,33
100,10,=,66,130.017633333333,209.369733333333,61748,61918,170
100,13,=,79,146.14565,272.60885,61918,61977,59
100,7,&,43,173.7626,149.0466,62007,62098,91
100,0,blank,0,184.8658,99.57425,62191,62250,59
100,0,blank,0,194.2806,94.8344,62309,62466,157
100,0,blank,0,201.70925,89.8214,62466,62644,178
100,0,blank,0,213.7462,71.8776,62644,62818,174
100,1,whether,7,277.013216666667,23.00935,62818,62998,180
100,0,blank,0,239.88352,70.76074,62998,63147,149
100,6,=,34,187.942233333333,132.0165,63147,63269,122
100,0,blank,0,217.14935,45.8570833333333,63298,63478,180
100,0,blank,0,258.00705,26.76495,63507,63693,186
100,1,Check,6,203.108233333333,17.35825,63693,63869,176
100,0,blank,0,249.465725,-6.677725,63898,64022,124
100,0,blank,0,229.39382,35.32758,64082,64230,148
100,0,blank,0,269.832066666667,26.0997666666667,64290,64475,185
100,0,blank,0,245.52436,42.37108,64504,64679,175
100,0,blank,0,242.327,32.5471,64679,64738,59
100,0,blank,0,-350,-105,64819,64972,153
100,8,<=,54,201.5496,172.5377,65111,65194,83
100,10,n,67,147.02165,203.66945,65222,65393,171
100,0,blank,0,109.5345,264.4381,65393,65452,59
100,0,blank,0,105.1028,93.0485,65509,65540,31
100,0,blank,0,75.56585,287.1381,65600,65788,188
100,0,blank,0,95.305525,288.6252,65788,65954,166
100,0,blank,0,180.7125,254.3546,65954,66016,62
100,0,blank,0,-350,-105,66316,66422,106
100,0,blank,0,186.3254,180.0035,66510,66555,45
100,0,blank,0,224.383875,139.367875,66748,66859,111
100,0,blank,0,212.6878,167.8747,66919,67009,90
100,0,blank,0,-350,-105,67071,67236,165
100,0,blank,0,-350,-105,67236,67389,153
100,0,blank,0,202.1493,244.197866666667,67421,67500,79
100,0,blank,0,203.164816666667,211.305966666667,67529,67723,194
100,10,%,68,171.45482,217.44758,67723,67904,181
100,0,blank,0,201.1945,187.593616666667,67904,68088,184
100,0,blank,0,183.596166666667,195.155033333333,68088,68180,92
100,0,blank,0,241.6624,36.5903,68211,68242,31
100,0,blank,0,195.810866666667,189.018133333333,68274,68462,188
100,0,blank,0,230.45666,198.927,68462,68611,149
100,8,n,56,225.50145,165.4542,68642,68816,174
100,6,0,35,209.396533333333,116.172283333333,68816,69001,185
100,0,blank,0,217.186933333333,85.8630166666667,69001,69193,192
100,0,blank,0,264.903183333333,64.7888166666667,69193,69376,183
100,0,blank,0,260.936566666667,48.0178,69376,69467,91
100,0,blank,0,247.2816,143.3338,69497,69527,30
100,0,blank,0,207.334916666667,236.837683333333,69557,69738,181
100,0,blank,0,212.72815,201.9439,69738,69799,61
100,0,blank,0,180.80048,266.64116,69830,70000,170
100,0,blank,0,174.78645,257.59545,70000,70085,85
100,0,blank,0,150.73185,254.90165,70255,70339,84
100,11,==,74,142.05825,241.15785,70549,70629,80
100,0,blank,0,232.6567,255.23494,70711,70890,179
100,0,blank,0,230.749333333333,237.9851,70890,71067,177
100,0,blank,0,199.46984,232.43498,71067,71213,146
100,0,blank,0,219.16492,322.31918,71243,71392,149
100,17,"EnteredNumberiscorrect",94,213.22235,365.610183333333,71422,71598,176
100,0,blank,0,219.587116666667,345.373316666667,71598,71773,175
100,0,blank,0,216.92408,342.87868,71773,71944,171
100,0,blank,0,220.239133333333,227.80155,71944,72119,175
100,8,(,55,215.776275,177.141425,72119,72235,116
100,0,blank,0,299.047625,244.84765,72292,72413,121
100,0,blank,0,261.64575,185.9217,72443,72504,61
100,0,blank,0,285.491283333333,224.307333333333,72567,72748,181
100,0,blank,0,305.3724,232.0514,72748,72778,30
100,0,blank,0,308.3084,394.3755,72837,72868,31
100,19,"EnteredNumberisnotaperfect",100,327.0468,408.7341,72897,72954,57
100,7,"%d",41,131.15465,155.18275,73149,73227,78
100,10,rem,65,95.4597,206.1444,73306,73345,39
100,13,=,79,145.70985,286.0487,73459,73539,80
100,11,==,74,130.7412,239.16,73622,73664,42
100,0,blank,0,123.0606,76.136,73791,73832,41
100,0,blank,0,-350,-105,73867,74047,180
100,0,blank,0,-350,-105,74047,74214,167
100,0,blank,0,-350,-105,74214,74252,38
100,0,blank,0,210.708266666667,135.374466666667,74279,74385,106
100,0,blank,0,213.0468,96.9403,74496,74577,81
100,0,blank,0,203.5094,178.04335,74634,74690,56
100,0,blank,0,223.0536,122.817966666667,74719,74891,172
100,6,0,35,204.2872,116.341475,74891,75010,119
100,0,blank,0,147.380733333333,223.169966666667,75253,75370,117
100,0,blank,0,-350,-105,75409,75606,197
100,0,blank,0,-350,-105,75606,75785,179
100,0,blank,0,-350,-105,75785,75975,190
100,0,blank,0,-350,-105,75975,76119,144
100,0,blank,0,240.674575,149.320775,76133,76296,163
100,0,blank,0,300.1813,125.4712,76296,76336,40
100,7,"%d",41,117.15615,140.875483333333,76515,76700,185
100,0,blank,0,-350,-105,76728,76894,166
100,0,blank,0,94.6623,150.763142857143,76922,77118,196
100,0,blank,0,43.5257166666667,149.442416666667,77118,77290,172
100,0,blank,0,16.2978166666667,151.25165,77290,77461,171
100,7,scanf,39,49.0044333333333,149.056966666667,77461,77633,172
100,0,blank,0,113.459033333333,104.9876,77633,77805,172
100,0,blank,0,102.534633333333,132.487216666667,77805,77979,174
100,0,blank,0,100.994366666667,156.46375,77979,78151,172
100,7,scanf,39,81.9396666666667,139.4955,78151,78324,173
100,0,blank,0,84.8498166666667,108.235516666667,78324,78498,174
100,7,scanf,39,65.6892833333333,153.027783333333,78498,78674,176
100,6,int,28,59.9312833333333,125.101533333333,78674,78851,177
100,0,blank,0,18.3191,130.404933333333,78851,79025,174
100,5,{,27,5.29963333333333,97.8652333333333,79025,79198,173
100,0,blank,0,-2.8935,101.682333333333,79198,79372,174
100,0,blank,0,-26.6626666666667,115.0529,79372,79546,174
100,0,blank,0,-23.0939666666667,116.050166666667,79546,79722,176
100,0,blank,0,18.5123333333333,108.945966666667,79722,79896,174
100,0,blank,0,70.4305666666667,92.3919166666667,79896,80070,174
100,7,"%d",41,119.063816666667,135.116416666667,80070,80244,174
100,7,"%d",41,136.94235,147.8243,80244,80419,175
100,7,comma,42,145.394866666667,143.3638,80419,80592,173
100,0,blank,0,154.349966666667,123.855833333333,80592,80770,178
100,0,blank,0,154.311966666667,137.9072,80770,80945,175
100,7,scanf,39,67.60072,153.68962,80945,81092,147
100,0,blank,0,5.73188333333331,127.560166666667,81121,81295,174
100,5,{,27,5.81206666666667,107.9799,81295,81467,172
100,0,blank,0,-45.6268666666667,101.3152,81467,81643,176
100,0,blank,0,-13.74805,138.387816666667,81643,81816,173
100,0,blank,0,9.03988333333334,163.699883333333,81816,81991,175
100,0,blank,0,-8.5738,120.49795,81991,82169,178
100,0,blank,0,5.78173333333334,139.826766666667,82169,82343,174
100,7,scanf,39,59.4245,145.135016666667,82343,82516,173
100,6,int,28,59.7892666666667,123.927133333333,82516,82688,172
100,0,blank,0,96.7787333333333,106.446766666667,82688,82862,174
100,4,(,25,88.08602,78.61812,82862,83038,176
100,0,blank,0,101.972383333333,133.093116666667,83038,83213,175
100,7,scanf,39,73.7714,153.7286,83213,83241,28
100,0,blank,0,-350,-105,83299,83451,152
100,0,blank,0,34.6990166666667,117.103633333333,83624,83795,171
100,6,int,28,48.3217833333333,115.72845,83795,83968,173
100,0,blank,0,27.6103166666667,138.357133333333,83968,84141,173
100,0,blank,0,14.0299,131.977771428571,84141,84340,199
100,0,blank,0,12.4647833333333,151.93055,84340,84511,171
100,0,blank,0,-9.83751428571428,112.889542857143,84511,84710,199
100,0,blank,0,4.00863333333333,116.647416666667,84710,84881,171
100,0,blank,0,34.4411857142857,111.615814285714,84881,85080,199
100,7,(,40,102.381216666667,138.338316666667,85080,85252,172
100,0,blank,0,112.1648,44.1023,85252,85281,29
100,0,blank,0,106.0886,133.7959,85310,85339,29
100,0,blank,0,16.10945,238.45175,85368,85547,179
100,0,blank,0,-9.42695000000001,290.79435,85547,85721,174
100,0,blank,0,-7.99766666666666,314.21425,85721,85895,174
100,0,blank,0,12.4007,347.0043,85895,86069,174
100,0,blank,0,6.52063333333334,377.197666666667,86069,86245,176
100,0,blank,0,4.49891666666664,399.593333333333,86245,86417,172
100,0,blank,0,18.7382,352.7775,86417,86567,150
100,0,blank,0,-27.8731,318.09345,86567,86764,197
100,0,blank,0,-23.3452,335.4205,86764,86939,175
100,0,blank,0,-20.54418,324.66314,86939,87112,173
100,0,blank,0,-5.87618333333333,328.6661,87112,87286,174
100,0,blank,0,0.111100000000003,342.8688,87286,87461,175
100,0,blank,0,-9.94886666666667,326.914033333333,87461,87636,175
100,0,blank,0,1.2838,297.822583333333,87636,87820,184
100,0,blank,0,19.9753,212.836616666667,87820,87999,179
100,0,blank,0,27.2808166666667,201.11515,87999,88172,173
100,11,if,71,49.1867,235.983433333333,88201,88380,179
100,0,blank,0,63.47056,211.09812,88380,88529,149
100,8,for,47,43.1367,170.0851,88529,88589,60
100,6,comma,36,98.19002,132.22774,88614,88758,144
100,0,blank,0,-350,-105,88816,88993,177
100,0,blank,0,-350,-105,88993,89045,52
100,0,blank,0,54.6012857142857,181.243342857143,89071,89264,193
100,8,for,47,55.1010333333333,160.931933333333,89264,89439,175
100,6,int,28,46.9499166666667,132.621016666667,89439,89613,174
100,0,blank,0,9.87123333333332,139.844533333333,89613,89786,173
100,0,blank,0,31.31805,164.497125,89786,89901,115
100,0,blank,0,76.5033,180.9069,89901,90108,207
100,0,blank,0,27.7759666666667,128.101283333333,90108,90293,185
100,0,blank,0,42.8392666666667,159.871066666667,90293,90467,174
100,6,int,28,45.6920166666667,120.76685,90467,90642,175
100,0,blank,0,37.6785833333333,123.588483333333,90642,90816,174
100,6,int,28,50.58145,128.881566666667,90816,90989,173
100,6,int,28,69.7104,116.9336,90989,91018,29
100,0,blank,0,-7.76975000000001,118.216916666667,91047,91221,174
100,5,{,27,5.82003999999999,108.92732,91221,91368,147
100,6,int,28,48.2032166666667,117.221833333333,91397,91574,177
100,7,scanf,39,65.33695,146.35245,91574,91633,59
100,6,int,28,55.34485,118.80935,91663,91838,175
100,6,int,28,61.89015,126.83305,91838,92012,174
100,7,scanf,39,51.5124285714286,145.917028571429,92012,92211,199
100,7,scanf,39,45.92435,143.923383333333,92211,92386,175
100,0,blank,0,11.1471333333333,141.832683333333,92386,92563,177
100,0,blank,0,10.7449,134.6632,92563,92622,59
100,0,blank,0,-350,-105,92681,92815,134
100,0,blank,0,0.361500000000001,96.91784,92933,93087,154
100,0,blank,0,-26.0911,123.63635,93116,93291,175
100,0,blank,0,-31.4310833333333,161.758633333333,93291,93465,174
100,0,blank,0,-38.0307833333333,128.5533,93465,93638,173
100,0,blank,0,2.86603333333334,120.523033333333,93638,93812,174
100,0,blank,0,-4.81746666666667,75.9922666666667,93812,93987,175
100,0,blank,0,9.1761,115.965483333333,93987,94162,175
100,0,blank,0,17.6299833333333,120.68515,94162,94336,174
100,0,blank,0,41.6973333333333,121.1715,94336,94510,174
100,7,scanf,39,47.9075166666667,155.023116666667,94510,94685,175
100,8,for,47,51.8672666666667,174.783816666667,94685,94860,175
100,0,blank,0,12.2752666666667,159.564366666667,94860,95035,175
100,0,blank,0,-350,-105,95093,95245,152
100,0,blank,0,-3.98155714285715,160.111871428571,95350,95547,197
100,0,blank,0,15.3335333333333,148.718966666667,95547,95721,174
100,0,blank,0,9.49316666666667,164.3699,95721,95896,175
100,0,blank,0,10.3766666666667,150.960183333333,95896,96070,174
100,0,blank,0,35.4504,139.187283333333,96070,96243,173
100,0,blank,0,23.6180833333333,154.633566666667,96243,96419,176
100,7,scanf,39,44.9784,141.76748,96419,96593,174
100,4,main,24,59.6272,89.4331,96593,96620,27
100,8,(,55,85.8244,173.2924,96677,96707,30
100,0,blank,0,80.3019333333333,93.2127833333333,96736,96910,174
100,0,blank,0,76.76755,121.50225,96910,97087,177
100,8,for,47,48.2738666666667,159.910233333333,97087,97264,177
100,8,for,47,65.27265,161.161016666667,97264,97440,176
100,7,scanf,39,73.16055,136.623916666667,97440,97615,175
100,7,(,40,101.539566666667,144.886333333333,97615,97792,177
100,0,blank,0,29.3776666666667,130.817116666667,97792,97968,176
100,0,blank,0,23.8044,156.783083333333,97968,98145,177
100,0,blank,0,24.8078333333333,159.461133333333,98145,98321,176
100,0,blank,0,5.49345,155.54485,98321,98497,176
100,0,blank,0,26.8322333333333,130.686516666667,98497,98673,176
100,0,blank,0,22.6903,148.964716666667,98673,98847,174
100,0,blank,0,36.5234833333333,133.2882,98847,99023,176
100,6,int,28,47.7883666666667,123.054033333333,99023,99197,174
100,0,blank,0,59.73206,97.33286,99197,99343,146
100,6,int,28,54.0182,132.594633333333,99372,99549,177
100,0,blank,0,32.0281666666667,140.16255,99549,99724,175
100,0,blank,0,24.7335,108.46402,99724,99870,146
100,0,blank,0,94.8404,93.12765,99900,100075,175
100,0,blank,0,134.86025,90.82005,100075,100134,59
100,0,blank,0,-350,-105,100189,100340,151
100,0,blank,0,-350,-105,100340,100405,65
100,0,blank,0,300.6339,-21.56865,100566,100646,80
100,2,h,21,171.78438,34.95886,100675,100822,147
100,0,blank,0,193.468425,-21.03045,100822,101002,180
100,0,blank,0,172.508833333333,0.0197166666666675,101033,101214,181
100,2,>,22,182.220166666667,32.0735,101214,101304,90
100,0,blank,0,142.2763,8.2928,101363,101423,60
100,7,comma,42,149.5305,142.60925,101483,101546,63
100,1,Program,4,119.748875,20.53285,101575,101753,178
100,1,Program,4,126.85625,14.9331333333333,101753,101928,175
100,0,blank,0,132.4677,-37.5022,101928,101957,29
100,0,blank,0,127.204766666667,-3.78036666666667,101986,102076,90
100,0,blank,0,156.69012,1.70754,102139,102322,183
100,0,blank,0,162.25165,25.4850833333333,102322,102505,183
100,1,Check,6,178.18345,17.70925,102505,102569,64
100,0,blank,0,256.53215,-1.7737,102603,102664,61
100,0,blank,0,271.1631,-33.9243666666667,102694,102874,180
100,0,blank,0,275.635475,-49.706875,102874,102995,121
100,0,blank,0,-350,-105,103086,103277,191
100,0,blank,0,243.686433333333,-28.2059,103416,103501,85
100,0,blank,0,226.27596,19.40488,103531,103720,189
100,0,blank,0,248.990116666667,47.7633166666667,103720,103902,182
100,0,blank,0,239.6517,49.4767,103902,104080,178
100,0,blank,0,219.164133333333,73.0891333333333,104080,104169,89
100,6,i,37,241.818866666667,118.701433333333,104169,104353,184
100,0,blank,0,241.02874,65.74886,104353,104526,173
100,0,blank,0,285.397,61.9113333333333,104526,104645,119
100,1,whether,7,259.008525,17.85655,104674,104791,117
100,0,blank,0,297.2247,67.3774,104822,104999,177
100,0,blank,0,295.948533333333,81.36875,104999,105177,178
100,0,blank,0,277.84272,42.08598,105177,105351,174
100,0,blank,0,246.67465,83.7854833333333,105381,105564,183
100,0,blank,0,251.447,146.2617,105564,105594,30
100,0,blank,0,226.718833333333,64.1822333333333,105625,105807,182
100,0,blank,0,320.205916666667,95.96975,105807,105988,181
100,0,blank,0,320.800333333333,106.8011,105988,106080,92
100,0,blank,0,193.759183333333,76.1331333333333,106110,106290,180
100,0,blank,0,186.6024,80.40688,106290,106439,149
100,0,blank,0,136.4546,-43.5822,106439,106498,59
100,0,blank,0,205.127,72.94535,106530,106589,59
100,0,blank,0,264.423,-33.249,106619,106649,30
100,0,blank,0,255.18245,97.6271,106678,106736,58
100,0,blank,0,265.00052,70.02478,106766,106936,170
100,0,blank,0,260.11274,81.9357,107294,107451,157
100,0,blank,0,224.540833333333,47.3303666666667,107507,107684,177
100,0,blank,0,209.225583333333,76.7169833333333,107684,107870,186
100,0,blank,0,174.0945,105.7716,107870,107897,27
100,0,blank,0,200.42405,36.377,107927,107987,60
100,0,blank,0,155.561125,57.53875,108047,108223,176
100,0,blank,0,159.4948,57.1197,108223,108248,25
100,1,Check,6,182.168166666667,4.43846666666667,108397,108512,115
100,0,blank,0,179.7196,111.4762,108537,108594,57
100,0,blank,0,-350,-105,108625,108808,183
100,0,blank,0,-350,-105,108808,108856,48
100,0,blank,0,203.990971428571,104.537385714286,108990,109186,196
100,0,blank,0,210.411825,71.47965,109186,109355,169
100,0,blank,0,230.28415,70.2325,109355,109522,167
100,0,blank,0,218.07545,62.5833,109522,109680,158
100,0,blank,0,212.93582,92.37906,109732,109901,169
100,0,blank,0,225.740125,10.966475,109901,110044,143
100,0,blank,0,187.3561,53.77408,110044,110221,177
100,0,blank,0,227.6686,40.46528,110221,110401,180
100,0,blank,0,295.0066,55.8063,110401,110458,57
100,0,blank,0,305.8188,36.7063333333333,110515,110632,117
100,1,whether,7,235.159775,18.427675,110713,110853,140
100,0,blank,0,232.23875,-36.6183,110853,110990,137
100,0,blank,0,231.15762,58.77228,111043,111236,193
100,0,blank,0,232.782233333333,55.86775,111236,111415,179
100,0,blank,0,275.71918,49.80958,111415,111595,180
100,0,blank,0,292.6602,121.133,111595,111625,30
100,0,blank,0,254.2837,56.582,111654,111827,173
100,0,blank,0,201.678233333333,47.3925833333333,111827,112023,196
100,6,=,34,183.9385,116.6371,112023,112051,28
100,0,blank,0,201.561966666667,48.8767,112080,112279,199
100,0,blank,0,199.332,57.7656833333333,112279,112477,198
100,0,blank,0,199.170825,25.47045,112477,112670,193
100,0,blank,0,203.5889,52.0816,112670,112865,195
100,0,blank,0,230.3261,-0.803399999999996,112865,112891,26
100,0,blank,0,204.8728,55.1031,112891,113102,211
100,1,Check,6,180.208,11.9223,113102,113207,105
100,0,blank,0,242.7002,63.9537,113236,113264,28
100,0,blank,0,181.6907,50.83122,113323,113495,172
100,0,blank,0,198.24225,79.2765833333333,113495,113672,177
100,0,blank,0,-350,-105,113730,113903,173
100,0,blank,0,-350,-105,113903,114020,117
100,0,blank,0,153.34525,134.6632,114053,114102,49
100,1,Check,6,182.520966666667,11.7565,114131,114219,88
100,0,blank,0,207.24488,98.93638,114249,114427,178
100,0,blank,0,206.232175,99.5776,114427,114571,144
100,0,blank,0,216.0758,95.96785,114571,114690,119
100,6,0,35,210.45196,114.19354,114746,114921,175
100,6,=,34,193.735425,116.370825,114921,115067,146
100,0,blank,0,176.0331,25.4255,115125,115156,31
100,0,blank,0,157.2664,95.1783,115187,115249,62
100,0,blank,0,-350,-105,115315,115510,195
100,0,blank,0,-350,-105,115510,115687,177
100,0,blank,0,-350,-105,115687,115870,183
100,0,blank,0,-350,-105,115870,115977,107
100,0,blank,0,-350,-105,116022,116202,180
100,0,blank,0,-350,-105,116202,116377,175
100,0,blank,0,-350,-105,116377,116554,177
100,0,blank,0,-350,-105,116554,116729,175
100,0,blank,0,256.640125,168.032275,116746,116919,173
100,8,),63,275.030525,163.084025,116919,117083,164
100,0,blank,0,339.358375,151.43505,117083,117245,162
100,0,blank,0,357.0294,87.0723,117245,117286,41
100,0,blank,0,-350,-105,117326,117524,198
100,0,blank,0,-350,-105,117524,117703,179
100,0,blank,0,-350,-105,117703,117887,184
100,0,blank,0,-350,-105,117887,118084,197
100,0,blank,0,-350,-105,118084,118171,87
100,0,blank,0,288.541525,137.345525,118203,118378,175
100,0,blank,0,270.64114,183.69598,118378,118558,180
100,0,blank,0,277.440833333333,180.793633333333,118558,118741,183
100,0,blank,0,274.6012,184.568725,118741,118863,122
100,0,blank,0,385.383033333333,218.936833333333,118926,119106,180
100,0,blank,0,406.0847,211.76845,119106,119226,120
100,0,blank,0,234.482916666667,215.033816666667,119256,119443,187
100,0,blank,0,243.24795,212.107733333333,119443,119630,187
100,0,blank,0,229.64345,227.84,119630,119816,186
100,0,blank,0,252.714133333333,213.921066666667,119816,119999,183
100,0,blank,0,236.01515,227.383533333333,119999,120182,183
100,0,blank,0,192.5407,250.08005,120182,120363,181
100,0,blank,0,193.81155,271.898283333333,120363,120541,178
100,0,blank,0,172.511733333333,266.031466666667,120541,120629,88
100,0,blank,0,226.9104,269.3759,120722,120751,29
100,0,blank,0,265.3268,289.132533333333,120780,120864,84
100,19,"EnteredNumberisnotaperfect",100,263.64374,405.06294,120949,121091,142
100,0,blank,0,156.2766,282.146933333333,121119,121294,175
100,13,=,79,150.854033333333,284.410166666667,121294,121469,175
100,0,blank,0,136.8886,252.2494,121469,121527,58
100,0,blank,0,242.680775,303.180825,121559,121671,112
100,0,blank,0,207.555625,255.18025,121700,121812,112
100,0,blank,0,184.587975,245.07525,121841,121955,114
100,11,),76,164.67805,228.3656,122016,122076,60
100,0,blank,0,-350,-105,122140,122321,181
100,0,blank,0,-350,-105,122321,122357,36
100,0,blank,0,182.872066666667,217.405166666667,122383,122459,76
100,0,blank,0,175.400433333333,229.345816666667,122521,122703,182
100,0,blank,0,163.382366666667,255.127716666667,122703,122876,173
100,0,blank,0,166.102283333333,264.280383333333,122876,123053,177
100,0,blank,0,198.755525,261.9896,123053,123173,120
100,0,blank,0,128.7501,456.9106,123314,123341,27
100,0,blank,0,203.4227,272.6017,123436,123461,25
100,11,rem,73,86.9927,233.5802,123529,123602,73
100,11,0,75,155.015825,239.836475,123646,123805,159
100,0,blank,0,110.9261,252.2493,123805,123846,41
100,10,=,66,134.8672,220.9763,123927,124007,80
100,0,blank,0,208.43215,174.8086,124085,124169,84
100,0,blank,0,252.00042,308.89626,124209,124376,167
100,0,blank,0,253.7463,269.98095,124468,124554,86
100,0,blank,0,241.59706,274.4934,124604,124794,190
100,0,blank,0,237.326966666667,280.648916666667,124794,124980,186
100,0,blank,0,267.3578,319.756566666667,124980,125121,141
100,0,blank,0,235.78952,259.69754,125121,125300,179
100,0,blank,0,248.67285,276.7072,125300,125483,183
100,0,blank,0,233.42838,267.67154,125483,125660,177
100,0,blank,0,307.04535,342.48355,125688,125822,134
100,19,"EnteredNumberisnotaperfect",100,263.887433333333,416.145533333333,125822,125972,150
100,0,blank,0,266.1241,304.5048,126103,126128,25
100,0,blank,0,357.837925,448.63035,126189,126323,134
100,0,blank,0,-350,-105,126409,126572,163
100,0,blank,0,-350,-105,126572,126751,179
100,0,blank,0,-350,-105,126751,126934,183
100,0,blank,0,-350,-105,126934,127112,178
100,0,blank,0,-350,-105,127112,127296,184
100,0,blank,0,-350,-105,127296,127376,80
100,0,blank,0,226.818033333333,290.598766666667,127636,127752,116
100,0,blank,0,255.5514,242.5311,127752,127958,206
100,0,blank,0,251.3069,228.973985714286,127958,128145,187
100,0,blank,0,248.9424,220.2462,128145,128328,183
100,0,blank,0,242.300514285714,238.287714285714,128328,128518,190
100,0,blank,0,257.79688,257.64904,128518,128683,165
100,0,blank,0,-350,-105,128767,128945,178
100,0,blank,0,-350,-105,128945,128970,25
100,0,blank,0,240.301,208.913625,129045,129230,185
100,0,blank,0,229.856083333333,225.3999,129230,129418,188
100,0,blank,0,254.0994,243.50048,129418,129587,169
100,0,blank,0,190.864966666667,222.366283333333,129738,129917,179
100,0,blank,0,260.91548,253.81368,129917,130084,167
100,0,blank,0,-350,-105,130142,130320,178
100,0,blank,0,-350,-105,130320,130499,179
100,0,blank,0,-350,-105,130499,130687,188
100,0,blank,0,-350,-105,130687,130866,179
100,0,blank,0,178.48225,292.83385,130881,131006,125
100,0,blank,0,224.5524,279.6431,131089,131161,72
100,0,blank,0,159.0379,282.97088,131230,131395,165
100,0,blank,0,-350,-105,131462,131645,183
100,0,blank,0,175.41855,229.61135,131786,131887,101
100,0,blank,0,275.305,295.584283333333,131931,132119,188
100,0,blank,0,292.8845,340.2572,132119,132148,29
100,0,blank,0,275.773966666667,267.64555,132176,132347,171
100,0,blank,0,250.80534,258.188,132347,132490,143
100,0,blank,0,232.48885,224.479775,132546,132660,114
100,0,blank,0,266.204171428571,261.779114285714,132688,132886,198
100,0,blank,0,262.709228571429,300.102728571429,132886,133085,199
100,0,blank,0,272.494266666667,295.258616666667,133085,133258,173
100,0,blank,0,269.601316666667,289.31895,133258,133431,173
100,0,blank,0,268.23085,288.902133333333,133431,133606,175
100,0,blank,0,279.74255,308.401783333333,133606,133780,174
100,0,blank,0,268.055116666667,291.73695,133780,133951,171
100,0,blank,0,224.708733333333,287.6369,133951,134039,88
100,0,blank,0,259.9093,280.534233333333,134039,134221,182
100,0,blank,0,268.902542857143,224.881657142857,134221,134416,195
100,0,blank,0,255.864266666667,205.12305,134416,134590,174
100,0,blank,0,254.522666666667,156.8544,134590,134763,173
100,0,blank,0,235.353516666667,146.192216666667,134763,134936,173
100,0,blank,0,263.818316666667,224.05055,134936,135109,173
100,0,blank,0,275.2108,276.669833333333,135109,135195,86
100,0,blank,0,-350,-105,135224,135404,180
100,0,blank,0,-350,-105,135404,135583,179
100,0,blank,0,-350,-105,135583,135775,192
100,0,blank,0,-350,-105,135775,135947,172
100,0,blank,0,98.5545714285714,263.7035,136053,136246,193
100,0,blank,0,116.049671428571,271.738428571429,136246,136443,197
100,13,s,80,125.562471428571,277.629014285714,136443,136640,197
100,0,blank,0,135.152514285714,306.9542,136640,136834,194
100,0,blank,0,-350,-105,136888,137064,176
100,0,blank,0,-350,-105,137064,137115,51
100,0,blank,0,143.362957142857,263.834,137140,137323,183
100,11,==,74,141.753614285714,238.861657142857,137323,137521,198
100,0,blank,0,117.189671428571,272.605942857143,137521,137720,199
100,11,==,74,142.680957142857,240.075371428571,137720,137918,198
100,11,==,74,133.362842857143,234.086442857143,137918,138114,196
100,11,rem,73,98.7012166666667,239.356983333333,138114,138286,172
100,0,blank,0,110.161616666667,248.764766666667,138286,138459,173
100,11,rem,73,111.331333333333,234.82565,138459,138630,171
100,0,blank,0,74.3469166666667,235.562616666667,138630,138802,172
100,0,blank,0,71.2187166666667,199.6644,138802,138976,174
100,0,blank,0,76.0744833333333,197.4558,138976,139148,172
100,8,for,47,71.8020333333333,170.390266666667,139148,139320,172
100,0,blank,0,-350,-105,139377,139527,150
100,10,rem,65,103.097,211.087083333333,139554,139748,194
100,11,rem,73,97.5665,241.546966666667,139748,139922,174
100,11,rem,73,110.421483333333,238.167583333333,139922,140095,173
100,0,blank,0,125.785785714286,248.662628571429,140095,140294,199
100,0,blank,0,122.5364,234.081142857143,140294,140491,197
100,11,==,74,138.645216666667,239.662516666667,140491,140665,174
100,0,blank,0,145.561033333333,229.133833333333,140665,140839,174
100,11,==,74,141.766733333333,235.830916666667,140839,141013,174
100,0,blank,0,126.633866666667,247.398783333333,141013,141188,175
100,0,blank,0,138.186683333333,211.084483333333,141188,141362,174
100,10,n,67,146.073383333333,219.335033333333,141362,141534,172
100,0,blank,0,174.7367,233.60165,141534,141706,172
100,0,blank,0,149.258466666667,235.90915,141706,141878,172
100,0,blank,0,-350,-105,141935,142112,177
100,11,==,74,126.042914285714,228.4831,142226,142423,197
100,0,blank,0,125.319816666667,246.959283333333,142423,142599,176
100,11,==,74,144.968133333333,241.8998,142599,142771,172
100,0,blank,0,127.296016666667,251.000983333333,142771,142944,173
100,11,0,75,160.390783333333,229.084966666667,142944,143118,174
100,0,blank,0,158.949716666667,215.411,143118,143297,179
100,11,==,74,143.081083333333,225.975416666667,143297,143477,180
100,11,rem,73,95.2178,225.912833333333,143477,143653,176
100,11,rem,73,105.116,239.1059,143653,143683,30
100,10,rem,65,113.356483333333,214.467466666667,143742,143921,179
100,11,==,74,135.89595,223.7515,143921,144101,180
100,11,==,74,140.8096,232.8084,144101,144281,180
100,11,==,74,133.400266666667,232.991733333333,144281,144463,182
100,0,blank,0,130.572816666667,251.9743,144463,144645,182
100,13,=,79,144.270066666667,280.4904,144645,144826,181
100,0,blank,0,142.071633333333,293.9735,144826,145008,182
100,0,blank,0,137.113783333333,292.842683333333,145008,145190,182
100,0,blank,0,174.94378,286.57442,145190,145339,149
100,0,blank,0,-350,-105,145369,145525,156
100,13,+,81,187.7302,283.2261,145550,145582,32
100,0,blank,0,178.762171428571,285.435228571429,145643,145835,192
100,0,blank,0,180.779716666667,274.950916666667,145835,146010,175
100,0,blank,0,175.583366666667,289.630383333333,146010,146181,171
100,0,blank,0,197.13035,277.9766,146181,146239,58
100,0,blank,0,203.37885,291.56235,146267,146437,170
100,0,blank,0,-350,-105,146465,146622,157
100,0,blank,0,123.6659,396.3983,146648,146673,25
100,0,blank,0,162.829871428571,270.750085714286,146699,146888,189
100,0,blank,0,186.415283333333,295.94045,146888,147062,174
100,13,s,80,126.99765,274.71895,147119,147293,174
100,0,blank,0,197.7202,376.8511,147430,147459,29
100,0,blank,0,141.6624,259.1176,147487,147515,28
100,17,"EnteredNumberiscorrect",94,254.48195,364.8157,147547,147605,58
100,0,blank,0,252.8519,275.491,147694,147824,130
100,13,s,80,170.48735,280.91545,147824,148009,185
100,0,blank,0,210.387333333333,257.8771,148009,148142,133
100,13,s,80,171.295733333333,272.444133333333,148174,148262,88
100,0,blank,0,-350,-105,148292,148445,153
100,0,blank,0,188.138714285714,263.903942857143,148551,148738,187
100,0,blank,0,196.4967,281.986133333333,148738,148912,174
100,0,blank,0,175.293916666667,276.030916666667,148912,149083,171
100,0,blank,0,201.349133333333,294.264433333333,149083,149172,89
100,11,==,74,142.0304,225.6058,149258,149286,28
100,0,blank,0,216.284,350.5193,149317,149349,32
100,0,blank,0,219.196,254.102566666667,149377,149553,176
100,0,blank,0,183.8099,183.4191,149553,149582,29
100,0,blank,0,237.1631,391.2513,149609,149643,34
100,0,blank,0,263.6985,257.2888,149699,149731,32
100,0,blank,0,149.4231,196.537842857143,149786,149985,199
100,0,blank,0,153.395833333333,196.9541,149985,150070,85
100,0,blank,0,191.195657142857,244.003914285714,150127,150326,199
100,0,blank,0,199.452166666667,308.147333333333,150326,150409,83
100,0,blank,0,189.212328571429,261.405657142857,150466,150665,199
100,0,blank,0,187.26422,265.85566,150665,150808,143
100,13,+,81,192.134416666667,274.829616666667,150864,151035,171
100,13,=,79,143.1705,281.68115,151035,151209,174
100,0,blank,0,140.186616666667,262.330583333333,151209,151385,176
100,0,blank,0,176.231183333333,267.875183333333,151385,151559,174
100,0,blank,0,172.9102,300.916683333333,151559,151732,173
100,13,=,79,147.204966666667,277.982916666667,151732,151905,173
100,0,blank,0,135.059433333333,304.766066666667,151905,152077,172
100,0,blank,0,143.641966666667,312.86695,152077,152252,175
100,0,blank,0,-350,-105,152311,152492,181
100,0,blank,0,-350,-105,152492,152671,179
100,0,blank,0,-350,-105,152671,152851,180
100,0,blank,0,-350,-105,152851,153029,178
100,0,blank,0,-350,-105,153029,153206,177
100,0,blank,0,-350,-105,153206,153388,182
100,0,blank,0,-350,-105,153388,153566,178
100,0,blank,0,-350,-105,153566,153743,177
100,0,blank,0,-350,-105,153743,153923,180
100,0,blank,0,-350,-105,153923,154102,179
100,0,blank,0,-350,-105,154102,154283,181
100,0,blank,0,-350,-105,154283,154465,182
100,0,blank,0,-350,-105,154465,154644,179
100,0,blank,0,-350,-105,154644,154823,179
100,0,blank,0,-350,-105,154823,155004,181
100,0,blank,0,-350,-105,155004,155184,180
100,0,blank,0,-350,-105,155184,155363,179
100,0,blank,0,-350,-105,155363,155546,183
100,0,blank,0,-350,-105,155546,155727,181
100,0,blank,0,-350,-105,155727,155906,179
100,0,blank,0,-350,-105,155906,156084,178
100,0,blank,0,-350,-105,156084,156260,176
100,0,blank,0,-350,-105,156260,156443,183
100,0,blank,0,-350,-105,156443,156622,179
100,0,blank,0,-350,-105,156622,156800,178
100,0,blank,0,-350,-105,156800,156980,180
100,0,blank,0,-350,-105,156980,157158,178
100,0,blank,0,-350,-105,157158,157337,179
100,0,blank,0,-350,-105,157337,157519,182
100,0,blank,0,-350,-105,157519,157698,179
100,0,blank,0,-350,-105,157698,157878,180
100,0,blank,0,-350,-105,157878,158058,180
100,0,blank,0,-350,-105,158058,158238,180
100,0,blank,0,-350,-105,158238,158417,179
100,0,blank,0,-350,-105,158417,158601,184
100,0,blank,0,-350,-105,158601,158781,180
100,0,blank,0,-350,-105,158781,158960,179
100,0,blank,0,-350,-105,158960,159143,183
100,0,blank,0,-350,-105,159143,159323,180
100,0,blank,0,-350,-105,159323,159504,181
100,0,blank,0,-350,-105,159504,159691,187
100,0,blank,0,-350,-105,159691,159870,179
100,0,blank,0,-350,-105,159870,160050,180
100,0,blank,0,-350,-105,160050,160232,182
100,0,blank,0,-350,-105,160232,160410,178
100,0,blank,0,-350,-105,160410,160472,62
100,0,blank,0,233.83312,310.17034,160501,160632,131
100,0,blank,0,236.800971428571,301.314928571429,160688,160885,197
100,13,;,83,220.138975,284.63035,160913,161030,117
100,0,blank,0,263.6844,453.6054,161062,161117,55
100,0,blank,0,309.4367,280.8974,161206,161236,30
100,0,blank,0,231.627028571429,277.8407,161290,161488,198
100,13,i,82,211.381783333333,283.834416666667,161488,161671,183
100,0,blank,0,186.417766666667,301.082,161671,161842,171
100,0,blank,0,181.1837,284.550966666667,161842,162016,174
100,13,s,80,170.377166666667,282.93315,162016,162193,177
100,0,blank,0,159.844916666667,314.120833333333,162193,162370,177
100,0,blank,0,168.431783333333,320.905033333333,162370,162548,178
100,0,blank,0,154.24595,293.620233333333,162548,162726,178
100,0,blank,0,164.519516666667,271.90095,162726,162904,178
100,13,s,80,170.844966666667,277.510416666667,162904,163081,177
100,0,blank,0,160.632866666667,278.271233333333,163081,163168,87
100,0,blank,0,-350,-105,163197,163377,180
100,0,blank,0,-350,-105,163377,163402,25
100,0,blank,0,180.9216,272.278957142857,163430,163618,188
100,0,blank,0,200.20512,239.10754,163618,163764,146
100,0,blank,0,218.782916666667,289.334833333333,163822,163993,171
100,0,blank,0,171.70785,308.1031,163993,164051,58
100,0,blank,0,182.7339,287.687757142857,164107,164306,199
100,0,blank,0,168.53004,265.38838,164306,164449,143
100,0,blank,0,188.0209,256.17235,164477,164651,174
100,0,blank,0,178.838733333333,250.42635,164651,164824,173
100,13,+,81,188.9409,280.9655,164824,164852,28
100,0,blank,0,-350,-105,164881,165061,180
100,0,blank,0,-350,-105,165061,165239,178
100,0,blank,0,-350,-105,165239,165415,176
100,0,blank,0,-350,-105,165415,165600,185
100,0,blank,0,-350,-105,165600,165779,179
100,0,blank,0,-350,-105,165779,165959,180
100,0,blank,0,-350,-105,165959,166140,181
100,0,blank,0,-350,-105,166140,166320,180
100,0,blank,0,-350,-105,166320,166497,177
100,0,blank,0,-350,-105,166497,166679,182
100,0,blank,0,-350,-105,166679,166858,179
100,0,blank,0,-350,-105,166858,167037,179
100,0,blank,0,-350,-105,167037,167217,180
100,0,blank,0,-350,-105,167217,167395,178
100,0,blank,0,-350,-105,167395,167572,177
100,0,blank,0,-350,-105,167572,167753,181
100,0,blank,0,-350,-105,167753,167928,175
100,0,blank,0,-350,-105,167928,168110,182
100,0,blank,0,-350,-105,168110,168161,51
100,0,blank,0,162.1655,275.8755,168229,168341,112
100,0,blank,0,153.3275,290.4502,168341,168525,184
100,0,blank,0,152.401666666667,318.258683333333,168525,168703,178
100,16,),91,145.6954,349.30942,168703,168874,171
100,16,n,90,143.304833333333,335.885433333333,168874,168988,114
100,0,blank,0,120.2357,314.8154,168988,169385,397
100,0,blank,0,139.4418,307.0574,169385,169467,82
100,16,(,87,75.8944,334.6053,169467,169746,279
100,16,(,87,81.6877,339.086166666667,169746,169852,106
100,0,blank,0,-350,-105,169877,170070,193
100,16,(,87,81.5663,341.858866666667,170098,170287,189
100,0,blank,0,72.4905166666667,346.2947,170287,170467,180
100,17,printf,92,93.1824166666667,359.386,170467,170646,179
100,16,s,88,86.6521166666667,350.379533333333,170646,170825,179
100,16,(,87,75.0054,340.297216666667,170825,171000,175
100,0,blank,0,76.2579166666667,354.889133333333,171000,171174,174
100,0,blank,0,99.47125,353.731533333333,171174,171350,176
100,17,printf,92,99.6643333333333,367.065766666667,171350,171524,174
100,17,printf,92,127.07055,374.179483333333,171524,171702,178
100,17,printf,92,114.813533333333,374.932666666667,171702,171879,177
100,17,"EnteredNumberiscorrect",94,161.41195,365.128733333333,171879,172054,175
100,17,"EnteredNumberiscorrect",94,216.505033333333,365.6174,172054,172229,175
100,0,blank,0,267.440383333333,351.619333333333,172229,172403,174
100,17,"EnteredNumberiscorrect",94,209.5416,364.889333333333,172403,172578,175
100,17,"EnteredNumberiscorrect",94,268.769766666667,361.8114,172578,172753,175
100,17,"EnteredNumberiscorrect",94,326.42705,369.087133333333,172753,172927,174
100,0,blank,0,298.120583333333,379.355,172927,173101,174
100,19,"EnteredNumberisnotaperfect",100,239.673583333333,408.214916666667,173101,173275,174
100,0,blank,0,206.906633333333,379.176633333333,173275,173448,173
100,0,blank,0,124.9626,390.211066666667,173448,173620,172
100,17,printf,92,112.720866666667,359.39745,173620,173793,173
100,19,(,99,149.440116666667,410.240233333333,173793,173967,174
100,19,"EnteredNumberisnotaperfect",100,344.969133333333,414.0078,173996,174169,173
100,0,blank,0,343.0717,431.975666666667,174169,174343,174
100,19,"EnteredNumberisnotaperfect",100,304.534583333333,416.451966666667,174343,174515,172
100,19,"EnteredNumberisnotaperfect",100,368.912883333333,411.494333333333,174515,174686,171
100,0,blank,0,343.976385714286,386.242071428571,174686,174885,199
100,0,blank,0,333.4369,377.374,174885,175059,174
100,17,"EnteredNumberiscorrect",94,334.647233333333,355.184233333333,175059,175231,172
100,0,blank,0,313.5697,379.580133333333,175231,175405,174
100,19,"EnteredNumberisnotaperfect",100,321.1884,399.540516666667,175405,175579,174
100,0,blank,0,330.861283333333,387.462266666667,175579,175752,173
100,0,blank,0,337.3552,343.9372,175752,175781,29
100,0,blank,0,379.163257142857,428.5187,175810,176009,199
100,0,blank,0,368.910616666667,424.7544,176009,176181,172
100,0,blank,0,335.286533333333,428.8091,176181,176354,173
100,19,"EnteredNumberisnotaperfect",100,322.331957142857,418.500028571429,176354,176552,198
100,0,blank,0,-350,-105,176580,176735,155
100,19,"EnteredNumberisnotaperfect",100,357.904071428571,416.124271428571,176820,177008,188
100,0,blank,0,353.754083333333,423.273283333333,177008,177181,173
100,19,"EnteredNumberisnotaperfect",100,403.283028571429,411.369028571429,177181,177379,198
100,0,blank,0,400.21705,428.782166666667,177408,177579,171
100,0,blank,0,377.756285714286,425.528342857143,177607,177806,199
100,0,blank,0,353.149342857143,422.962742857143,177806,178004,198
100,19,"EnteredNumberisnotaperfect",100,267.3441,412.0311,178004,178176,172
100,0,blank,0,247.847283333333,389.5442,178176,178350,174
100,0,blank,0,170.4888,389.332166666667,178379,178552,173
100,0,blank,0,152.193816666667,385.454833333333,178552,178725,173
100,0,blank,0,114.510533333333,377.92825,178725,178897,172
100,0,blank,0,93.8758857142857,385.570285714286,178897,179095,198
100,0,blank,0,93.11515,378.537866666667,179095,179267,172
100,0,blank,0,112.479016666667,376.043283333333,179267,179439,172
100,17,printf,92,118.8396,361.340166666667,179439,179611,172
100,17,printf,92,143.225516666667,372.658433333333,179611,179785,174
100,0,blank,0,178.0683,381.992133333333,179785,179957,172
100,0,blank,0,287.926883333333,379.76645,179987,180161,174
100,17,"EnteredNumberiscorrect",94,279.560585714286,373.277014285714,180161,180355,194
100,0,blank,0,216.376983333333,395.898733333333,180355,180554,199
100,19,(,99,152.505783333333,404.2734,180554,180727,173
100,19,printf,98,138.90725,400.8384,180727,180901,174
100,19,printf,98,120.172016666667,413.072333333333,180901,181076,175
100,19,printf,98,117.1398,408.6952,181076,181164,88
100,0,blank,0,-350,-105,181222,181399,177
100,0,blank,0,-350,-105,181399,181576,177
100,0,blank,0,-350,-105,181576,181766,190
100,0,blank,0,-350,-105,181766,181944,178
100,0,blank,0,-350,-105,181944,182121,177
100,0,blank,0,-350,-105,182121,182302,181
100,0,blank,0,-350,-105,182302,182480,178
100,0,blank,0,-350,-105,182480,182660,180
100,0,blank,0,-350,-105,182660,182844,184
100,0,blank,0,-350,-105,182844,183025,181
100,0,blank,0,-350,-105,183025,183205,180
100,0,blank,0,-350,-105,183205,183388,183
100,0,blank,0,-350,-105,183388,183568,180
100,0,blank,0,-350,-105,183568,183750,182
100,0,blank,0,-350,-105,183750,183934,184
100,0,blank,0,-350,-105,183934,184114,180
100,0,blank,0,-350,-105,184114,184296,182
100,0,blank,0,-350,-105,184296,184479,183
100,0,blank,0,-350,-105,184479,184660,181
100,0,blank,0,-350,-105,184660,184838,178
100,0,blank,0,-350,-105,184838,185019,181
100,0,blank,0,-350,-105,185019,185199,180
100,0,blank,0,-350,-105,185199,185379,180
100,0,blank,0,-350,-105,185379,185560,181
100,0,blank,0,-350,-105,185560,185738,178
100,0,blank,0,-350,-105,185738,185915,177
100,0,blank,0,-350,-105,185915,186094,179
100,0,blank,0,-350,-105,186094,186272,178
100,0,blank,0,-350,-105,186272,186450,178
100,0,blank,0,-350,-105,186450,186634,184
100,0,blank,0,-350,-105,186634,186815,181
100,0,blank,0,-350,-105,186815,186994,179
100,0,blank,0,-350,-105,186994,187176,182
100,0,blank,0,-350,-105,187176,187357,181
100,0,blank,0,-350,-105,187357,187539,182
100,0,blank,0,-350,-105,187539,187723,184
100,0,blank,0,-350,-105,187723,187905,182
100,0,blank,0,-350,-105,187905,188084,179
100,0,blank,0,-350,-105,188084,188266,182
100,0,blank,0,-350,-105,188266,188446,180
100,0,blank,0,-350,-105,188446,188573,127
100,11,==,74,138.90325,225.29275,188681,188840,159
100,0,blank,0,127.228,198.68914,188840,189019,179
100,10,=,66,130.55355,211.47415,189019,189192,173
100,0,blank,0,162.565583333333,183.14045,189192,189364,172
100,10,n,67,151.93415,211.883766666667,189364,189539,175
100,0,blank,0,174.05795,199.836366666667,189539,189712,173
100,10,i,69,193.124128571429,210.9621,189712,189911,199
100,0,blank,0,196.45896,193.7242,189911,190055,144
100,0,blank,0,-350,-105,190084,190270,186
100,0,blank,0,207.125085714286,198.1114,190296,190478,182
100,0,blank,0,215.617766666667,192.490016666667,190478,190651,173
100,0,blank,0,202.3879,208.16655,190651,190826,175
100,0,blank,0,186.69895,227.37065,190826,190998,172
100,0,blank,0,186.03705,249.753666666667,190998,191171,173
100,0,blank,0,183.186716666667,244.023016666667,191171,191345,174
100,0,blank,0,156.588733333333,250.237566666667,191345,191520,175
100,0,blank,0,163.116483333333,268.506083333333,191520,191696,176
100,0,blank,0,154.91185,293.8854,191696,191873,177
100,0,blank,0,147.1457,300.242633333333,191873,192050,177
100,0,blank,0,149.834,296.322516666667,192050,192227,177
100,13,=,79,152.717783333333,284.784083333333,192227,192407,180
100,0,blank,0,152.171816666667,269.94035,192407,192582,175
100,16,),91,148.798116666667,343.189233333333,192582,192757,175
100,0,blank,0,159.1394,336.8189,192757,192933,176
100,0,blank,0,161.019016666667,292.146183333333,192933,193110,177
100,0,blank,0,150.241666666667,291.087766666667,193110,193287,177
100,0,blank,0,128.300016666667,291.594533333333,193287,193462,175
100,0,blank,0,136.760266666667,305.9224,193462,193637,175
100,0,blank,0,118.3698,326.9017,193637,193667,30
100,0,blank,0,-350,-105,193696,193851,155
100,0,blank,0,181.2956,276.2758,193876,193902,26
100,0,blank,0,164.619942857143,315.099557142857,193950,194141,191
100,0,blank,0,187.14535,341.421433333333,194141,194318,177
100,0,blank,0,242.414883333333,384.37355,194318,194493,175
100,19,"EnteredNumberisnotaperfect",100,330.895516666667,400.271166666667,194493,194667,174
100,19,"EnteredNumberisnotaperfect",100,374.8686,414.302366666667,194667,194841,174
100,0,blank,0,352.60245,398.524383333333,194841,195013,172
100,19,"EnteredNumberisnotaperfect",100,343.447666666667,402.648983333333,195013,195187,174
100,0,blank,0,336.345516666667,394.5083,195187,195360,173
100,17,"EnteredNumberiscorrect",94,347.40945,363.3273,195360,195534,174
100,17,"EnteredNumberiscorrect",94,360.71606,367.65742,195534,195678,144
100,17,"EnteredNumberiscorrect",94,307.5131,366.02545,195735,195909,174
100,17,"EnteredNumberiscorrect",94,326.900133333333,370.10385,195909,196084,175
100,0,blank,0,284.761316666667,382.307233333333,196084,196258,174
100,17,"EnteredNumberiscorrect",94,260.29945,369.770083333333,196258,196432,174
100,17,"EnteredNumberiscorrect",94,218.30115,369.076616666667,196432,196604,172
100,19,"EnteredNumberisnotaperfect",100,222.58975,407.1917,196604,196660,56
100,19,"EnteredNumberisnotaperfect",100,246.4047,401.598516666667,196716,196887,171
100,0,blank,0,319.601533333333,420.010933333333,196887,196973,86
100,19,"EnteredNumberisnotaperfect",100,332.729533333333,410.0916,197002,197174,172
100,19,"EnteredNumberisnotaperfect",100,341.267566666667,418.4707,197174,197261,87
100,0,blank,0,155.522716666667,398.662366666667,197319,197490,171
100,0,blank,0,147.7054,456.9824,197490,197519,29
100,19,printf,98,95.2247571428571,417.956057142857,197548,197747,199
100,18,else,97,80.4521666666667,384.718633333333,197747,197834,87
100,0,blank,0,41.5462,447.47965,197862,197919,57
100,0,blank,0,-350,-105,197948,198107,159
100,20,return,103,75.6482,431.713114285714,198198,198388,190
100,0,blank,0,69.6218166666667,404.305166666667,198388,198560,172
100,0,blank,0,73.4155571428572,402.020942857143,198560,198754,194
100,0,blank,0,80.5339428571429,422.689328571429,198754,198947,193
100,20,return,103,92.9549142857143,440.128614285714,198947,199146,199
100,0,blank,0,90.71264,420.98396,199146,199289,143
100,20,return,103,70.4779285714286,437.8534,199319,199518,199
100,20,return,103,92.6965833333333,438.403566666667,199518,199691,173
100,0,blank,0,92.6906166666667,444.42025,199691,199865,174
100,20,return,103,96.3699,436.510666666667,199865,200039,174
100,20,return,103,94.54545,430.899916666667,200039,200212,173
100,0,blank,0,55.78225,411.443233333333,200212,200386,174
100,0,blank,0,49.4882833333333,401.18315,200386,200561,175
100,0,blank,0,50.3040166666667,400.1021,200561,200737,176
100,0,blank,0,54.4044,409.358133333333,200737,200913,176
100,0,blank,0,79.82185,396.860533333333,200913,201090,177
100,0,blank,0,73.4638,404.846533333333,201090,201177,87
100,0,blank,0,-350,-105,201206,201387,181
100,0,blank,0,107.9579,448.2724,201413,201438,25
100,0,blank,0,105.093728571429,389.624257142857,201486,201676,190
100,0,blank,0,90.0173333333333,390.7246,201676,201851,175
100,0,blank,0,93.2563833333333,398.7354,201851,202024,173
100,19,printf,98,97.9141666666667,409.289233333333,202024,202198,174
100,0,blank,0,145.78655,383.0448,202198,202373,175
100,0,blank,0,167.31345,348.056283333333,202373,202548,175
100,0,blank,0,160.283166666667,325.178516666667,202548,202725,177
100,0,blank,0,147.31685,306.268433333333,202725,202901,176
100,0,blank,0,144.059516666667,316.39025,202901,203077,176
100,0,blank,0,-350,-105,203106,203288,182
100,0,blank,0,-350,-105,203288,203467,179
100,0,blank,0,-350,-105,203467,203644,177
100,0,blank,0,-350,-105,203644,203825,181
100,0,blank,0,-350,-105,203825,204004,179
100,0,blank,0,-350,-105,204004,204181,177
100,0,blank,0,-350,-105,204181,204365,184
100,0,blank,0,-350,-105,204365,204545,180
100,0,blank,0,-350,-105,204545,204723,178
100,0,blank,0,-350,-105,204723,204902,179
100,0,blank,0,-350,-105,204902,205031,129
100,0,blank,0,200.075233333333,180.837966666667,205139,205320,181
100,0,blank,0,121.070366666667,225.25615,205320,205496,176
100,0,blank,0,97.7498,251.1095,205496,205553,57
100,13,=,79,147.64725,278.49875,205582,205638,56
100,19,"EnteredNumberisnotaperfect",100,171.9818,400.5087,205805,205863,58
100,0,blank,0,-350,-105,206000,206126,126
100,0,blank,0,131.9808,327.4532,206151,206177,26
100,0,blank,0,153.6129,267.7397,206304,206329,25
100,0,blank,0,171.8891,335.2215,206360,206390,30
100,0,blank,0,243.914,473.3109,206420,206450,30
100,19,"EnteredNumberisnotaperfect",100,154.30908,406.4384,206566,206737,171
100,0,blank,0,243.022733333333,434.0856,206737,206822,85
100,0,blank,0,281.81615,428.2066,206933,206989,56
100,0,blank,0,380.033466666667,393.313833333333,207021,207106,85
100,0,blank,0,149.2826,387.1946,207164,207194,30
100,0,blank,0,67.3088,459.06995,207220,207394,174
100,0,blank,0,80.8322333333333,402.843333333333,207394,207566,172
100,19,printf,98,110.518242857143,416.621571428571,207566,207765,199
100,0,blank,0,111.50975,432.738033333333,207765,207936,171
100,0,blank,0,-350,-105,207963,208122,159
100,18,else,97,62.3082,391.5473,208149,208174,25
100,0,blank,0,169.64635,393.2553,208196,208333,137
100,0,blank,0,145.755483333333,384.298233333333,208390,208563,173
100,0,blank,0,217.2557,388.488075,208760,208916,156
100,0,blank,0,162.9755,396.52225,208916,209065,149
100,0,blank,0,110.5202,398.14585,209065,209238,173
100,0,blank,0,91.4755666666667,389.763683333333,209238,209428,190
100,0,blank,0,173.648675,382.4749,209428,209544,116
100,17,"EnteredNumberiscorrect",94,171.841766666667,366.289566666667,209573,209658,85
100,0,blank,0,161.98234,380.03028,209771,209913,142
100,0,blank,0,-350,-105,209943,210073,130
100,17,"EnteredNumberiscorrect",94,156.8994,375.3574,210099,210125,26
100,17,"EnteredNumberiscorrect",94,181.045,364.66555,210172,210222,50
100,19,"EnteredNumberisnotaperfect",100,424.287833333333,410.251816666667,210247,210421,174
100,0,blank,0,422.806957142857,445.200157142857,210421,210619,198
100,0,blank,0,446.863885714286,436.222271428571,210619,210813,194
100,0,blank,0,419.531828571428,436.098028571429,210813,211002,189
100,0,blank,0,423.7852,397.737166666667,211002,211086,84
100,19,"EnteredNumberisnotaperfect",100,443.425583333333,413.194616666667,211115,211288,173
100,0,blank,0,415.76542,377.79598,211288,211437,149
100,0,blank,0,312.7552,398.2137,211499,211527,28
100,0,blank,0,281.7382,533.3676,211582,211610,28
100,0,blank,0,223.5457,335.1508,211638,211666,28
100,0,blank,0,272.3633,344.8201,211753,211778,25
100,0,blank,0,244.2887,342.3521,211803,211830,27
100,19,"EnteredNumberisnotaperfect",100,441.56688,408.75998,211857,211999,142
100,19,"EnteredNumberisnotaperfect",100,459.03975,402.361725,212026,212138,112
100,0,blank,0,405.0079,531.63,212166,212197,31
100,19,"EnteredNumberisnotaperfect",100,439.8398,416.3927,212252,212339,87
100,0,blank,0,157.66128,352.23706,212371,212516,145
100,16,==,89,117.84975,338.49085,212627,212687,60
100,0,blank,0,173.9507,380.512083333333,212748,212921,173
100,0,blank,0,71.9775666666666,338.2697,212947,213036,89
100,17,printf,92,112.29545,357.39615,213092,213146,54
100,0,blank,0,171.00162,504.44102,213202,213336,134
100,0,blank,0,148.8322,309.2491,213364,213391,27
100,19,printf,98,114.00856,403.93892,213421,213567,146
100,0,blank,0,111.0566,387.2993,213596,213624,28
100,0,blank,0,77.98875,372.1416,213686,213745,59
100,19,"EnteredNumberisnotaperfect",100,176.57285,411.412,213777,213835,58
100,0,blank,0,90.4722,331.786933333333,214057,214141,84
100,0,blank,0,157.9633,383.056383333333,214205,214378,173
100,0,blank,0,148.182025,326.1553,214378,214489,111
100,18,else,97,77.4602,387.2596,214517,214549,32
100,0,blank,0,182.842533333333,386.814333333333,214577,214664,87
100,17,"EnteredNumberiscorrect",94,180.989,365.4822,214722,214863,141
100,0,blank,0,213.507575,514.715075,214950,215063,113
100,17,printf,92,129.122714285714,362.133528571429,215090,215284,194
100,0,blank,0,192.8592,440.5165,215284,215312,28
100,17,printf,92,98.4119,375.4362,215341,215369,28
100,0,blank,0,107.51335,383.7147,215425,215480,55
100,0,blank,0,196.2706,443.6024,215508,215563,55
100,0,blank,0,105.8617,326.34115,215591,215647,56
100,0,blank,0,194.4863,462.3115,215678,215709,31
100,0,blank,0,132.5384,380.937,215736,215762,26
100,0,blank,0,178.665733333333,376.25695,215847,216017,170
100,0,blank,0,193.16918,523.34074,216102,216238,136
100,0,blank,0,-350,-105,216266,216418,152
100,0,blank,0,-350,-105,216479,216507,28
100,0,blank,0,128.666583333333,300.0959,216532,216693,161
100,0,blank,0,163.8554,463.556233333333,216721,216803,82
100,0,blank,0,79.18504,364.12516,216830,216970,140
100,17,printf,92,128.358666666667,368.9767,216997,217080,83
100,0,blank,0,144.12135,432.409925,217108,217218,110
100,0,blank,0,94.5102666666667,295.0485,217246,217333,87
100,0,blank,0,106.7145,285.1648,217362,217392,30
100,0,blank,0,162.7822,548.5802,217421,217450,29
100,0,blank,0,173.261,510.7106,217477,217507,30
100,0,blank,0,101.5322,318.5638,217532,217559,27
100,0,blank,0,91.27015,270.1334,217675,217766,91
100,0,blank,0,157.6269,509.0784,217794,217823,29
100,0,blank,0,118.17175,383.5212,217935,217991,56
100,0,blank,0,238.0252,433.908,218019,218050,31
100,17,printf,92,114.160075,356.891025,218078,218192,114
100,0,blank,0,44.3474,292.8101,218220,218248,28
100,0,blank,0,69.0618,340.4403,218279,218307,28
100,0,blank,0,138.24045,311.986625,218368,218479,111
100,0,blank,0,203.9609,528.1048,218508,218536,28
100,0,blank,0,190.6308,496.8575,218590,218620,30
100,0,blank,0,169.0544,298.7703,218648,218676,28
100,11,rem,73,85.65495,232.3661,218736,218882,146
100,0,blank,0,101.62405,244.0297,218882,219075,193
100,0,blank,0,104.205,191.2828,219075,219162,87
100,0,blank,0,131.2351,251.747066666667,219225,219314,89
100,0,blank,0,198.0544,466.487233333333,219345,219431,86
100,0,blank,0,75.4009,159.1262,219461,219487,26
100,0,blank,0,119.12762,224.63822,219518,219669,151
100,0,blank,0,203.1949,296.6538,219728,219867,139
100,0,blank,0,141.119466666667,275.890466666667,219898,219982,84
100,10,=,66,134.5357,209.23818,220038,220179,141
100,0,blank,0,128.782133333333,221.2081,220238,220407,169
100,0,blank,0,79.4027333333333,216.44465,220466,220637,171
100,0,blank,0,76.6685,186.1535,220637,220667,30
100,0,blank,0,121.580616666667,273.4161,220726,220894,168
100,0,blank,0,135.22892,279.41684,220894,221042,148
100,0,blank,0,93.9562,194.0623,221071,221098,27
100,0,blank,0,188.246366666667,312.1795,221128,221211,83
100,0,blank,0,104.53538,261.27676,221238,221383,145
100,0,blank,0,-350,-105,221501,221630,129
100,0,blank,0,144.603816666667,300.4617,221724,221897,173
100,0,blank,0,84.7538833333333,278.402733333333,221897,222094,197
100,0,blank,0,94.132,250.1129,222094,222238,144
100,0,blank,0,54.3838,267.7088,222328,222411,83
100,0,blank,0,197.6179,461.355,222525,222551,26
100,0,blank,0,101.7213,264.784,222578,222605,27
100,0,blank,0,93.7909,331.4294,222783,222811,28
100,0,blank,0,92.59745,323.736975,222839,222958,119
100,16,==,89,114.6974,335.113433333333,223021,223108,87
100,0,blank,0,91.3683,314.3344,223166,223193,27
100,0,blank,0,229.70935,424.69795,223221,223277,56
100,0,blank,0,-350,-105,223361,223489,128
100,0,blank,0,113.8116,323.5517,223514,223539,25
100,0,blank,0,172.664785714286,324.4599,223599,223779,180
100,16,(,87,79.00685,337.65455,223808,223866,58
100,0,blank,0,-350,-105,223923,224098,175
100,17,(,93,150.1896,361.865,224198,224223,25
100,0,blank,0,119.5912,321.76775,224248,224299,51
100,0,blank,0,75.0818666666667,221.653266666667,224325,224501,176
100,0,blank,0,34.2571166666667,227.152266666667,224501,224673,172
100,0,blank,0,31.2927833333333,217.220233333333,224673,224848,175
100,11,if,71,50.0388833333333,226.9885,224848,225021,173
100,10,rem,65,90.1553166666667,214.8418,225021,225195,174
100,10,rem,65,103.854116666667,219.204983333333,225195,225369,174
100,10,rem,65,89.0449,207.0842,225369,225427,58
100,16,if,86,59.0603,339.253066666667,225457,225631,174
100,16,if,86,60.0058,334.9644,225631,225807,176
100,0,blank,0,42.8626833333333,325.896616666667,225807,225984,177
100,0,blank,0,40.8840333333333,365.413233333333,225984,226162,178
100,0,blank,0,0.857700000000004,403.247816666667,226162,226342,180
100,0,blank,0,46.0597666666667,280.096383333333,226342,226520,178
100,0,blank,0,38.207,241.886766666667,226520,226695,175
100,0,blank,0,43.2652,202.206966666667,226695,226870,175
100,0,blank,0,49.2467,212.074733333333,226870,227047,177
100,0,blank,0,26.3115,217.618133333333,227047,227222,175
100,9,{,64,46.6587,196.2897,227222,227398,176
100,0,blank,0,71.7846333333333,184.033133333333,227398,227573,175
100,0,blank,0,75.55055,181.582183333333,227573,227748,175
100,0,blank,0,116.0955,202.262966666667,227748,227922,174
100,0,blank,0,117.598633333333,198.3137,227922,228096,174
100,0,blank,0,64.0116333333333,283.525183333333,228096,228271,175
100,0,blank,0,60.2022666666667,300.621733333333,228271,228358,87
100,0,blank,0,-350,-105,228416,228568,152
100,0,blank,0,94.3928,290.5636,228593,228619,26
100,0,blank,0,79.9191857142857,312.823585714286,228672,228860,188
100,0,blank,0,76.33545,324.051983333333,228860,229035,175
100,16,if,86,54.8460857142857,338.588957142857,229035,229234,199
100,0,blank,0,52.5799,373.7054,229234,229262,28
100,0,blank,0,164.6006,425.3554,229302,229480,178
100,20,0,104,121.01985,423.1079,229480,229657,177
100,0,blank,0,101.280583333333,422.969083333333,229657,229831,174
100,19,printf,98,91.2451666666667,415.027616666667,229831,230003,172
100,0,blank,0,97.0621571428572,422.430414285714,230003,230199,196
100,0,blank,0,107.96875,426.841733333333,230199,230374,175
100,0,blank,0,109.378333333333,423.878866666667,230374,230551,177
100,19,printf,98,105.431616666667,410.957133333333,230551,230732,181
100,0,blank,0,94.1701333333333,444.043,230732,230910,178
100,20,return,103,79.1835666666667,427.105383333333,230910,231084,174
100,0,blank,0,110.64035,420.563025,231084,231196,112
100,0,blank,0,-350,-105,231225,231405,180
100,0,blank,0,-350,-105,231405,231585,180
100,0,blank,0,-350,-105,231585,231780,195
100,0,blank,0,-350,-105,231780,231966,186
100,0,blank,0,-350,-105,231966,232159,193
100,0,blank,0,-350,-105,232159,232323,164
100,0,blank,0,-350,-105,232323,232498,175
100,0,blank,0,-350,-105,232498,232667,169
100,0,blank,0,-350,-105,232667,232844,177
100,0,blank,0,-350,-105,232844,233012,168
100,0,blank,0,-350,-105,233012,233210,198
100,0,blank,0,-350,-105,233210,233394,184
100,0,blank,0,-350,-105,233394,233568,174
100,0,blank,0,-350,-105,233568,233747,179
100,0,blank,0,-350,-105,233747,233940,193
100,0,blank,0,-350,-105,233940,234066,126
100,0,blank,0,-350,-105,234066,234153,87
