Frameno_fix,lineno_fix,Tokenname_fix,tokens_id,gaze_X_fix,gaze_Y_fix,timestamp_fix_start,timestamp_fix_end,time_duration
100,0,blank,0,499.7099,-31.7636,2751,2782,31
100,0,blank,0,487.2726,-40.9634,2843,2903,60
100,0,blank,0,492.723033333333,-47.1773,3027,3117,90
100,1,Program,4,103.28485,10.5501666666667,3364,3549,185
100,1,Program,4,95.2644,13.432,3549,3580,31
100,0,blank,0,399.59925,-9.32635,3642,3765,123
100,0,blank,0,488.0701,-21.2531,3827,3858,31
100,0,blank,0,416.4822,-19.2895,4041,4071,30
100,0,blank,0,400.5289,-8.3125,4101,4131,30
100,0,blank,0,156.249966666667,-24.9603,4192,4283,91
100,0,blank,0,70.96904,-28.65192,4375,4530,155
100,0,blank,0,239.9351,-23.717,4561,4592,31
100,0,blank,0,279.7207,-57.0309,4653,4684,31
100,0,blank,0,207.16112,-8.87568,4776,4933,157
100,0,blank,0,274.567175,-26.62775,5098,5232,134
100,0,blank,0,366.0681,-10.9489,5265,5334,69
100,0,blank,0,364.0015,-17.4833666666667,5370,5477,107
100,0,blank,0,371.8648,-30.3969,5513,5548,35
100,0,blank,0,-323,-105,5701,5877,176
100,0,blank,0,-323,-105,5877,6055,178
100,0,blank,0,-323,-105,6055,6236,181
100,0,blank,0,-323,-105,6236,6412,176
100,0,blank,0,-323,-105,6412,6588,176
100,0,blank,0,-323,-105,6588,6765,177
100,0,blank,0,-323,-105,6765,6865,100
100,0,blank,0,-323,-105,6865,6970,105
100,0,blank,0,-323,-105,6970,7163,193
100,0,blank,0,-323,-105,7163,7361,198
100,0,blank,0,-323,-105,7361,7503,142
100,0,blank,0,-323,-105,7569,7767,198
100,0,blank,0,-323,-105,7767,7964,197
100,0,blank,0,-323,-105,7964,8136,172
100,0,blank,0,-323,-105,8136,8335,199
100,0,blank,0,-323,-105,8335,8516,181
100,0,blank,0,-323,-105,8516,9217,701
100,0,blank,0,-323,-105,9217,9411,194
100,0,blank,0,-323,-105,9411,9447,36
100,0,blank,0,-323,-105,9447,9642,195
100,0,blank,0,-323,-105,9642,10100,458
100,0,blank,0,-323,-105,10100,10180,80
100,0,blank,0,-323,-105,10180,10362,182
100,0,blank,0,-323,-105,10362,10460,98
100,0,blank,0,-323,-105,10460,10658,198
100,0,blank,0,-323,-105,10658,10839,181
100,0,blank,0,-323,-105,10839,11022,183
100,0,blank,0,-323,-105,11022,11156,134
100,0,blank,0,-323,-105,11156,11304,148
100,0,blank,0,-323,-105,11304,11462,158
100,0,blank,0,-323,-105,11462,11654,192
100,0,blank,0,-323,-105,11654,11729,75
100,5,[,27,126.9623,94.459,11812,11850,38
100,0,blank,0,162.1727,130.5633,11997,12073,76
100,0,blank,0,-323,-105,12110,12293,183
100,0,blank,0,-323,-105,12293,12468,175
100,0,blank,0,-323,-105,12468,12646,178
100,0,blank,0,-323,-105,12646,12829,183
100,0,blank,0,-323,-105,12829,13016,187
100,0,blank,0,-323,-105,13016,13200,184
100,0,blank,0,-323,-105,13200,13292,92
100,0,blank,0,1027.038,59.362,13572,13609,37
100,0,blank,0,1036.4442,127.88608,13674,13844,170
100,0,blank,0,1036.436,121.5163,13909,13945,36
100,7,"Entertotalnumberofelements:",38,215.313025,135.744675,14048,14183,135
100,0,blank,0,104.618233333333,149.548866666667,14383,14580,197
100,7,"Entertotalnumberofelements:",38,204.0888,153.4322,14645,14677,32
100,7,"Entertotalnumberofelements:",38,201.93645,152.1189,14742,14807,65
100,7,"Entertotalnumberofelements:",38,169.554316666667,154.036466666667,15002,15198,196
100,7,"Entertotalnumberofelements:",38,193.25595,148.96045,15229,15292,63
100,0,blank,0,-323,-105,15453,15621,168
100,7,"Entertotalnumberofelements:",38,228.26465,141.54935,15650,15776,126
100,7,"Entertotalnumberofelements:",38,215.1011,141.2773,15809,15842,33
100,9,"Entertheelements:\n",51,267.0599,184.4805,16992,17037,45
100,0,blank,0,164.1482,278.39485,19651,19707,56
100,0,blank,0,158.929266666667,273.742366666667,19740,19833,93
100,7,printf,36,61.76415,140.0506,20342,20406,64
100,5,int,25,73.7677,102.3645,20502,20566,64
100,5,int,25,68.7547,105.7375,20630,20662,32
100,5,int,25,50.4859833333333,103.7205,20693,20881,188
100,5,int,25,46.4312,106.0642,20881,20912,31
100,0,blank,0,135.473075,286.97125,21007,21135,128
100,0,blank,0,30.5024,311.3937,21260,21285,25
100,0,blank,0,30.1055,322.39766,21315,21474,159
100,0,blank,0,29.0353,324.1266,21537,21569,32
100,0,blank,0,104.7328,315.4703,21729,21761,32
100,14,partition,80,107.6396,306.11785,21792,21855,63
100,15,(,92,111.143633333333,317.264833333333,21885,22071,186
100,14,partition,80,118.9048,304.5866,22164,22194,30
100,15,printf,91,68.9909,313.799233333333,22381,22476,95
100,14,partition,80,72.11895,305.88785,22508,22569,61
100,15,printf,91,80.72045,326.278,22726,22789,63
100,0,blank,0,36.9318,161.8682,22886,22918,32
100,3,int,20,25.2338,56.9391,22981,23013,32
100,3,int,20,6.9117,66.1081,23044,23075,31
100,0,blank,0,24.3376,69.5526,23106,23138,32
100,15,printf,91,76.452,320.1353,23394,23426,32
100,16,i,106,89.2726,338.7339,23459,23492,33
100,15,"Aftermergesort:\n",93,182.103725,313.990175,23695,23819,124
100,0,blank,0,-323,-105,23851,24025,174
100,0,blank,0,-323,-105,24025,24212,187
100,0,blank,0,-323,-105,24212,24408,196
100,0,blank,0,-323,-105,24408,24598,190
100,0,blank,0,-323,-105,24598,24706,108
100,15,"Aftermergesort:\n",93,299.58685,316.12775,25063,25133,70
100,16,i,106,151.1951,336.3315,25442,25468,26
100,0,blank,0,156.5279,336.0314,25750,25796,46
100,16,;,105,140.552,350.3058,25831,25898,67
100,0,blank,0,138.9944,363.9678,25932,25967,35
100,15,"Aftermergesort:\n",93,155.686,331.8219,26516,26549,33
100,0,blank,0,214.5623,359.4743,26846,26912,66
100,16,size,104,214.4909,349.201,26944,27010,66
100,0,blank,0,283.66225,341.0677,27139,27205,66
100,0,blank,0,197.7486,371.57395,27502,27568,66
100,0,blank,0,181.580666666667,400.719266666667,27670,27778,108
100,15,"Aftermergesort:\n",93,176.8301,315.3518,27994,28029,35
100,0,blank,0,178.9688,349.4456,28065,28101,36
100,16,size,104,196.0787,349.69885,28137,28206,69
100,0,blank,0,196.8995,354.0898,28276,28313,37
100,0,blank,0,-323,-105,28382,28546,164
100,0,blank,0,222.7105,368.8581,28746,28814,68
100,16,++,107,262.92935,353.3584,28920,28989,69
100,0,blank,0,307.0939,369.72295,29060,29129,69
100,0,blank,0,313.2912,400.6035,29196,29263,67
100,0,blank,0,280.655675,402.9009,29332,29471,139
100,0,blank,0,227.8316,424.7269,29504,29539,35
100,0,blank,0,240.1202,398.9989,29574,29608,34
100,0,blank,0,176.7481,416.7057,29753,29788,35
100,0,blank,0,274.3016,402.0725,29856,29888,32
100,0,blank,0,268.64345,409.4479,30024,30092,68
100,18,list,114,267.6368,380.3889,30126,30159,33
100,0,blank,0,318.6387,406.0635,30294,30330,36
100,0,blank,0,311.7478,414.7329,30397,30431,34
100,0,blank,0,280.9624,405.54855,30541,30612,71
100,0,blank,0,277.4172,400.8304,30681,30717,36
100,18,comma,113,241.651025,396.47935,30894,31037,143
100,0,blank,0,286.179633333333,408.864866666667,31387,31490,103
100,0,blank,0,289.0468,414.3914,31561,31599,38
100,18,[,115,288.7847,396.6714,31632,31666,34
100,0,blank,0,286.01455,432.41295,31700,31767,67
100,0,blank,0,170.6868,444.177925,31835,31973,138
100,0,blank,0,132.6941,460.7973,32294,32329,35
100,0,blank,0,134.6891,435.2813,32401,32435,34
100,0,blank,0,132.90835,450.81635,32508,32578,70
100,0,blank,0,-323,-105,32796,32926,130
100,0,blank,0,-323,-105,32926,33123,197
100,0,blank,0,-323,-105,33123,33282,159
100,0,blank,0,-323,-105,33282,33431,149
100,0,blank,0,-323,-105,33431,33558,127
100,0,blank,0,-323,-105,33895,34079,184
100,0,blank,0,-323,-105,34079,34259,180
100,0,blank,0,-323,-105,34259,34428,169
100,0,blank,0,-323,-105,34428,34506,78
100,0,blank,0,939.3435,246.72095,34617,34679,62
100,0,blank,0,934.57825,243.479875,34749,34892,143
101,0,blank,0,842.748,121.3563,35664,35703,39
101,0,blank,0,123.7032,186.8466,35804,35839,35
101,0,blank,0,115.3144,217.5716,35875,35911,36
101,0,blank,0,75.5595333333333,109.369466666667,35983,36093,110
101,24,mid,141,83.3535,168.9828,36179,36215,36
101,0,blank,0,50.7809,145.6433,36252,36290,38
101,0,blank,0,53.6774,160.9687,36326,36361,35
101,0,blank,0,59.6881,148.5705,36397,36432,35
101,24,int,140,62.1829,172.4751,36466,36499,33
101,22,partition,126,138.67225,130.67175,36533,36602,69
101,0,blank,0,97.9262,141.2843,36806,36843,37
101,24,mid,141,103.0619,166.2348,36877,36911,34
101,0,blank,0,86.0474,146.8685,36946,36982,36
101,0,blank,0,90.6703,151.9149,37130,37166,36
101,22,list,129,203.0996,125.0095,37202,37238,36
101,22,list,129,225.2679,132.5568,37309,37344,35
101,22,int,136,276.696725,138.301375,37381,37524,143
101,0,blank,0,238.076033333333,145.4658,37634,37736,102
101,0,blank,0,273.138,143.4019,37770,37908,138
101,22,int,136,276.4899,137.31102,37942,38119,177
101,22,int,136,345.2272,128.1173,38156,38226,70
101,0,blank,0,196.8956,170.84795,38404,38476,72
101,0,blank,0,83.0158,214.1795,38511,38546,35
101,25,low,145,88.4662,188.0779,38582,38617,35
101,0,blank,0,-323,-105,38764,38958,194
101,0,blank,0,-323,-105,38958,39130,172
101,0,blank,0,-323,-105,39130,39280,150
101,0,blank,0,-323,-105,39280,39465,185
101,0,blank,0,-323,-105,39465,39641,176
101,0,blank,0,-323,-105,39641,39818,177
101,0,blank,0,-323,-105,39818,39957,139
101,0,blank,0,-323,-105,39957,40075,118
101,0,blank,0,-323,-105,40075,40244,169
101,0,blank,0,-323,-105,40244,40654,410
101,0,blank,0,-323,-105,40654,40830,176
101,0,blank,0,-323,-105,40830,41020,190
101,0,blank,0,-323,-105,41020,41169,149
101,0,blank,0,-323,-105,41169,41281,112
101,0,blank,0,-323,-105,41281,41437,156
101,0,blank,0,-323,-105,41437,41617,180
101,0,blank,0,-323,-105,41617,41802,185
101,0,blank,0,-323,-105,41802,41976,174
101,0,blank,0,-323,-105,41976,42160,184
101,0,blank,0,-323,-105,42160,42334,174
101,0,blank,0,-323,-105,42334,42505,171
101,0,blank,0,-323,-105,42505,42702,197
101,0,blank,0,-323,-105,42702,42866,164
101,0,blank,0,-323,-105,42866,43035,169
101,0,blank,0,-323,-105,43035,43207,172
101,0,blank,0,-323,-105,43207,43399,192
101,0,blank,0,-323,-105,43399,43577,178
101,0,blank,0,-323,-105,43577,43710,133
101,0,blank,0,-323,-105,43979,44169,190
101,0,blank,0,-323,-105,44169,44359,190
101,0,blank,0,-323,-105,44359,44525,166
101,0,blank,0,-323,-105,44525,44707,182
101,0,blank,0,-323,-105,44707,44898,191
101,0,blank,0,-323,-105,44898,45086,188
101,0,blank,0,-323,-105,45086,45260,174
101,0,blank,0,-323,-105,45260,45395,135
101,0,blank,0,-323,-105,45395,45530,135
101,0,blank,0,-323,-105,45530,45712,182
101,0,blank,0,-323,-105,45712,45815,103
101,24,mid,141,83.7232,171.0623,46371,46418,47
101,24,mid,141,87.823725,176.3091,46522,46651,129
101,22,partition,126,130.2034,140.9216,46717,46750,33
101,0,blank,0,189.564275,94.672575,46782,46915,133
101,24,;,142,117.3135,166.40705,47179,47376,197
101,0,blank,0,122.14035,164.604875,47376,47510,134
101,0,blank,0,88.90108,160.98618,47543,47717,174
101,0,blank,0,82.65765,160.09745,47717,47783,66
101,25,<,146,118.1134,197.6555,47815,47885,70
101,0,blank,0,119.7163,185.4428,47921,47989,68
101,0,blank,0,194.963775,195.77535,48056,48194,138
101,0,blank,0,126.1629,193.9685,48294,48358,64
101,25,low,145,100.98475,201.63465,48425,48489,64
101,0,blank,0,-323,-105,48731,48915,184
101,0,blank,0,-323,-105,48915,49112,197
101,0,blank,0,-323,-105,49112,49303,191
101,0,blank,0,-323,-105,49303,49476,173
101,0,blank,0,-323,-105,49476,49651,175
101,0,blank,0,-323,-105,49651,49826,175
101,0,blank,0,-323,-105,49826,50013,187
101,0,blank,0,-323,-105,50013,50200,187
101,0,blank,0,-323,-105,50200,50291,91
101,0,blank,0,-323,-105,50291,50418,127
101,0,blank,0,-323,-105,50418,50608,190
101,0,blank,0,-323,-105,50608,50796,188
101,0,blank,0,-323,-105,50796,50983,187
101,0,blank,0,-323,-105,50983,51169,186
101,0,blank,0,-323,-105,51169,51360,191
101,0,blank,0,-323,-105,51360,51465,105
101,0,blank,0,-323,-105,51985,52174,189
101,0,blank,0,-323,-105,52174,52352,178
101,0,blank,0,-323,-105,52352,52538,186
101,0,blank,0,-323,-105,52538,52713,175
101,0,blank,0,-323,-105,52713,52887,174
101,0,blank,0,-323,-105,52887,53062,175
101,0,blank,0,-323,-105,53062,53239,177
101,0,blank,0,-323,-105,53239,53423,184
101,0,blank,0,-323,-105,53423,53611,188
101,0,blank,0,-323,-105,53611,53750,139
101,0,blank,0,-323,-105,53750,53927,177
101,0,blank,0,-323,-105,53927,54161,234
101,0,blank,0,-323,-105,54161,54271,110
101,0,blank,0,-323,-105,54271,54458,187
101,0,blank,0,-323,-105,54458,54646,188
101,0,blank,0,-323,-105,54646,54781,135
101,0,blank,0,-323,-105,55848,56009,161
101,28,comma,165,280.5091,262.88235,56107,56189,82
101,0,blank,0,242.892,258.4283,56231,56261,30
101,0,blank,0,267.5101,250.2187,56497,56531,34
101,0,blank,0,-323,-105,56671,56834,163
101,0,blank,0,-323,-105,56834,57018,184
101,0,blank,0,-323,-105,57018,57197,179
101,0,blank,0,-323,-105,57197,57388,191
101,0,blank,0,-323,-105,57388,57560,172
101,0,blank,0,-323,-105,57560,57738,178
101,0,blank,0,-323,-105,57738,57921,183
101,0,blank,0,-323,-105,57921,58101,180
101,0,blank,0,-323,-105,58101,58281,180
101,0,blank,0,-323,-105,58281,58455,174
101,0,blank,0,-323,-105,58455,58632,177
101,0,blank,0,-323,-105,58632,58808,176
101,0,blank,0,-323,-105,58808,59000,192
101,0,blank,0,-323,-105,59000,59197,197
101,0,blank,0,-323,-105,59197,59269,72
101,29,mid,173,259.7373,291.7318,60012,60101,89
101,30,high,186,344.34385,315.0916,60432,60508,76
101,0,blank,0,-323,-105,60540,60730,190
101,0,blank,0,-323,-105,60730,60908,178
101,0,blank,0,-323,-105,60908,61089,181
101,0,blank,0,-323,-105,61089,61272,183
101,0,blank,0,-323,-105,61272,61451,179
101,0,blank,0,-323,-105,61451,61632,181
101,0,blank,0,-323,-105,61632,61796,164
101,0,blank,0,-323,-105,61796,61973,177
101,0,blank,0,-323,-105,61973,62076,103
101,0,blank,0,-323,-105,62076,62274,198
101,0,blank,0,-323,-105,62274,62464,190
101,0,blank,0,-323,-105,62464,62639,175
101,0,blank,0,-323,-105,62639,62813,174
101,0,blank,0,-323,-105,62813,62988,175
101,0,blank,0,-323,-105,62988,63171,183
101,0,blank,0,-323,-105,63171,63349,178
101,0,blank,0,-323,-105,63349,63527,178
101,0,blank,0,-323,-105,63527,63705,178
101,0,blank,0,-323,-105,63705,63886,181
101,0,blank,0,-323,-105,63886,64067,181
101,0,blank,0,-323,-105,64067,64142,75
101,0,blank,0,75.76735,312.1273,65534,65602,68
101,0,blank,0,88.2315,343.2424,65668,65700,32
101,25,(,144,71.37935,192.8672,65833,65903,70
101,25,if,143,62.6555,194.2762,65937,65970,33
101,25,(,144,69.5840333333334,203.1446,66003,66104,101
101,0,blank,0,44.65035,143.00525,66170,66304,134
101,0,blank,0,167.2127,141.48655,66438,66506,68
101,0,blank,0,-323,-105,66573,66713,140
101,0,blank,0,984.884333333333,256.1254,66847,66944,97
101,0,blank,0,984.8505,260.70725,66977,67042,65
101,0,blank,0,982.32525,275.569125,67141,67276,135
101,0,blank,0,971.2964,320.64566,67309,67482,173
101,0,blank,0,971.3842,329.8906,67482,67650,168
101,0,blank,0,974.184,322.1587,67684,67717,33
101,0,blank,0,967.63,334.00715,67750,67817,67
101,0,blank,0,-323,-105,67926,68012,86
101,0,blank,0,-323,-105,68308,68458,150
102,0,blank,0,315.5685,121.4729,72827,72915,88
102,35,k,214,161.8295,172.8459,73309,73343,34
102,33,mergeSort,192,132.1262,129.320325,73375,73504,129
102,33,mergeSort,192,63.9671,143.649,73631,73662,31
102,0,blank,0,44.4914,148.7316,73724,73755,31
102,0,blank,0,24.7369,154.7576,73786,73851,65
102,33,void,191,14.1434,135.1984,73883,73918,35
102,0,blank,0,14.8807,154.958333333333,74012,74106,94
102,33,void,191,19.9631,127.5527,74231,74262,31
102,0,blank,0,-323,-105,74325,74523,198
102,0,blank,0,-323,-105,74523,74631,108
102,0,blank,0,-323,-105,74631,74821,190
102,0,blank,0,-323,-105,74821,75012,191
102,0,blank,0,-323,-105,75012,75149,137
102,0,blank,0,491.1531,93.4216,75964,76011,47
102,35,comma,217,138.3957,172.3659,77006,77034,28
102,0,blank,0,-323,-105,78094,78160,66
102,33,int,205,267.3305,140.175033333333,78284,78418,134
102,0,blank,0,93.4605,159.86995,78450,78515,65
102,35,i,210,87.5166,169.8087,78547,78644,97
102,35,int,209,51.9289,171.7081,78709,78773,64
102,35,int,209,58.3616,183.462175,78838,78963,125
102,35,int,209,54.0675,177.991033333333,79024,79114,90
102,35,i,210,91.998875,178.378275,79144,79271,127
102,0,blank,0,132.71604,154.87054,79303,79463,160
102,0,blank,0,177.9124,149.0399,79493,79524,31
102,0,blank,0,177.5437,158.7814,79586,79618,32
102,0,blank,0,138.499883333333,166.897083333333,79684,79872,188
102,0,blank,0,86.0332,188.0217,79935,79967,32
102,36,low,225,94.1852,203.6138,80031,80063,32
102,0,blank,0,86.9978,193.7279,80093,80123,30
102,0,blank,0,89.1559,210.7734,80184,80215,31
102,36,=,224,83.84404,206.05756,80308,80460,152
102,37,=,228,68.0943,218.9287,80491,80521,30
102,0,blank,0,64.72605,207.6781,80550,80611,61
102,0,blank,0,60.4888,209.4393,80641,80671,30
102,36,lo,223,56.4772,203.83132,80701,80849,148
102,36,lo,223,52.756,207.492,80908,80937,29
102,36,lo,223,58.5346,208.9068,80967,81057,90
102,36,=,224,83.4484,200.162,81178,81294,116
102,37,low,229,89.1538666666667,220.612866666667,81391,81551,160
102,0,blank,0,90.8509,210.956,81581,81642,61
102,37,i,227,52.4666,230.0969,81704,81888,184
102,38,mid,233,111.7761,244.9062,81919,81950,31
102,38,mid,233,118.55525,235.5222,82012,82073,61
102,0,blank,0,95.9,260.268,82134,82165,31
102,37,i,227,53.1263,227.8214,82257,82288,31
102,38,mi,231,45.3007,235.2098,82319,82411,92
102,38,mid,233,106.8326,236.00625,82503,82565,62
102,37,;,230,115.7407,222.9035,82626,82657,31
102,38,mid,233,96.0655,238.4568,82687,82717,30
102,38,mid,233,121.6528,246.4901,82929,82955,26
102,39,<=,247,172.3147,268.7772,83097,83159,62
102,0,blank,0,174.3752,256.0064,83190,83220,30
102,39,<=,247,153.88105,259.5764,83282,83344,62
102,39,<=,247,154.0476,257.4506,83375,83438,63
102,38,mid,233,112.582,248.8892,83468,83500,32
102,0,blank,0,125.3433,249.4924,83530,83561,31
102,0,blank,0,222.7957,247.592525,83652,83775,123
102,0,blank,0,-323,-105,83869,84052,183
102,0,blank,0,-323,-105,84052,84232,180
102,0,blank,0,-323,-105,84232,84411,179
102,0,blank,0,-323,-105,84411,84588,177
102,0,blank,0,-323,-105,84588,84764,176
102,0,blank,0,-323,-105,84764,84939,175
102,0,blank,0,-323,-105,84939,85116,177
102,0,blank,0,-323,-105,85116,85313,197
102,0,blank,0,-323,-105,85313,85494,181
102,0,blank,0,-323,-105,85494,85633,139
102,0,blank,0,-323,-105,85633,85810,177
102,0,blank,0,-323,-105,85810,86005,195
102,0,blank,0,-323,-105,86005,86188,183
102,0,blank,0,-323,-105,86188,86363,175
102,0,blank,0,-323,-105,86363,86556,193
102,0,blank,0,-323,-105,86556,86729,173
102,0,blank,0,-323,-105,86729,86869,140
102,0,blank,0,-323,-105,86869,87033,164
102,0,blank,0,-323,-105,87033,87221,188
102,0,blank,0,-323,-105,87221,87417,196
102,0,blank,0,-323,-105,87899,88075,176
102,0,blank,0,-323,-105,88075,88256,181
102,0,blank,0,-323,-105,88256,88448,192
102,0,blank,0,-323,-105,88448,88613,165
102,0,blank,0,-323,-105,88613,88951,338
102,0,blank,0,-323,-105,88951,89129,178
102,0,blank,0,-323,-105,89129,89311,182
102,0,blank,0,-323,-105,89311,89496,185
102,0,blank,0,-323,-105,89496,89599,103
102,0,blank,0,-323,-105,89599,89767,168
102,0,blank,0,-323,-105,89767,89864,97
102,0,blank,0,-323,-105,89864,89999,135
102,0,blank,0,-323,-105,89999,90302,303
102,0,blank,0,-323,-105,90302,90459,157
102,0,blank,0,-323,-105,90459,90652,193
102,0,blank,0,-323,-105,90652,90759,107
102,0,blank,0,-323,-105,90759,91317,558
102,0,blank,0,-323,-105,91317,91479,162
102,39,(,245,119.0329,262.8629,91500,91528,28
102,0,blank,0,330.6859,246.4196,92010,92042,32
102,0,blank,0,284.3565,343.8553,92419,92449,30
102,41,list,259,265.515,308.4824,92481,92511,30
102,41,list,259,143.71995,300.1941,92960,93021,61
102,41,list,259,145.1906,306.447,93081,93112,31
102,0,blank,0,204.0105,288.9272,93174,93205,31
102,0,blank,0,-323,-105,93454,93561,107
102,0,blank,0,225.6718,332.4315,93698,93724,26
102,0,blank,0,204.4205,308.3585,93760,93790,30
102,41,<=,258,227.6466,309.8425,93977,94011,34
102,0,blank,0,174.3723,294.380466666667,94103,94196,93
102,0,blank,0,173.0452,325.6433,94258,94289,31
102,41,list,259,268.95855,304.72125,94684,94743,59
102,41,<=,258,228.9185,304.56835,94829,94949,120
102,41,list,259,281.9872,304.761,95419,95450,31
102,0,blank,0,289.7562,330.3717,95481,95512,31
102,0,blank,0,281.0707,335.2989,95574,95604,30
102,0,blank,0,370.6755,310.1888,96001,96065,64
102,43,=,269,210.57815,353.86615,96289,96352,63
102,0,blank,0,218.4815,353.91395,96449,96513,64
102,43,list,270,224.1565,358.766,96610,96642,32
102,0,blank,0,285.2779,341.7573,96706,96738,32
102,0,blank,0,310.1436,369.4398,96899,96928,29
102,0,blank,0,296.9837,366.5475,96960,96992,32
102,0,blank,0,317.1777,339.6697,97087,97118,31
102,0,blank,0,366.466,354.3331,97245,97277,32
102,0,blank,0,191.23915,379.1327,97438,97499,61
102,0,blank,0,207.78025,389.9671,97561,97624,63
102,0,blank,0,204.2971,398.80505,97689,97751,62
102,43,list,270,232.6559,359.2766,97782,97813,31
102,0,blank,0,171.1323,444.424366666667,98353,98452,99
102,48,[,287,168.9417,463.1893,98484,98516,32
102,48,],289,185.8785,456.42555,98580,98641,61
102,0,blank,0,259.72105,476.14865,98857,98918,61
102,0,blank,0,307.4641,518.6112,98979,99010,31
102,0,blank,0,-323,-105,99073,99235,162
102,0,blank,0,326.4725,459.8049,99413,99444,31
102,0,blank,0,329.6512,474.7922,99505,99535,30
102,0,blank,0,288.936,448.5632,99565,99596,31
102,0,blank,0,217.166,485.0675,99687,99717,30
102,0,blank,0,211.6101,486.6514,99838,99870,32
102,0,blank,0,194.6343,489.0026,99987,100016,29
102,0,blank,0,187.4433,505.3217,100046,100076,30
102,0,blank,0,148.5647,555.9404,100281,100311,30
102,0,blank,0,140.7026,535.6574,100430,100490,60
102,0,blank,0,140.6254,591.8274,100607,100637,30
102,0,blank,0,157.0323,598.8405,100725,100754,29
102,0,blank,0,134.2623,550.0074,100873,100903,30
102,0,blank,0,239.0687,638.3073,101409,101439,30
102,0,blank,0,221.6165,638.36795,101468,101554,86
102,0,blank,0,311.8085,662.1168,102233,102262,29
102,0,blank,0,330.8276,639.3046,102353,102414,61
102,0,blank,0,331.7937,633.516475,102475,102596,121
102,0,blank,0,337.4196,638.9079,102626,102656,30
102,0,blank,0,333.2352,649.3807,102808,102837,29
102,0,blank,0,317.5002,687.0504,102867,102897,30
102,0,blank,0,290.4316,681.9256,102986,103016,30
102,0,blank,0,173.3696,673.4507,103075,103105,30
102,0,blank,0,228.8623,694.3914,103135,103164,29
102,0,blank,0,208.071,703.0635,103282,103311,29
102,0,blank,0,378.7787,664.7471,103461,103491,30
102,0,blank,0,372.2458,649.3314,103703,103733,30
102,0,blank,0,353.996733333333,644.509033333333,103855,103946,91
102,0,blank,0,343.1855,632.4368,103976,104007,31
102,0,blank,0,396.6503,626.7831,104097,104128,31
102,0,blank,0,418.1053,629.8873,104191,104221,30
102,0,blank,0,405.77765,630.64895,104253,104314,61
102,0,blank,0,216.2733,667.624,104497,104557,60
102,0,blank,0,-323,-105,104647,104791,144
102,0,blank,0,-323,-105,104791,104906,115
102,0,blank,0,996.653,443.8148,104957,104991,34
102,0,blank,0,1015.938,439.7134,105053,105092,39
102,0,blank,0,1028.391,450.6143,105279,105308,29
103,0,blank,0,246.3546,578.4092,106739,106764,25
103,0,blank,0,250.4428,568.78595,106935,106991,56
103,0,blank,0,199.9782,629.2617,107521,107550,29
103,0,blank,0,206.6836,670.5345,107608,107637,29
103,71,temp,385,185.2578,650.4781,107724,107753,29
103,0,blank,0,140.0355,698.6391,108818,108844,26
103,0,blank,0,83.1123,694.1852,108873,108902,29
103,0,blank,0,1042.861,661.1627,109301,109332,31
103,0,blank,0,1040.956,639.4614,109392,109423,31
103,0,blank,0,1020.891,176.7423,110276,110364,88
103,0,blank,0,1019.293,194.8316,110513,110576,63
104,0,blank,0,348.8029,174.6047,114576,114639,63
104,25,high,147,138.1754,190.6944,114755,114786,31
104,25,high,147,160.7278,193.0951,114879,114909,30
104,0,blank,0,155.2085,210.3253,114941,114972,31
104,0,blank,0,204.3791,185.9708,115160,115190,30
104,0,blank,0,298.2515,98.4916,115285,115318,33
104,0,blank,0,306.9562,110.3131,115381,115414,33
104,0,blank,0,366.8615,139.9232,115856,115886,30
104,0,blank,0,163.5258,114.2614,115947,115979,32
104,0,blank,0,171.7908,111.5963,116138,116169,31
104,25,),148,175.69955,182.8646,116201,116264,63
104,0,blank,0,185.5196,173.7997,116393,116425,32
104,0,blank,0,186.5622,200.5993,116554,116585,31
104,0,blank,0,191.3006,206.9164,116961,117026,65
104,0,blank,0,114.3477,153.0732,117313,117377,64
104,0,blank,0,120.5676,159.1939,117658,117722,64
104,30,mergeSort,178,163.048275,297.4044,118110,118235,125
104,30,list,180,221.1573,308.9046,118359,118391,32
104,30,list,180,217.7098,308.898833333333,118516,118608,92
104,0,blank,0,303.9375,291.4902,118753,118783,30
104,0,blank,0,299.7579,291.3494,118948,118978,30
104,30,mergeSort,178,162.1395,310.2061,119009,119038,29
104,0,blank,0,169.6395,319.4891,119132,119164,32
104,0,blank,0,186.1881,188.7615,119383,119415,32
104,0,blank,0,118.6945,148.8972,119576,119608,32
104,0,blank,0,123.1456,173.1759,119672,119704,32
104,0,blank,0,348.0488,101.4436,119956,119989,33
104,0,blank,0,350.0668,99.714,120053,120085,32
104,0,blank,0,320.9029,95.4657,120118,120149,31
104,22,low,134,322.597,133.9651,120279,120311,32
104,0,blank,0,331.3282,103.8796,120343,120375,32
104,0,blank,0,316.0927,112.8649,120407,120439,32
104,0,blank,0,324.7665,74.7141,120472,120504,32
104,0,blank,0,319.73245,109.69495,120600,120727,127
104,22,low,134,323.1306,121.5592,120790,120822,32
104,0,blank,0,316.3273,106.3011,120886,120918,32
104,0,blank,0,350.6619,91.2247,120981,121013,32
104,0,blank,0,-323,-105,121078,121185,107
104,0,blank,0,358.217,111.7064,121554,121586,32
104,22,int,136,354.4653,125.6333,121650,121682,32
104,22,int,136,356.4185,126.6703,121810,121841,31
104,25,high,147,171.1065,199.0813,122008,122097,89
104,0,blank,0,165.554,203.2813,122097,122216,119
104,0,blank,0,-323,-105,122314,122488,174
104,0,blank,0,381.747866666667,120.727566666667,122653,122748,95
104,0,blank,0,177.66755,209.22995,123065,123129,64
104,25,high,147,159.2783,192.3254,123257,123289,32
104,24,mid,141,112.54,162.3507,123480,123512,32
104,22,int,136,163.4069,120.4812,123605,123636,31
104,0,blank,0,163.0861,108.8187,123699,123730,31
104,0,blank,0,168.9364,153.5656,123793,123825,32
104,0,blank,0,193.8873,104.5144,123889,123920,31
104,0,blank,0,163.6997,53.0459,123951,123982,31
104,0,blank,0,194.1035,87.929,124077,124107,30
104,33,int,205,174.5521,375.2752,124262,124292,30
104,0,blank,0,194.3627,388.773,124412,124442,30
104,0,blank,0,151.7515,435.7255,124680,124710,30
104,0,blank,0,211.556533333333,512.702966666667,124798,124976,178
104,0,blank,0,206.601433333333,397.3714,125034,125126,92
104,29,partition,169,168.9176,272.3412,125189,125249,60
104,30,list,180,187.42665,300.54175,125281,125343,62
104,29,partition,169,164.9568,282.8795,125374,125406,32
104,0,blank,0,181.7566,318.0827,125437,125467,30
104,30,(,179,180.7345,302.15435,125530,125593,63
104,0,blank,0,196.7607,328.7714,125624,125654,30
104,29,list,171,213.7642,275.4192,126001,126031,30
104,0,blank,0,161.140833333333,396.616666666667,126154,126244,90
104,33,int,205,159.98215,371.23695,126393,126455,62
104,30,mergeSort,178,148.17,298.1786,126517,126548,31
104,0,blank,0,163.5497,346.0952,126761,126791,30
104,29,high,175,339.62195,285.9652,127191,127253,62
104,27,+,154,203.5622,240.1276,127440,127471,31
104,28,(,161,182.68735,250.56795,127565,127627,62
104,27,low,153,171.8461,246.4936,127722,127753,31
104,29,list,171,194.2398,273.4407,127784,127816,32
104,28,list,162,203.507233333333,255.8817,127847,127943,96
104,0,blank,0,-323,-105,128101,128179,78
104,0,blank,0,188.9619,236.88395,128388,128451,63
104,0,blank,0,154.43525,145.38145,128483,128608,125
104,22,(,127,149.5197,135.3245,128828,128859,31
104,28,list,162,200.0728,256.9742,129202,129233,31
104,0,blank,0,292.09655,259.71975,129448,129511,63
104,28,),167,324.69255,258.18125,129636,129700,64
104,29,high,175,335.46985,274.3798,129793,129855,62
104,30,list,180,189.1033,302.5095,129917,129948,31
104,29,list,171,198.648,290.1249,129980,130011,31
104,0,blank,0,225.7347,317.6504,130135,130167,32
104,0,blank,0,204.6411,315.2839,130381,130413,32
104,0,blank,0,289.3795,265.8619,130628,130660,32
104,29,comma,174,288.1354,273.7709,130724,130755,31
104,0,blank,0,202.8289,314.5945,130818,130849,31
104,0,blank,0,158.5162,151.7116,131066,131097,31
104,0,blank,0,179.4828,140.8826,131344,131375,31
104,0,blank,0,158.5879,80.8393,131562,131626,64
104,0,blank,0,180.2033,59.044,131751,131783,32
104,0,blank,0,302.8101,0.665000000000006,132033,132065,32
104,0,blank,0,305.272,53.7286,132161,132194,33
104,0,blank,0,312.6869,7.3918,132225,132257,32
104,0,blank,0,-323,-105,132448,132555,107
104,0,blank,0,1070.4825,414.7308,132685,132736,51
104,0,blank,0,1044.524,472.4745,132799,132830,31
104,0,blank,0,280.9324,520.3336,133018,133050,32
104,39,mi,246,280.6188,507.6221,133116,133146,30
104,0,blank,0,228.8192,464.6703,133238,133269,31
104,0,blank,0,213.0862,440.8043,133301,133333,32
104,0,blank,0,206.8555,448.7709,133396,133427,31
104,0,blank,0,220.7483,443.5939,133459,133490,31
104,35,comma,217,206.1793,407.5384,133520,133550,30
104,0,blank,0,1018.892,247.45405,133864,133927,63
104,0,blank,0,1001.388,283.0986,133959,133991,32
104,0,blank,0,1030.43066666667,405.489066666667,134279,134375,96
104,0,blank,0,1042.9595,399.7529,134535,134626,91
105,0,blank,0,-323,-105,142012,142196,184
105,0,blank,0,-323,-105,142196,142319,123
105,0,blank,0,-323,-105,142591,142765,174
105,0,blank,0,310.5638,199.41866,142814,142973,159
105,0,blank,0,323.0696,231.4008,143036,143067,31
105,0,blank,0,413.6465,203.8529,143163,143195,32
105,22,high,137,397.7133,173.8605,143227,143259,32
105,0,blank,0,350.019,209.9349,143322,143354,32
105,0,blank,0,366.8746,209.9732,143418,143451,33
105,0,blank,0,-323,-105,143483,143675,192
105,0,blank,0,-323,-105,143675,143862,187
105,0,blank,0,-323,-105,143862,144039,177
105,0,blank,0,-323,-105,144039,144222,183
105,0,blank,0,-323,-105,144222,144414,192
105,0,blank,0,-323,-105,144414,144644,230
105,0,blank,0,-323,-105,144644,144838,194
105,0,blank,0,-323,-105,144838,144970,132
105,0,blank,0,-323,-105,144970,145188,218
105,0,blank,0,-323,-105,145188,145413,225
105,28,partition,160,131.3439,318.8135,145436,145462,26
105,28,partition,160,124.099566666667,322.014566666667,145543,145645,102
105,30,mergeSort,178,100.374133333333,357.790233333333,145707,145890,183
105,0,blank,0,132.7964,376.2966,145920,145951,31
105,29,partition,169,98.869,342.6021,146105,146134,29
105,29,partition,169,95.8676333333333,337.553733333333,146315,146406,91
105,28,partition,160,90.0865,317.593,146436,146465,29
105,30,mergeSort,178,137.28885,355.1101,146495,146555,60
105,29,partition,169,136.35125,347.7273,146644,146705,61
105,0,blank,0,115.54995,406.466,147006,147066,60
105,0,blank,0,122.2148,401.1404,147125,147156,31
105,0,blank,0,81.2816,411.58765,147185,147247,62
105,33,mergeSort,192,82.2943666666667,425.7227,147307,147398,91
105,0,blank,0,69.8907,414.8503,147611,147641,30
105,33,mergeSort,192,77.1718,418.571,147672,147703,31
105,0,blank,0,104.0505,383.7532,147765,147797,32
105,0,blank,0,110.9423,387.9327,147858,147920,62
105,0,blank,0,112.1573,406.926,147950,147981,31
105,30,mergeSort,178,117.759,353.8088,148139,148169,30
105,30,mergeSort,178,112.8007,358.6956,148261,148293,32
105,29,partition,169,100.4264,330.8033,148488,148521,33
105,30,mergeSort,178,92.7918,352.2377,148650,148682,32
105,0,blank,0,110.7732,372.2157,148966,148996,30
105,0,blank,0,132.49005,371.63595,149117,149178,61
105,0,blank,0,-323,-105,149349,149528,179
105,0,blank,0,-323,-105,149528,149706,178
105,0,blank,0,-323,-105,149706,149900,194
105,0,blank,0,-323,-105,149900,150091,191
105,0,blank,0,-323,-105,150091,150289,198
105,0,blank,0,-323,-105,150289,150485,196
105,0,blank,0,-323,-105,150485,150677,192
105,0,blank,0,-323,-105,150677,150785,108
105,0,blank,0,-323,-105,150785,150964,179
105,0,blank,0,-323,-105,150964,151135,171
105,0,blank,0,-323,-105,151135,151299,164
105,0,blank,0,-323,-105,151686,151867,181
105,0,blank,0,-323,-105,151867,151929,62
105,28,partition,160,112.932766666667,316.4726,151960,152043,83
105,0,blank,0,-323,-105,152080,152268,188
105,0,blank,0,-323,-105,152268,152401,133
105,0,blank,0,139.7814,448.8627,152430,152464,34
105,33,mergeSort,192,141.4527,433.107466666667,152502,152625,123
105,0,blank,0,-61.2083,424.4629,152856,152899,43
105,35,comma,217,138.84095,468.2225,152975,153055,80
105,0,blank,0,149.719333333333,473.935066666667,153095,153211,116
105,0,blank,0,-323,-105,153250,153441,191
105,28,(,161,181.7834,306.2685,153515,153542,27
105,28,list,162,188.8891,322.1308,153634,153665,31
105,28,list,162,188.3575,314.1413,153696,153728,32
105,27,high,155,227.56665,285.5428,153759,153821,62
105,22,partition,126,56.2246,182.4725,153980,154012,32
105,0,blank,0,52.9816,204.6497,154043,154075,32
105,22,partition,126,62.1245,184.2295,154106,154137,31
105,0,blank,0,73.7713,204.7748,154263,154295,32
105,22,partition,126,72.9157,189.639,154327,154360,33
105,24,mid,141,91.7940666666667,232.5979,154425,154621,196
105,0,blank,0,82.3466,163.2357,154717,154749,32
105,0,blank,0,78.2679,194.7027,154782,154815,33
105,0,blank,0,76.0646,172.2687,154848,154880,32
105,29,partition,169,111.3949,337.337066666667,154946,155042,96
105,28,partition,160,141.67974,307.9899,155138,155296,158
105,27,low,153,176.7254,297.7352,155327,155359,32
105,28,list,162,188.53285,309.85625,155390,155454,64
105,0,blank,0,-323,-105,155525,155641,116
105,0,blank,0,121.2873,280.8018,156039,156082,43
105,0,blank,0,-323,-105,156118,156305,187
105,0,blank,0,-323,-105,156305,156491,186
105,0,blank,0,-323,-105,156491,156678,187
105,0,blank,0,-323,-105,156678,156854,176
105,0,blank,0,-323,-105,156854,157052,198
105,0,blank,0,-323,-105,157052,157233,181
105,0,blank,0,-323,-105,157233,157262,29
105,27,low,153,157.9796,287.2494,158007,158049,42
105,0,blank,0,186.0107,252.5714,158130,158173,43
105,25,high,147,167.1353,251.032,158206,158238,32
105,0,blank,0,176.0175,230.2458,158333,158363,30
105,0,blank,0,-323,-105,158488,158683,195
105,0,blank,0,-323,-105,158683,158721,38
105,0,blank,0,161.81226,270.42574,158746,158918,172
105,0,blank,0,160.292466666667,274.714483333333,158918,159107,189
105,0,blank,0,150.292,276.3282,159107,159138,31
105,0,blank,0,158.8242,230.9785,159434,159472,38
105,25,high,147,162.032,249.5431,159754,159785,31
105,0,blank,0,162.3619,262.5285,159818,159850,32
105,27,high,155,217.4351,294.6897,159915,159948,33
105,28,list,162,211.627,313.6153,160012,160042,30
105,0,blank,0,-323,-105,160203,160395,192
105,0,blank,0,-323,-105,160395,160548,153
105,0,blank,0,-323,-105,160548,160737,189
105,0,blank,0,-323,-105,160737,160930,193
105,0,blank,0,-323,-105,160930,161170,240
105,0,blank,0,-323,-105,161170,161367,197
105,0,blank,0,-323,-105,161367,161546,179
105,0,blank,0,-323,-105,161546,161622,76
105,0,blank,0,338.4318,359.6998,162590,162620,30
105,28,mid,166,315.91145,315.0534,162870,163052,182
105,0,blank,0,-323,-105,163270,163400,130
105,0,blank,0,205.8883,276.2026,163514,163540,26
105,28,low,164,265.3718,313.5722,163689,163722,33
105,28,list,162,217.51005,311.58215,163880,163943,63
105,28,list,162,199.7617,314.0598,164005,164036,31
105,0,blank,0,279.4868,334.8633,164253,164283,30
105,28,low,164,261.7017,319.0097,165182,165211,29
105,27,high,155,251.3283,283.72095,165453,165513,60
105,27,/,157,283.215,301.0193,166063,166094,31
105,28,mid,166,304.16615,315.36715,166124,166184,60
105,28,mid,166,320.6145,321.78545,166338,166402,64
105,28,),167,324.4135,316.4481,166430,166460,30
105,0,blank,0,326.9093,294.2406,166492,166522,30
105,28,low,164,269.15085,305.5822,166735,166797,62
105,0,blank,0,264.4074,295.9604,166887,166917,30
105,0,blank,0,282.3381,344.479,167190,167220,30
105,30,low,182,270.5887,350.4353,167251,167282,31
105,0,blank,0,-323,-105,167463,167642,179
105,0,blank,0,-323,-105,167642,167820,178
105,0,blank,0,-323,-105,167820,167957,137
105,27,high,155,250.5461,297.6182,167988,168038,50
105,0,blank,0,382.6869,321.9239,169003,169028,25
105,27,high,155,223.8223,298.4996,169623,169653,30
105,28,comma,165,229.059,316.6958,169777,169808,31
105,28,list,162,223.907,306.8713,169869,169900,31
105,0,blank,0,289.496,359.4815,169930,169961,31
105,0,blank,0,282.5389,332.3347,170087,170118,31
105,0,blank,0,269.0027,348.7042,170243,170273,30
105,0,blank,0,199.2922,379.0857,170603,170635,32
105,29,comma,174,225.3971,329.4131,170793,170824,31
105,0,blank,0,-323,-105,170888,171021,133
105,29,(,170,181.7115,342.7137,171175,171206,31
105,0,blank,0,166.4108,268.53255,172405,172468,63
105,28,list,162,186.8683,317.7619,172848,172878,30
105,27,high,155,251.4699,289.9031,173004,173035,31
105,0,blank,0,293.7697,195.0577,173099,173131,32
105,22,comma,135,258.965,185.759,173323,173349,26
105,28,(,161,177.5034,320.4442,174054,174085,31
105,0,blank,0,-323,-105,174399,174508,109
105,29,comma,174,286.3597,338.5296,174867,174898,31
105,0,blank,0,289.3297,322.6863,175019,175050,31
105,29,mid,173,252.062,339.4914,175264,175295,31
105,30,low,182,256.9564,360.5736,175358,175388,30
105,28,comma,165,227.2369,311.1501,175665,175695,30
105,29,),176,344.5918,330.0436,176162,176194,32
105,29,high,175,312.968,342.2951,176501,176532,31
105,30,(,179,178.2585,350.8048,176841,176873,32
105,30,list,180,196.7817,364.5847,176965,176995,30
105,0,blank,0,190.7582,246.9576,177699,177729,30
105,29,mid,173,263.4448,346.1377,178402,178432,30
105,27,+,154,199.9876,295.3372,178678,178709,31
105,0,blank,0,194.8954,228.8106,178861,178892,31
105,0,blank,0,196.2342,218.0973,179047,179077,30
105,0,blank,0,213.2935,254.4568,179139,179200,61
105,28,list,162,219.1793,320.2564,179411,179441,30
105,27,/,157,278.0835,298.8603,180485,180513,28
105,27,(,152,150.9947,289.4496,181098,181127,29
105,28,partition,160,167.2633,321.6334,181188,181218,30
105,28,list,162,186.2773,311.3298,181278,181308,30
105,28,low,164,250.0549,325.3413,181398,181458,60
105,0,blank,0,213.2993,234.6196,181573,181602,29
105,0,blank,0,210.4252,243.3318,181809,181871,62
105,0,blank,0,181.1939,233.4544,182080,182113,33
105,0,blank,0,205.726,244.5107,182234,182264,30
105,0,blank,0,286.3693,298.9742,182524,182584,60
105,0,blank,0,283.1531,334.7266,182673,182706,33
105,0,blank,0,322.4509,301.235,182817,182842,25
105,29,),176,346.0545,336.7562,182929,182959,30
105,28,),167,324.4344,313.0596,183019,183044,25
105,0,blank,0,358.5653,316.997,183178,183374,196
105,0,blank,0,348.638633333333,303.6836,183374,183557,183
105,30,high,186,354.7357,357.2373,183749,183779,30
105,0,blank,0,-323,-105,183865,184045,180
105,0,blank,0,-323,-105,184045,184227,182
105,0,blank,0,-323,-105,184227,184414,187
105,0,blank,0,-323,-105,184414,184603,189
105,0,blank,0,451.7896,208.9847,184676,184704,28
105,0,blank,0,455.357,246.16,184733,184765,32
105,0,blank,0,-323,-105,184795,184934,139
105,0,blank,0,378.2662,343.2597,185040,185101,61
105,30,),187,388.5532,351.3723,185342,185372,30
105,0,blank,0,365.2301,332.3428,185492,185522,30
105,0,blank,0,-323,-105,185583,185764,181
105,0,blank,0,-323,-105,185764,185944,180
105,0,blank,0,-323,-105,185944,186123,179
105,0,blank,0,-323,-105,186123,186299,176
105,0,blank,0,-323,-105,186299,186491,192
105,0,blank,0,-323,-105,186491,186640,149
105,0,blank,0,-323,-105,186640,186829,189
105,0,blank,0,-323,-105,186829,187002,173
105,0,blank,0,-323,-105,187002,187173,171
105,0,blank,0,-323,-105,187173,187364,191
105,0,blank,0,-323,-105,187364,187532,168
105,0,blank,0,-323,-105,187532,187723,191
105,0,blank,0,-323,-105,187723,187921,198
105,0,blank,0,-323,-105,187921,188102,181
105,0,blank,0,-323,-105,188102,188286,184
105,0,blank,0,-323,-105,188286,188426,140
105,0,blank,0,-323,-105,188426,188531,105
105,0,blank,0,-323,-105,188531,188697,166
105,0,blank,0,-323,-105,188697,188850,153
105,0,blank,0,-323,-105,188850,189030,180
105,0,blank,0,-323,-105,189030,189219,189
105,0,blank,0,-323,-105,189219,189418,199
105,0,blank,0,-323,-105,189418,189578,160
105,0,blank,0,-323,-105,189578,189715,137
105,0,blank,0,-323,-105,189715,189859,144
105,0,blank,0,-323,-105,189859,190005,146
105,0,blank,0,-323,-105,190005,190187,182
105,0,blank,0,-323,-105,190187,190372,185
105,0,blank,0,-323,-105,190372,190561,189
105,0,blank,0,-323,-105,190561,190727,166
105,0,blank,0,-323,-105,190727,190798,71
105,0,blank,0,-323,-105,190798,190961,163
105,0,blank,0,-323,-105,190961,191014,53
105,0,blank,0,-323,-105,191014,191231,217
105,0,blank,0,-323,-105,191231,191380,149
105,0,blank,0,-323,-105,191380,191567,187
105,0,blank,0,-323,-105,191567,191751,184
105,0,blank,0,-323,-105,191751,191930,179
105,0,blank,0,-323,-105,191930,191990,60
105,0,blank,0,-323,-105,191990,192392,402
105,0,blank,0,-323,-105,192392,192681,289
105,0,blank,0,-323,-105,192681,193279,598
105,0,blank,0,-323,-105,193279,193462,183
105,0,blank,0,-323,-105,193462,193500,38
105,0,blank,0,-323,-105,193647,193827,180
105,0,blank,0,-323,-105,193827,194003,176
105,0,blank,0,-323,-105,194003,194124,121
105,0,blank,0,-323,-105,194124,194253,129
105,0,blank,0,-323,-105,194253,194444,191
105,0,blank,0,-323,-105,194444,194623,179
105,0,blank,0,-323,-105,194623,194802,179
105,0,blank,0,-323,-105,194802,194929,127
105,0,blank,0,-323,-105,194929,195176,247
105,0,blank,0,-323,-105,195176,195208,32
105,0,blank,0,-323,-105,195208,195820,612
105,0,blank,0,-323,-105,195820,196430,610
105,0,blank,0,-323,-105,196430,196612,182
105,0,blank,0,-323,-105,196612,196791,179
105,0,blank,0,-323,-105,196791,196840,49
105,0,blank,0,-323,-105,196840,197235,395
105,0,blank,0,-323,-105,197235,197262,27
105,0,blank,0,-323,-105,197262,197675,413
105,0,blank,0,-323,-105,197675,198085,410
105,0,blank,0,-323,-105,198085,198217,132
105,0,blank,0,-323,-105,198217,198356,139
105,0,blank,0,-323,-105,198356,198496,140
105,0,blank,0,-323,-105,198496,198745,249
105,0,blank,0,-323,-105,198745,198937,192
105,0,blank,0,-323,-105,198937,199100,163
105,29,high,175,310.3556,333.599,200059,200117,58
105,0,blank,0,-323,-105,200261,200442,181
105,0,blank,0,-323,-105,200442,200622,180
105,0,blank,0,-323,-105,200622,200802,180
105,0,blank,0,-323,-105,200802,200984,182
105,0,blank,0,-323,-105,200984,201162,178
105,0,blank,0,-323,-105,201162,201341,179
105,0,blank,0,-323,-105,201341,201540,199
105,0,blank,0,-323,-105,201540,201672,132
105,0,blank,0,-323,-105,201672,201845,173
105,0,blank,0,-323,-105,201845,202018,173
105,0,blank,0,-323,-105,202018,202390,372
105,0,blank,0,-323,-105,202390,202571,181
105,0,blank,0,-323,-105,202571,202755,184
105,0,blank,0,-323,-105,202755,202938,183
105,0,blank,0,-323,-105,202938,203116,178
105,0,blank,0,-323,-105,203116,203188,72
105,0,blank,0,-323,-105,203188,203475,287
105,0,blank,0,-323,-105,203475,203732,257
105,0,blank,0,-323,-105,204496,204678,182
105,0,blank,0,-323,-105,204678,204739,61
105,0,blank,0,-323,-105,204739,205029,290
105,0,blank,0,-323,-105,205029,205312,283
105,0,blank,0,-323,-105,205312,205407,95
105,0,blank,0,-323,-105,205407,205668,261
105,0,blank,0,-323,-105,205668,205861,193
105,0,blank,0,-323,-105,205861,206030,169
105,0,blank,0,-323,-105,206030,206214,184
105,0,blank,0,-323,-105,206214,206408,194
105,0,blank,0,-323,-105,206408,206585,177
105,0,blank,0,-323,-105,206585,206746,161
105,0,blank,0,-323,-105,206746,206912,166
105,0,blank,0,-323,-105,206912,207093,181
105,0,blank,0,-323,-105,207093,207261,168
105,0,blank,0,-323,-105,207261,207549,288
105,0,blank,0,-323,-105,207549,207838,289
105,0,blank,0,-323,-105,207838,207952,114
105,27,high,155,223.5795,303.9617,207969,207999,30
105,28,partition,160,165.901825,308.26845,208066,208190,124
105,0,blank,0,282.273,359.7738,208223,208381,158
105,30,comma,185,281.725533333333,363.033066666667,208412,208506,94
105,30,comma,185,279.601016666667,358.340983333333,208538,208724,186
105,30,comma,185,226.3135,357.4772,208756,208821,65
105,0,blank,0,-323,-105,209242,209417,175
105,0,blank,0,-323,-105,209417,209597,180
105,0,blank,0,-323,-105,209597,209783,186
105,0,blank,0,-323,-105,209783,209952,169
105,0,blank,0,-323,-105,209952,210122,170
105,0,blank,0,-323,-105,210122,210291,169
105,0,blank,0,-323,-105,210291,210598,307
105,0,blank,0,-323,-105,210598,210903,305
105,0,blank,0,-323,-105,210903,211088,185
105,0,blank,0,-323,-105,211088,211281,193
105,0,blank,0,-323,-105,211281,211459,178
105,0,blank,0,-323,-105,211459,211635,176
105,0,blank,0,-323,-105,211635,211804,169
105,0,blank,0,-323,-105,211804,211992,188
105,0,blank,0,-323,-105,211992,212168,176
105,0,blank,0,-323,-105,212168,212315,147
105,0,blank,0,-323,-105,212315,212504,189
105,0,blank,0,-323,-105,212504,212659,155
105,0,blank,0,-323,-105,212659,213066,407
105,0,blank,0,-323,-105,213066,213098,32
105,0,blank,0,-323,-105,213098,213426,328
105,0,blank,0,-323,-105,213426,213749,323
105,0,blank,0,-323,-105,213749,213926,177
105,0,blank,0,-323,-105,213926,214108,182
105,0,blank,0,-323,-105,214108,214300,192
105,0,blank,0,-323,-105,214300,214475,175
105,0,blank,0,-323,-105,214475,214644,169
105,0,blank,0,-323,-105,214644,214828,184
105,0,blank,0,-323,-105,214828,214896,68
105,0,blank,0,-323,-105,214896,215123,227
105,0,blank,0,-323,-105,215123,215355,232
105,0,blank,0,-323,-105,215355,215530,175
105,0,blank,0,-323,-105,215530,215588,58
105,0,blank,0,-323,-105,215588,215850,262
105,0,blank,0,-323,-105,215850,215880,30
105,0,blank,0,-323,-105,215880,216067,187
105,0,blank,0,-323,-105,216067,216527,460
105,0,blank,0,-323,-105,216527,216709,182
105,0,blank,0,-323,-105,216709,216900,191
105,0,blank,0,-323,-105,216900,217079,179
105,0,blank,0,-323,-105,217079,217139,60
105,0,blank,0,-323,-105,217139,217281,142
105,0,blank,0,-323,-105,217281,217367,86
105,0,blank,0,-323,-105,217367,217509,142
105,0,blank,0,-323,-105,217509,217642,133
105,0,blank,0,-323,-105,217642,217837,195
105,0,blank,0,-323,-105,217837,218007,170
105,0,blank,0,-323,-105,218007,218178,171
105,0,blank,0,-323,-105,218178,218370,192
105,0,blank,0,-323,-105,218370,218547,177
105,0,blank,0,-323,-105,218547,218725,178
105,0,blank,0,-323,-105,218725,218835,110
105,0,blank,0,265.2828,125.5022,219205,219249,44
105,16,size,104,197.9219,41.01915,219594,219669,75
105,15,"Aftermergesort:\n",93,131.1235,27.21785,219761,219823,62
105,15,"Aftermergesort:\n",93,125.7951,31.2102,219884,219915,31
105,0,blank,0,189.25918,-2.95656,219947,220105,158
105,0,blank,0,198.366925,-1.611875,220168,220292,124
105,0,blank,0,-323,-105,220354,220462,108
105,0,blank,0,216.4443,502.8837,220488,220513,25
105,0,blank,0,208.15985,444.808175,220540,220656,116
105,35,comma,217,205.3016,461.0682,220719,220782,63
105,0,blank,0,937.344,321.46375,220876,221064,188
105,0,blank,0,940.910666666667,324.3883,221064,221158,94
105,0,blank,0,976.815,332.3014,221190,221222,32
105,0,blank,0,983.734,342.358566666667,221253,221350,97
105,0,blank,0,991.9728,440.69052,221381,221538,157
105,0,blank,0,977.275833333333,441.202083333333,221665,221855,190
105,0,blank,0,990.3845,438.8263,221983,222047,64
105,0,blank,0,986.048,446.77495,222079,222206,127
105,0,blank,0,978.8356,446.2796,222270,222432,162
105,0,blank,0,981.687666666667,445.9758,222461,222554,93
106,0,blank,0,127.1492,59.521875,223117,223239,122
106,0,blank,0,128.1163,62.1825,223270,223300,30
106,33,mergeSort,192,97.4086666666667,89.8328333333333,223331,223511,180
106,33,mergeSort,192,97.8294,85.224,223511,223541,30
106,0,blank,0,132.728266666667,117.799933333333,223571,223661,90
106,0,blank,0,-323,-105,223691,223772,81
106,0,blank,0,242.72525,74.23235,223862,223954,92
106,33,int,205,346.8619,89.8366,224062,224183,121
106,33,low,200,309.4616,88.2891,224255,224293,38
106,33,low,200,304.329466666667,90.5441666666667,224321,224412,91
106,0,blank,0,89.9877,119.0403,224535,224567,32
106,35,i,210,86.69825,135.92115,224598,224721,123
106,0,blank,0,106.137633333333,128.981183333333,224781,224966,185
106,0,blank,0,108.4251,127.4789,224966,224996,30
106,0,blank,0,71.64405,118.49485,225027,225087,60
106,0,blank,0,72.9756,112.4891,225147,225177,30
106,0,blank,0,74.6288,132.3824,225208,225239,31
106,0,blank,0,76.73928,123.49768,225270,225423,153
106,0,blank,0,113.492766666667,120.276016666667,225485,225671,186
106,0,blank,0,115.77065,118.41845,225671,225733,62
106,0,blank,0,114.4397,114.19738,225764,225917,153
106,0,blank,0,148.0453,129.401033333333,225948,226040,92
106,0,blank,0,145.54765,127.28145,226071,226195,124
106,0,blank,0,-323,-105,226226,226411,185
106,0,blank,0,-323,-105,226411,226436,25
106,0,blank,0,165.59,116.532633333333,226462,226540,78
106,0,blank,0,165.22905,124.31045,226571,226633,62
106,0,blank,0,211.443716666667,120.140333333333,226662,226847,185
106,0,blank,0,207.72725,117.1123,226847,226909,62
106,0,blank,0,210.8458,127.8456,227002,227033,31
106,0,blank,0,225.36195,129.314383333333,227095,227280,185
106,35,temp,218,224.70216,141.5821,227280,227434,154
106,0,blank,0,-323,-105,227495,227678,183
106,0,blank,0,-323,-105,227678,227849,171
106,0,blank,0,-323,-105,227849,228042,193
106,0,blank,0,-323,-105,228042,228194,152
106,0,blank,0,-323,-105,228194,228367,173
106,0,blank,0,-323,-105,228367,228556,189
106,0,blank,0,-323,-105,228556,228624,68
106,0,blank,0,-323,-105,228624,228998,374
106,0,blank,0,-323,-105,228998,229062,64
106,0,blank,0,-323,-105,229062,229454,392
106,0,blank,0,-323,-105,229454,229776,322
106,0,blank,0,87.3223,157.8197,229800,229825,25
106,36,low,225,100.774233333333,165.50715,229882,230065,183
106,0,blank,0,93.7648,170.2498,230065,230095,30
106,36,=,224,83.2639,158.77665,230125,230186,61
106,0,blank,0,69.4927,160.0298,230216,230246,30
106,35,int,209,63.3,146.9587,230306,230336,30
106,36,lo,223,58.1216333333333,156.0959,230367,230458,91
106,36,low,225,109.7011,154.314325,230519,230643,124
106,0,blank,0,-323,-105,230704,230850,146
106,0,blank,0,-323,-105,230850,231036,186
106,0,blank,0,-323,-105,231036,231217,181
106,0,blank,0,-323,-105,231217,231396,179
106,0,blank,0,-323,-105,231396,231574,178
106,0,blank,0,-323,-105,231574,231755,181
106,0,blank,0,-323,-105,231755,231947,192
106,0,blank,0,-323,-105,231947,232124,177
106,0,blank,0,-323,-105,232124,232298,174
106,0,blank,0,-323,-105,232298,232543,245
106,0,blank,0,-323,-105,232543,232706,163
106,0,blank,0,-323,-105,232706,232911,205
106,0,blank,0,-323,-105,232911,233074,163
106,0,blank,0,-323,-105,233074,233214,140
106,0,blank,0,-323,-105,233214,233357,143
106,0,blank,0,-323,-105,233357,233553,196
106,0,blank,0,-323,-105,233553,233734,181
106,0,blank,0,-323,-105,233734,233857,123
106,0,blank,0,-323,-105,233857,234063,206
106,0,blank,0,-323,-105,234063,234255,192
106,0,blank,0,-323,-105,234255,234451,196
106,0,blank,0,-323,-105,234451,234577,126
106,0,blank,0,-323,-105,234577,234712,135
106,0,blank,0,-323,-105,234712,234880,168
106,0,blank,0,-323,-105,234880,235001,121
106,0,blank,0,-323,-105,235001,235273,272
106,0,blank,0,-323,-105,235273,235298,25
106,0,blank,0,-323,-105,235298,235708,410
106,0,blank,0,-323,-105,235708,236112,404
106,0,blank,0,-323,-105,236218,236417,199
106,0,blank,0,-323,-105,236417,236593,176
106,0,blank,0,-323,-105,236593,236790,197
106,0,blank,0,-323,-105,236790,236970,180
106,0,blank,0,-323,-105,236970,237063,93
106,0,blank,0,-323,-105,237063,237403,340
106,0,blank,0,-323,-105,237403,237432,29
106,0,blank,0,-323,-105,237432,237950,518
106,0,blank,0,-323,-105,237950,238138,188
106,0,blank,0,-323,-105,238138,238314,176
106,0,blank,0,299.6037,219.4574,239147,239189,42
106,0,blank,0,280.433,210.446,239294,239324,30
106,39,mi,246,280.51882,223.98306,239354,239506,152
106,39,<=,247,309.724816666667,227.138066666667,239536,239719,183
106,39,mi,246,283.13965,230.89445,239810,239870,60
106,0,blank,0,283.4563,216.4933,239900,239960,60
106,38,1,235,157.9494,203.4787,240020,240051,31
106,38,+,234,142.5929,208.265,240081,240112,31
106,0,blank,0,177.5938,206.12105,240295,240356,61
106,0,blank,0,-323,-105,240418,240601,183
106,0,blank,0,-323,-105,240601,240781,180
106,0,blank,0,-323,-105,240781,240955,174
106,0,blank,0,-323,-105,240955,241144,189
106,0,blank,0,-323,-105,241144,241310,166
106,0,blank,0,-323,-105,241310,241489,179
106,0,blank,0,-323,-105,241489,241694,205
106,0,blank,0,-323,-105,241694,241882,188
106,0,blank,0,-323,-105,241882,242012,130
106,0,blank,0,-323,-105,242012,242119,107
106,0,blank,0,-323,-105,242119,242248,129
106,0,blank,0,-323,-105,242248,242382,134
106,0,blank,0,-323,-105,242382,242580,198
106,0,blank,0,-323,-105,242580,242758,178
106,0,blank,0,-323,-105,242758,242939,181
106,0,blank,0,-323,-105,242939,243070,131
106,33,int,205,353.4012,103.88985,243157,243215,58
106,33,mid,203,410.903,87.97555,243304,243363,59
106,33,high,206,471.130633333333,91.6194333333333,243424,243515,91
106,0,blank,0,180.9638,141.1719,243575,243636,61
106,0,blank,0,183.42735,154.4425,243695,243756,61
106,0,blank,0,-323,-105,243816,243998,182
106,0,blank,0,-323,-105,243998,244193,195
106,0,blank,0,-323,-105,244193,244380,187
106,0,blank,0,-323,-105,244380,244518,138
106,0,blank,0,-323,-105,244518,244666,148
106,0,blank,0,-323,-105,244666,244816,150
106,0,blank,0,-323,-105,244816,245003,187
106,0,blank,0,-323,-105,245003,245199,196
106,0,blank,0,-323,-105,245199,245348,149
106,0,blank,0,-323,-105,245348,245475,127
106,0,blank,0,-323,-105,245475,245653,178
106,0,blank,0,-323,-105,245653,245850,197
106,0,blank,0,-323,-105,245850,246025,175
106,0,blank,0,-323,-105,246025,246205,180
106,0,blank,0,-323,-105,246205,246367,162
106,0,blank,0,-323,-105,246367,246611,244
106,0,blank,0,-323,-105,246611,246653,42
106,0,blank,0,-323,-105,246653,247172,519
106,0,blank,0,-323,-105,247172,247209,37
106,0,blank,0,-323,-105,247209,247464,255
106,0,blank,0,-323,-105,247464,247718,254
106,0,blank,0,-323,-105,247718,247905,187
106,0,blank,0,-323,-105,247905,248082,177
106,0,blank,0,-323,-105,248082,248260,178
106,0,blank,0,-323,-105,248260,248437,177
106,0,blank,0,-323,-105,248437,248617,180
106,0,blank,0,-323,-105,248617,248793,176
106,0,blank,0,-323,-105,248793,248972,179
106,0,blank,0,-323,-105,248972,249143,171
106,0,blank,0,-323,-105,249143,249331,188
106,0,blank,0,-323,-105,249331,249813,482
106,0,blank,0,-323,-105,249813,249995,182
106,0,blank,0,-323,-105,249995,250179,184
106,0,blank,0,-323,-105,250179,250201,22
106,0,blank,0,-323,-105,250201,250385,184
106,0,blank,0,-323,-105,250385,250583,198
106,0,blank,0,-323,-105,250583,250722,139
106,0,blank,0,-323,-105,250722,250872,150
106,0,blank,0,-323,-105,250872,251001,129
106,0,blank,0,-323,-105,251001,251121,120
106,0,blank,0,-323,-105,251121,251295,174
106,0,blank,0,-323,-105,251295,251471,176
106,0,blank,0,-323,-105,251471,251629,158
106,0,blank,0,-323,-105,251629,251789,160
106,0,blank,0,-323,-105,251789,251983,194
106,0,blank,0,-323,-105,251983,252140,157
106,0,blank,0,-323,-105,252140,252320,180
106,0,blank,0,-323,-105,252320,252481,161
106,0,blank,0,-323,-105,252481,252649,168
106,0,blank,0,-323,-105,252649,252698,49
106,0,blank,0,-323,-105,252698,252899,201
106,0,blank,0,-323,-105,252899,252931,32
106,0,blank,0,-323,-105,252931,253188,257
106,0,blank,0,-323,-105,253188,253376,188
106,0,blank,0,-323,-105,253376,253575,199
106,0,blank,0,-323,-105,253575,253736,161
106,0,blank,0,-323,-105,253736,253916,180
106,0,blank,0,-323,-105,253916,254083,167
106,0,blank,0,-323,-105,254083,254275,192
106,0,blank,0,-323,-105,254275,254440,165
106,0,blank,0,-323,-105,254440,254634,194
106,0,blank,0,-323,-105,254634,254831,197
106,0,blank,0,-323,-105,254831,255027,196
106,0,blank,0,-323,-105,255027,255224,197
106,0,blank,0,-323,-105,255224,255418,194
106,0,blank,0,-323,-105,255418,255596,178
106,0,blank,0,-323,-105,255596,255733,137
106,0,blank,0,-323,-105,255733,255911,178
106,0,blank,0,-323,-105,255911,256040,129
106,0,blank,0,-323,-105,256040,256128,88
106,0,blank,0,-323,-105,256128,256261,133
106,0,blank,0,-323,-105,256261,256431,170
106,0,blank,0,-323,-105,256431,256568,137
106,0,blank,0,-323,-105,256568,256684,116
106,0,blank,0,-323,-105,256684,256811,127
106,0,blank,0,-323,-105,256811,257004,193
106,0,blank,0,-323,-105,257004,257133,129
106,0,blank,0,-323,-105,257133,257218,85
106,0,blank,0,-323,-105,257218,257350,132
106,0,blank,0,-323,-105,257350,257535,185
106,0,blank,0,-323,-105,257535,257725,190
106,0,blank,0,-323,-105,257725,257923,198
106,0,blank,0,-323,-105,257923,258098,175
106,0,blank,0,-323,-105,258098,258251,153
106,0,blank,0,-323,-105,258251,258428,177
106,0,blank,0,-323,-105,258428,258559,131
106,0,blank,0,-323,-105,258559,258653,94
106,0,blank,0,-323,-105,258653,258827,174
106,0,blank,0,-323,-105,258827,259018,191
106,0,blank,0,-323,-105,259018,259170,152
106,0,blank,0,-323,-105,259170,259340,170
106,0,blank,0,-323,-105,259340,259523,183
106,0,blank,0,-323,-105,259523,259711,188
106,0,blank,0,-323,-105,259711,259897,186
106,0,blank,0,-323,-105,259897,260062,165
106,0,blank,0,-323,-105,260062,260239,177
106,0,blank,0,-323,-105,260239,260396,157
106,0,blank,0,-323,-105,260396,260460,64
106,0,blank,0,-323,-105,260460,260601,141
106,0,blank,0,-323,-105,260601,260733,132
106,0,blank,0,-323,-105,260733,260923,190
106,0,blank,0,-323,-105,260923,261185,262
106,0,blank,0,-323,-105,261185,261450,265
106,0,blank,0,-323,-105,261450,261749,299
106,0,blank,0,-323,-105,261749,261936,187
106,0,blank,0,-323,-105,261936,262109,173
106,0,blank,0,-323,-105,262109,262285,176
106,0,blank,0,-323,-105,262285,262635,350
106,0,blank,0,-323,-105,262635,262747,112
106,0,blank,0,-323,-105,262747,262864,117
106,0,blank,0,-323,-105,262864,263041,177
106,0,blank,0,-323,-105,263041,263176,135
106,0,blank,0,-323,-105,263176,263311,135
106,0,blank,0,-323,-105,263311,263495,184
106,0,blank,0,-323,-105,263495,263652,157
106,0,blank,0,-323,-105,263652,263774,122
106,0,blank,0,-323,-105,263774,263968,194
106,0,blank,0,-323,-105,263968,264149,181
106,0,blank,0,-323,-105,264149,264246,97
106,0,blank,0,-323,-105,264246,264385,139
106,0,blank,0,-323,-105,264385,264551,166
106,0,blank,0,-323,-105,264551,264638,87
106,0,blank,0,-323,-105,264638,265100,462
106,0,blank,0,-323,-105,265100,265134,34
106,0,blank,0,-323,-105,265134,265673,539
106,0,blank,0,-323,-105,265673,266210,537
106,0,blank,0,-323,-105,266210,266386,176
106,0,blank,0,-323,-105,266386,266417,31
106,0,blank,0,-323,-105,266417,266727,310
106,0,blank,0,-323,-105,266727,267041,314
106,0,blank,0,-323,-105,267041,267482,441
106,0,blank,0,-323,-105,267482,267677,195
106,0,blank,0,-323,-105,267677,267843,166
106,0,blank,0,-323,-105,267843,267910,67
106,0,blank,0,-323,-105,267910,268210,300
106,0,blank,0,-323,-105,268210,268268,58
106,0,blank,0,-323,-105,268268,268459,191
106,0,blank,0,-323,-105,268459,268584,125
106,0,blank,0,-323,-105,268584,268755,171
106,0,blank,0,-323,-105,268755,268924,169
106,0,blank,0,-323,-105,268924,269185,261
106,0,blank,0,-323,-105,269185,269489,304
106,43,=,269,203.66365,310.0518,269515,269600,85
106,0,blank,0,279.6122,296.4279,269956,269995,39
106,0,blank,0,-323,-105,270316,270502,186
106,0,blank,0,-323,-105,270502,270681,179
106,0,blank,0,-323,-105,270681,270858,177
106,0,blank,0,-323,-105,270858,271048,190
106,0,blank,0,-323,-105,271048,271229,181
106,0,blank,0,-323,-105,271229,271424,195
106,0,blank,0,-323,-105,271424,271613,189
106,0,blank,0,-323,-105,271613,271777,164
106,0,blank,0,-323,-105,271777,272021,244
106,0,blank,0,-323,-105,272021,272223,202
106,0,blank,0,-323,-105,272223,272402,179
106,0,blank,0,-323,-105,272402,272592,190
106,0,blank,0,-323,-105,272592,272713,121
106,0,blank,0,-323,-105,272713,272900,187
106,0,blank,0,-323,-105,272900,273076,176
106,0,blank,0,-323,-105,273076,273146,70
106,0,blank,0,-323,-105,273146,273324,178
106,0,blank,0,-323,-105,273324,273442,118
106,0,blank,0,-323,-105,273442,273641,199
106,0,blank,0,-323,-105,273641,273797,156
106,0,blank,0,-323,-105,273797,273924,127
106,0,blank,0,-323,-105,273924,274046,122
106,0,blank,0,-323,-105,274046,274229,183
106,0,blank,0,-323,-105,274229,274400,171
106,0,blank,0,-323,-105,274400,274435,35
106,0,blank,0,-323,-105,274435,274667,232
106,0,blank,0,-323,-105,274667,274699,32
106,0,blank,0,-323,-105,274699,275160,461
106,0,blank,0,-323,-105,275160,275617,457
106,0,blank,0,-323,-105,275617,275809,192
106,0,blank,0,-323,-105,275809,275993,184
106,0,blank,0,-323,-105,275993,276635,642
106,0,blank,0,-323,-105,276635,276806,171
106,0,blank,0,-323,-105,276806,276943,137
106,0,blank,0,-323,-105,276943,277058,115
106,0,blank,0,-323,-105,277058,277164,106
106,0,blank,0,-323,-105,277164,277315,151
106,0,blank,0,-323,-105,277315,277540,225
106,0,blank,0,-323,-105,277540,277696,156
106,0,blank,0,-323,-105,277696,277813,117
106,0,blank,0,-323,-105,277813,277922,109
106,0,blank,0,-323,-105,277922,278561,639
106,0,blank,0,-323,-105,278561,278748,187
106,0,blank,0,-323,-105,278748,278781,33
106,0,blank,0,-323,-105,278781,279080,299
106,0,blank,0,-323,-105,279080,279132,52
106,0,blank,0,-323,-105,279132,279620,488
106,0,blank,0,-323,-105,279620,279819,199
106,0,blank,0,-323,-105,279819,279944,125
106,0,blank,0,-323,-105,279944,280063,119
106,0,blank,0,-323,-105,280063,280297,234
106,0,blank,0,-323,-105,280297,280341,44
106,0,blank,0,-323,-105,280341,280527,186
106,0,blank,0,-323,-105,280527,280866,339
106,0,blank,0,-323,-105,280866,281110,244
106,0,blank,0,269.6288,339.9142,281133,281158,25
106,0,blank,0,-323,-105,281378,281575,197
106,0,blank,0,-323,-105,281575,281754,179
106,0,blank,0,-323,-105,281754,281949,195
106,0,blank,0,-323,-105,281949,282077,128
106,0,blank,0,-323,-105,282077,282379,302
106,0,blank,0,-323,-105,282379,282686,307
106,0,blank,0,-323,-105,282686,283170,484
106,0,blank,0,179.8727,327.7175,283196,283234,38
106,0,blank,0,169.4617,190.6979,283349,283397,48
106,0,blank,0,139.4913,251.1003,283602,283644,42
106,35,lo,216,187.41335,147.410075,283769,283906,137
106,0,blank,0,181.0121,155.6151,283937,283968,31
106,36,;,226,128.085666666667,164.314533333333,283999,284091,92
106,39,<=,247,154.0401,217.9651,284181,284273,92
106,35,;,222,308.998,138.2094,284553,284581,28
106,0,blank,0,340.79835,149.3593,284862,284924,62
106,0,blank,0,339.0815,135.2156,284955,284985,30
106,0,blank,0,324.7717,140.5602,285047,285104,57
106,43,list,270,238.9411,319.9781,285292,285417,125
106,0,blank,0,-323,-105,285491,285642,151
106,0,blank,0,-323,-105,286797,286978,181
106,0,blank,0,-323,-105,286978,287162,184
106,0,blank,0,-323,-105,287162,287341,179
106,0,blank,0,-323,-105,287341,287429,88
106,0,blank,0,-323,-105,287429,287579,150
106,0,blank,0,-323,-105,287579,287693,114
106,0,blank,0,-323,-105,287693,287779,86
106,0,blank,0,-323,-105,287779,287998,219
106,0,blank,0,-323,-105,287998,288112,114
106,41,list,259,267.9586,278.9335,288130,288158,28
106,0,blank,0,-323,-105,288440,288622,182
106,0,blank,0,-323,-105,288622,288809,187
106,0,blank,0,-323,-105,288809,288995,186
106,0,blank,0,-323,-105,288995,289160,165
106,0,blank,0,-323,-105,289160,289347,187
106,0,blank,0,-323,-105,289347,289537,190
106,0,blank,0,-323,-105,289537,289669,132
106,0,blank,0,-323,-105,289669,289772,103
106,0,blank,0,-323,-105,289772,289873,101
106,0,blank,0,-323,-105,289873,290079,206
106,0,blank,0,-323,-105,290079,290273,194
106,0,blank,0,-323,-105,290273,290334,61
106,0,blank,0,-323,-105,290334,290487,153
106,0,blank,0,-323,-105,290487,290642,155
106,0,blank,0,-323,-105,290642,290765,123
106,0,blank,0,-323,-105,290765,290875,110
106,0,blank,0,-323,-105,290875,291047,172
106,0,blank,0,-323,-105,291047,291175,128
106,0,blank,0,-323,-105,291175,291333,158
106,0,blank,0,-323,-105,291333,291532,199
106,0,blank,0,-323,-105,291532,291719,187
106,0,blank,0,-323,-105,291719,291880,161
106,0,blank,0,-323,-105,291880,292076,196
106,0,blank,0,-323,-105,292076,292199,123
106,0,blank,0,-323,-105,292199,292292,93
106,0,blank,0,-323,-105,292292,292471,179
106,0,blank,0,-323,-105,292471,292682,211
106,0,blank,0,-323,-105,292682,292867,185
106,0,blank,0,-323,-105,292867,293085,218
106,0,blank,0,-323,-105,293085,293261,176
106,0,blank,0,-323,-105,293261,293359,98
106,0,blank,0,-323,-105,293359,293543,184
106,0,blank,0,-323,-105,293543,293722,179
106,0,blank,0,-323,-105,293722,293900,178
106,0,blank,0,-323,-105,293900,294079,179
106,0,blank,0,-323,-105,294079,294245,166
106,0,blank,0,-323,-105,294245,294439,194
106,0,blank,0,-323,-105,294439,294617,178
106,0,blank,0,-323,-105,294617,294783,166
106,0,blank,0,-323,-105,294783,294902,119
106,0,blank,0,-323,-105,294902,295046,144
106,0,blank,0,-323,-105,295046,295235,189
106,0,blank,0,-323,-105,295235,295425,190
106,0,blank,0,-323,-105,295425,295609,184
106,0,blank,0,-323,-105,295609,295680,71
106,0,blank,0,-323,-105,295680,295867,187
106,0,blank,0,-323,-105,295867,296016,149
106,0,blank,0,-323,-105,296016,296144,128
106,0,blank,0,-323,-105,296144,296269,125
106,0,blank,0,-323,-105,296269,296444,175
106,0,blank,0,-323,-105,296444,296613,169
106,0,blank,0,-323,-105,296613,296848,235
106,0,blank,0,-323,-105,296848,297081,233
106,0,blank,0,-323,-105,297081,297155,74
106,0,blank,0,-323,-105,297594,297619,25
106,48,temp,281,162.33925,429.01755,297648,297698,50
106,0,blank,0,228.3438,446.8239,297840,297869,29
106,0,blank,0,222.425733333333,436.967966666667,297898,298071,173
106,0,blank,0,221.4539,437.5956,298157,298186,29
106,0,blank,0,270.2147,442.2575,298215,298244,29
106,0,blank,0,262.5271,441.3514,298302,298391,89
106,0,blank,0,221.26995,440.9541,298450,298509,59
106,0,blank,0,224.291025,439.0821,298539,298656,117
106,0,blank,0,264.7779,421.5145,298685,298714,29
106,48,list,286,261.65665,429.77435,298743,298803,60
106,0,blank,0,274.018,301.412,298862,299013,151
106,41,list,259,275.582466666667,271.0274,299043,299131,88
106,41,list,259,269.31075,270.03455,299221,299283,62
106,0,blank,0,240.865725,286.318,299314,299437,123
106,0,blank,0,-323,-105,299466,299651,185
106,0,blank,0,-323,-105,299651,299836,185
106,0,blank,0,-323,-105,299836,299866,30
106,0,blank,0,-323,-105,299953,300136,183
106,0,blank,0,-323,-105,300136,300313,177
106,0,blank,0,-323,-105,300313,300509,196
106,0,blank,0,-323,-105,300509,300692,183
106,0,blank,0,-323,-105,300692,300847,155
106,0,blank,0,-323,-105,300847,300991,144
106,0,blank,0,-323,-105,300991,301133,142
106,0,blank,0,-323,-105,301133,301324,191
106,0,blank,0,-323,-105,301324,301465,141
106,0,blank,0,-323,-105,301465,301651,186
106,0,blank,0,-323,-105,301651,301837,186
106,0,blank,0,-323,-105,301837,302011,174
106,0,blank,0,-323,-105,302011,302145,134
106,0,blank,0,-323,-105,302145,302325,180
106,0,blank,0,-323,-105,302325,302502,177
106,0,blank,0,-323,-105,302502,302692,190
106,0,blank,0,-323,-105,302692,302864,172
106,0,blank,0,-323,-105,302864,303027,163
106,0,blank,0,127.0117,472.7648,303043,303070,27
106,0,blank,0,142.2587,467.541916666667,303096,303272,176
106,0,blank,0,149.166733333333,468.441566666667,303272,303360,88
106,0,blank,0,281.1967,484.8942,303448,303519,71
106,0,blank,0,289.4835,474.2025,303580,303605,25
106,0,blank,0,-323,-105,304194,304372,178
106,0,blank,0,-323,-105,304372,304552,180
106,0,blank,0,-323,-105,304552,304707,155
106,0,blank,0,-323,-105,304707,304896,189
106,0,blank,0,-323,-105,304896,305088,192
106,0,blank,0,-323,-105,305088,305300,212
106,0,blank,0,-323,-105,305300,305333,33
106,0,blank,0,-323,-105,305333,305649,316
106,0,blank,0,-323,-105,305649,305984,335
106,39,high,248,360.9116,224.6259,306088,306130,42
106,0,blank,0,344.8545,240.20935,306188,306246,58
106,39,high,248,338.232933333333,237.5042,306453,306539,86
106,0,blank,0,317.0418,323.2813,306627,306656,29
106,0,blank,0,307.2986,305.3478,306715,306747,32
106,0,blank,0,-323,-105,306835,307017,182
106,0,blank,0,-323,-105,307017,307194,177
106,0,blank,0,-323,-105,307194,307295,101
106,0,blank,0,-323,-105,307295,307406,111
106,0,blank,0,-323,-105,307406,307605,199
106,0,blank,0,-323,-105,307605,307639,34
106,0,blank,0,-323,-105,307639,308070,431
106,0,blank,0,-323,-105,308070,308107,37
106,0,blank,0,-323,-105,308107,308522,415
106,0,blank,0,-323,-105,308522,309235,713
106,0,blank,0,-323,-105,309235,309410,175
106,0,blank,0,-323,-105,309410,309553,143
106,0,blank,0,-323,-105,309553,309706,153
106,0,blank,0,-323,-105,309706,310273,567
106,0,blank,0,-323,-105,310273,310311,38
106,0,blank,0,-323,-105,310439,310632,193
106,0,blank,0,-323,-105,310632,310808,176
106,0,blank,0,-323,-105,310808,311003,195
106,0,blank,0,-323,-105,311003,311047,44
106,0,blank,0,-323,-105,311047,311230,183
106,0,blank,0,-323,-105,311230,311256,26
106,0,blank,0,-323,-105,311256,311717,461
106,0,blank,0,-323,-105,311717,312145,428
106,0,blank,0,-323,-105,312145,312331,186
106,0,blank,0,-323,-105,312331,312468,137
106,0,blank,0,-323,-105,312468,312543,75
106,0,blank,0,-323,-105,312543,312734,191
106,0,blank,0,-323,-105,312734,312818,84
106,0,blank,0,-323,-105,312818,313008,190
106,0,blank,0,-323,-105,313008,313198,190
106,0,blank,0,-323,-105,313198,313371,173
106,0,blank,0,-323,-105,313371,313514,143
106,0,blank,0,-323,-105,313514,313637,123
106,0,blank,0,-323,-105,313637,313784,147
106,0,blank,0,-323,-105,313784,313974,190
106,0,blank,0,-323,-105,313974,314039,65
106,0,blank,0,-323,-105,314039,314290,251
106,0,blank,0,-323,-105,314290,314558,268
106,0,blank,0,-323,-105,314558,314701,143
106,0,blank,0,-323,-105,314701,314919,218
106,0,blank,0,-323,-105,314919,315128,209
106,0,blank,0,-323,-105,315128,315418,290
106,0,blank,0,-323,-105,315418,315849,431
106,0,blank,0,-323,-105,315849,316029,180
106,0,blank,0,-323,-105,316029,316197,168
106,0,blank,0,-323,-105,316197,316269,72
106,0,blank,0,-323,-105,316269,316423,154
106,0,blank,0,-323,-105,316423,316787,364
106,0,blank,0,-323,-105,316787,317042,255
106,0,blank,0,-323,-105,317042,317296,254
106,0,blank,0,-323,-105,317296,317480,184
106,0,blank,0,-323,-105,317480,317558,78
106,0,blank,0,-323,-105,317558,317894,336
106,0,blank,0,-323,-105,317894,317926,32
106,0,blank,0,-323,-105,317926,318226,300
106,0,blank,0,-323,-105,318226,318522,296
106,0,blank,0,-323,-105,318627,318823,196
106,0,blank,0,-323,-105,318823,318999,176
106,0,blank,0,-323,-105,318999,319197,198
106,0,blank,0,-323,-105,319197,319330,133
106,0,blank,0,-323,-105,319330,319492,162
106,0,blank,0,-323,-105,319492,319878,386
106,0,blank,0,-323,-105,319878,320035,157
106,0,blank,0,-323,-105,320035,320227,192
106,0,blank,0,-323,-105,320227,320370,143
106,0,blank,0,-323,-105,320370,320618,248
106,0,blank,0,-323,-105,320618,320658,40
106,0,blank,0,-323,-105,320658,321092,434
106,0,blank,0,-323,-105,321092,321656,564
106,0,blank,0,-323,-105,321656,321839,183
106,0,blank,0,-323,-105,321839,321859,20
106,0,blank,0,-323,-105,321859,322142,283
106,0,blank,0,-323,-105,322142,322203,61
106,0,blank,0,-323,-105,322203,322559,356
106,0,blank,0,-323,-105,322559,322944,385
106,0,blank,0,-323,-105,322944,323124,180
106,0,blank,0,-323,-105,323124,323519,395
106,0,blank,0,-323,-105,323519,323676,157
106,0,blank,0,-323,-105,323676,323834,158
106,0,blank,0,-323,-105,323834,323995,161
106,0,blank,0,-323,-105,324352,324521,169
106,0,blank,0,-323,-105,324521,324706,185
106,0,blank,0,-323,-105,324706,324888,182
106,0,blank,0,-323,-105,324888,325023,135
106,0,blank,0,-323,-105,325023,325214,191
106,0,blank,0,-323,-105,325214,325375,161
106,0,blank,0,-323,-105,325375,325539,164
106,0,blank,0,-323,-105,325539,325812,273
106,0,blank,0,-323,-105,325812,325967,155
106,0,blank,0,-323,-105,325967,326162,195
106,0,blank,0,-323,-105,326162,326328,166
106,0,blank,0,-323,-105,326328,326363,35
106,0,blank,0,-323,-105,326363,326618,255
106,0,blank,0,-323,-105,326618,326776,158
106,0,blank,0,-323,-105,326776,327007,231
106,0,blank,0,-323,-105,327007,327120,113
106,0,blank,0,-323,-105,327120,327486,366
106,0,blank,0,-323,-105,327486,327919,433
106,0,blank,0,-323,-105,327919,328094,175
106,0,blank,0,-323,-105,328094,328247,153
106,0,blank,0,-323,-105,328247,328424,177
106,0,blank,0,-323,-105,328424,328620,196
106,0,blank,0,-323,-105,328620,328734,114
106,0,blank,0,-323,-105,328734,328969,235
106,0,blank,0,-323,-105,328969,329091,122
106,0,blank,0,-323,-105,329091,329287,196
106,0,blank,0,-323,-105,329287,329419,132
106,0,blank,0,-323,-105,329419,329590,171
106,0,blank,0,-323,-105,329590,330026,436
106,0,blank,0,-323,-105,330026,330441,415
106,0,blank,0,-323,-105,330441,330625,184
106,0,blank,0,-323,-105,330625,330716,91
106,0,blank,0,-323,-105,330716,331074,358
106,0,blank,0,-323,-105,331074,331439,365
106,0,blank,0,-323,-105,331439,331566,127
106,0,blank,0,-323,-105,331566,331904,338
106,0,blank,0,-323,-105,331904,332235,331
106,0,blank,0,-323,-105,332235,332413,178
106,0,blank,0,-323,-105,332413,332576,163
106,0,blank,0,-323,-105,332576,332705,129
106,0,blank,0,-323,-105,332705,332858,153
106,0,blank,0,-323,-105,332858,333017,159
106,0,blank,0,-323,-105,333017,333593,576
106,0,blank,0,-323,-105,333593,333899,306
106,0,blank,0,-323,-105,333899,334171,272
106,0,blank,0,-323,-105,334171,334364,193
106,0,blank,0,-323,-105,334575,334751,176
106,0,blank,0,-323,-105,334751,334941,190
106,0,blank,0,-323,-105,334941,335052,111
106,0,blank,0,-323,-105,335052,335236,184
106,0,blank,0,-323,-105,335236,335432,196
106,0,blank,0,-323,-105,335432,335547,115
106,0,blank,0,-323,-105,335547,335680,133
106,0,blank,0,-323,-105,335680,335968,288
106,0,blank,0,-323,-105,335968,336124,156
106,0,blank,0,287.7845,334.7528,336471,336497,26
106,0,blank,0,-323,-105,336524,336692,168
106,48,=,285,203.8572,418.569,337047,337076,29
106,0,blank,0,237.4668,413.0092,337194,337223,29
106,0,blank,0,221.4693,421.9699,337454,337513,59
106,0,blank,0,189.72592,401.78528,337541,337690,149
106,43,=,269,207.0623,309.2032,337720,337750,30
106,0,blank,0,238.9948,256.1768,337809,337839,30
106,0,blank,0,195.7051,245.6635,338136,338166,30
106,0,blank,0,-323,-105,338437,338619,182
106,0,blank,0,-323,-105,338619,338799,180
106,0,blank,0,-323,-105,338799,338987,188
106,0,blank,0,-323,-105,338987,339166,179
106,0,blank,0,-323,-105,339166,339251,85
106,0,blank,0,-323,-105,339251,339441,190
106,0,blank,0,-323,-105,339441,339646,205
106,0,blank,0,-323,-105,339646,339760,114
106,0,blank,0,-323,-105,339760,339926,166
106,0,blank,0,313.3411,285.5426,339950,340006,56
106,0,blank,0,343.2685,278.193,340064,340093,29
106,0,blank,0,367.4091,269.1689,340121,340150,29
106,0,blank,0,368.2402,303.153,340238,340266,28
106,0,blank,0,-323,-105,340295,340478,183
106,0,blank,0,-323,-105,340478,340646,168
106,0,blank,0,-323,-105,340646,340810,164
106,0,blank,0,-323,-105,340810,340976,166
106,0,blank,0,-323,-105,340976,341012,36
106,0,blank,0,-323,-105,341012,341310,298
106,0,blank,0,-323,-105,341310,341342,32
106,0,blank,0,-323,-105,341342,341757,415
106,0,blank,0,-323,-105,341757,342169,412
106,48,temp,281,163.3484,430.3703,342274,342322,48
106,0,blank,0,249.3011,442.6851,342408,342439,31
106,48,list,286,252.43225,433.485775,342495,342612,117
106,0,blank,0,218.3869,424.93895,342698,342755,57
106,0,blank,0,144.2666,371.2479,342871,342930,59
106,39,<=,247,161.574,236.0889,342989,343018,29
106,39,<=,247,167.236966666667,232.817866666667,343105,343192,87
106,48,],289,185.482333333333,430.966133333333,343309,343397,88
106,0,blank,0,201.9645,439.2018,343426,343455,29
106,0,blank,0,202.943,433.8023,343485,343514,29
106,48,list,286,237.490433333333,435.81715,343543,343717,174
106,0,blank,0,244.049,438.5346,343717,343746,29
106,0,blank,0,290.6293,447.7948,343834,343980,146
106,0,blank,0,201.070633333333,439.974133333333,344068,344155,87
106,0,blank,0,140.9822,458.447233333333,344214,344389,175
106,49,++,292,153.1604,443.7185,344389,344418,29
106,49,++,292,146.09915,453.9988,344476,344534,58
106,51,++,296,102.3397,486.9963,344592,344622,30
106,51,++,296,98.3811333333334,493.319516666667,344709,344884,175
106,0,blank,0,114.806933333333,477.511733333333,344973,345061,88
106,0,blank,0,124.818175,437.07795,345090,345208,118
106,49,mi,291,135.5378,453.2301,345239,345268,29
106,49,mi,291,128.73618,443.88026,345326,345474,148
106,51,++,296,95.7164,494.8547,345593,345653,60
106,0,blank,0,97.94478,286.70268,345712,345859,147
106,0,blank,0,91.833925,546.111925,346035,346154,119
106,0,blank,0,101.47595,549.486625,346243,346362,119
106,0,blank,0,248.027,258.6263,346760,346797,37
106,0,blank,0,241.6324,243.3634,346825,346855,30
106,0,blank,0,243.8405,245.1127,346914,346943,29
106,57,temp,320,143.28512,631.49168,347093,347243,150
106,0,blank,0,225.9691,650.4915,347395,347425,30
106,0,blank,0,222.9453,649.629,347455,347485,30
106,0,blank,0,-323,-105,347515,347700,185
106,0,blank,0,-323,-105,347700,347885,185
106,0,blank,0,-323,-105,347885,348071,186
106,0,blank,0,-323,-105,348071,348243,172
106,0,blank,0,-323,-105,348243,348430,187
106,0,blank,0,-323,-105,348430,348519,89
106,0,blank,0,-323,-105,348519,348637,118
106,0,blank,0,-323,-105,348637,348813,176
106,0,blank,0,-323,-105,348813,348988,175
106,0,blank,0,-323,-105,348988,349134,146
106,0,blank,0,-323,-105,349134,349335,201
106,0,blank,0,-323,-105,349335,349506,171
106,0,blank,0,-323,-105,349506,349674,168
106,0,blank,0,-323,-105,349674,349828,154
106,0,blank,0,-323,-105,349828,350003,175
106,0,blank,0,-323,-105,350003,350167,164
106,0,blank,0,-323,-105,350167,350322,155
106,0,blank,0,-323,-105,350322,350453,131
106,0,blank,0,-323,-105,350453,350551,98
106,0,blank,0,-323,-105,350551,350715,164
106,0,blank,0,-323,-105,350715,350889,174
106,0,blank,0,-323,-105,350889,351018,129
106,0,blank,0,-323,-105,351018,351375,357
106,0,blank,0,-323,-105,351375,351608,233
106,0,blank,0,-323,-105,351608,352051,443
106,0,blank,0,-323,-105,352051,352222,171
106,0,blank,0,-323,-105,352222,352343,121
106,0,blank,0,-323,-105,352343,352490,147
106,0,blank,0,-323,-105,352490,352646,156
106,0,blank,0,-323,-105,352646,352810,164
106,0,blank,0,-323,-105,352810,353014,204
106,0,blank,0,-323,-105,353014,353217,203
106,0,blank,0,-323,-105,353217,353494,277
106,0,blank,0,-323,-105,353494,353919,425
106,0,blank,0,-323,-105,353919,354072,153
106,0,blank,0,-323,-105,354072,354302,230
106,0,blank,0,-323,-105,354302,354334,32
106,0,blank,0,-323,-105,354334,354589,255
106,0,blank,0,-323,-105,354589,354785,196
106,0,blank,0,-323,-105,354785,354977,192
106,0,blank,0,-323,-105,354977,355170,193
106,0,blank,0,-323,-105,355170,355286,116
106,0,blank,0,-323,-105,355286,355424,138
106,0,blank,0,-323,-105,355424,355688,264
106,0,blank,0,-323,-105,355688,356046,358
106,0,blank,0,-323,-105,356046,356236,190
106,0,blank,0,-323,-105,356236,356427,191
106,0,blank,0,-323,-105,356427,356610,183
106,0,blank,0,-323,-105,356610,356786,176
106,0,blank,0,-323,-105,356786,356965,179
106,0,blank,0,-323,-105,356965,357140,175
106,0,blank,0,-323,-105,357140,357339,199
106,0,blank,0,-323,-105,357339,357535,196
106,0,blank,0,-323,-105,357535,357716,181
106,0,blank,0,-323,-105,357716,357800,84
106,0,blank,0,-323,-105,357800,357944,144
106,0,blank,0,135.71355,546.5177,357995,358078,83
106,57,list,325,258.5788,621.258,358871,358899,28
106,0,blank,0,160.2527,515.1514,359098,359126,28
106,0,blank,0,184.6421,557.601,359154,359183,29
106,0,blank,0,173.6687,534.5441,359212,359240,28
106,0,blank,0,-323,-105,359355,359535,180
106,0,blank,0,154.0478,480.6292,359559,359585,26
106,0,blank,0,184.1821,456.1627,359658,359684,26
106,0,blank,0,186.2434,525.7911,359770,359798,28
106,0,blank,0,177.0252,521.2936,359827,359855,28
106,0,blank,0,162.3711,595.8279,360471,360499,28
106,43,],273,186.9718,325.3622,360754,360782,28
106,55,=,309,159.078,570.9336,360954,360983,29
106,0,blank,0,-323,-105,361203,361382,179
106,0,blank,0,-323,-105,361382,361560,178
106,0,blank,0,-323,-105,361560,361737,177
106,0,blank,0,-323,-105,361737,361873,136
106,0,blank,0,-323,-105,361873,362056,183
106,0,blank,0,-323,-105,362056,362250,194
106,0,blank,0,-323,-105,362250,362410,160
106,0,blank,0,-323,-105,362410,362580,170
106,0,blank,0,-323,-105,362580,362757,177
106,0,blank,0,-323,-105,362757,362848,91
106,0,blank,0,-323,-105,362848,363073,225
106,0,blank,0,-323,-105,363073,363309,236
106,0,blank,0,-323,-105,363309,363670,361
106,0,blank,0,-323,-105,363670,363866,196
106,0,blank,0,-323,-105,363866,364051,185
106,0,blank,0,-323,-105,364051,364227,176
106,0,blank,0,-323,-105,364227,364487,260
106,0,blank,0,-323,-105,364487,364538,51
106,0,blank,0,-323,-105,364538,364785,247
106,0,blank,0,-323,-105,364785,364994,209
106,0,blank,0,-323,-105,364994,365187,193
106,0,blank,0,-323,-105,365187,365326,139
106,0,blank,0,-323,-105,365326,365524,198
106,0,blank,0,-323,-105,365524,365722,198
106,0,blank,0,-323,-105,365722,365826,104
106,0,blank,0,-323,-105,365826,366304,478
106,0,blank,0,-323,-105,366304,366377,73
106,0,blank,0,-323,-105,366377,366515,138
106,0,blank,0,-323,-105,366515,366650,135
106,0,blank,0,-323,-105,366650,366762,112
106,0,blank,0,-323,-105,366762,367076,314
106,0,blank,0,-323,-105,367076,367253,177
106,0,blank,0,-323,-105,367253,367281,28
106,0,blank,0,-323,-105,367281,367482,201
106,0,blank,0,-323,-105,367482,367658,176
106,0,blank,0,-323,-105,367658,367775,117
106,0,blank,0,-323,-105,367775,367938,163
106,0,blank,0,-323,-105,367938,368120,182
106,0,blank,0,-323,-105,368120,368309,189
106,0,blank,0,-323,-105,368309,368506,197
106,0,blank,0,-323,-105,368506,368704,198
106,0,blank,0,1028.145,534.2098,369953,369985,32
106,0,blank,0,180.36425,531.00355,370189,370247,58
106,0,blank,0,155.85045,511.9492,370336,370395,59
106,0,blank,0,177.4716,482.2277,370571,370601,30
106,0,blank,0,196.6923,415.4983,370659,370688,29
106,0,blank,0,196.6316,423.9432,370775,370804,29
106,0,blank,0,133.4469,487.4393,371091,371120,29
107,0,blank,0,113.1261,447.8417,372352,372380,28
107,0,blank,0,195.6243,446.433,372819,372847,28
107,0,blank,0,228.336466666667,482.555633333333,372992,373082,90
107,63,;,346,201.502,487.8428,373111,373141,30
107,0,blank,0,233.25565,499.43775,373227,373287,60
107,0,blank,0,-323,-105,373373,373530,157
107,0,blank,0,-323,-105,373530,373608,78
107,0,blank,0,266.4487,511.9033,374098,374128,30
107,0,blank,0,255.6274,491.5362,374217,374248,31
107,0,blank,0,297.3156,493.1643,374278,374339,61
107,0,blank,0,304.2141,509.9229,374399,374430,31
107,0,blank,0,285.859133333333,498.2519,374519,374610,91
107,0,blank,0,419.058,509.342,374669,374699,30
107,0,blank,0,325.9302,495.5997,374818,374847,29
107,0,blank,0,298.0783,542.3683,375147,375177,30
107,0,blank,0,226.0501,481.2505,375357,375387,30
107,0,blank,0,337.3262,490.9691,375446,375475,29
107,0,blank,0,347.81605,490.4994,375505,375565,60
107,0,blank,0,330.724266666667,494.515533333333,375654,375743,89
107,0,blank,0,360.2495,489.5391,375803,375833,30
107,0,blank,0,363.644225,488.309975,375922,376039,117
107,0,blank,0,-323,-105,376128,376286,158
107,0,blank,0,378.8982,582.3015,376311,376336,25
107,0,blank,0,391.4208,495.21505,376444,376504,60
107,0,blank,0,259.2314,486.0892,376778,376808,30
107,0,blank,0,281.6561,494.6382,376839,376869,30
107,0,blank,0,298.5345,507.3804,376899,376929,30
107,63,k,347,216.653,485.0289,377079,377109,30
107,0,blank,0,-323,-105,377258,377442,184
107,0,blank,0,-323,-105,377442,377621,179
107,0,blank,0,-323,-105,377621,377792,171
107,0,blank,0,-323,-105,377792,377972,180
107,0,blank,0,-323,-105,377972,378157,185
107,0,blank,0,-323,-105,378157,378311,154
107,0,blank,0,-323,-105,378311,378420,109
107,0,blank,0,-323,-105,378420,378606,186
107,0,blank,0,-323,-105,378606,378773,167
107,0,blank,0,-323,-105,378773,378871,98
107,0,blank,0,-323,-105,378871,379040,169
107,0,blank,0,-323,-105,379040,379208,168
107,0,blank,0,-323,-105,379208,379334,126
107,0,blank,0,-323,-105,379334,379522,188
107,0,blank,0,-323,-105,379522,379702,180
107,0,blank,0,-323,-105,379702,379886,184
107,0,blank,0,-323,-105,379886,380039,153
107,0,blank,0,-323,-105,380039,380176,137
107,0,blank,0,-323,-105,380176,380331,155
107,0,blank,0,-323,-105,380331,380401,70
107,0,blank,0,-323,-105,380522,380706,184
107,0,blank,0,-323,-105,380706,380882,176
107,0,blank,0,-323,-105,380882,381061,179
107,0,blank,0,-323,-105,381061,381224,163
107,0,blank,0,-323,-105,381224,381395,171
107,0,blank,0,-323,-105,381395,381663,268
107,0,blank,0,-323,-105,381663,381695,32
107,0,blank,0,-323,-105,381695,381912,217
107,0,blank,0,-323,-105,381912,382095,183
107,0,blank,0,-323,-105,382095,382215,120
107,0,blank,0,-323,-105,382215,382320,105
107,0,blank,0,-323,-105,382320,382603,283
107,0,blank,0,-323,-105,382603,382753,150
107,0,blank,0,-323,-105,382753,382930,177
107,0,blank,0,-323,-105,382930,383109,179
107,0,blank,0,-323,-105,383109,383257,148
107,0,blank,0,-323,-105,383257,383426,169
107,0,blank,0,-323,-105,383426,383590,164
107,0,blank,0,-323,-105,383590,383724,134
107,0,blank,0,-323,-105,383724,383899,175
107,0,blank,0,-323,-105,383899,384068,169
107,63,),349,351.4027,479.8104,384101,384153,52
107,0,blank,0,-323,-105,384192,384382,190
107,0,blank,0,-323,-105,384382,384516,134
107,0,blank,0,-323,-105,384516,384698,182
107,0,blank,0,-323,-105,384698,384887,189
107,0,blank,0,-323,-105,384887,385064,177
107,0,blank,0,-323,-105,385064,385178,114
107,0,blank,0,277.402,539.13,385259,385290,31
107,0,blank,0,264.363,537.2401,385385,385416,31
107,65,list,356,237.29765,527.30535,385545,385674,129
107,0,blank,0,219.7945,543.7796,385769,385834,65
107,0,blank,0,232.1497,555.3188,385895,385927,32
107,0,blank,0,-323,-105,385989,386169,180
107,0,blank,0,-323,-105,386169,386357,188
107,0,blank,0,-323,-105,386357,386546,189
107,0,blank,0,-323,-105,386546,386716,170
107,0,blank,0,-323,-105,386716,386841,125
107,0,blank,0,-323,-105,386841,386988,147
107,0,blank,0,-323,-105,386988,387106,118
107,0,blank,0,-323,-105,387106,387357,251
107,0,blank,0,-323,-105,387357,387601,244
107,0,blank,0,-323,-105,387601,387773,172
107,0,blank,0,-323,-105,387773,387967,194
107,0,blank,0,-323,-105,387967,388143,176
107,0,blank,0,-323,-105,388143,388277,134
107,0,blank,0,-323,-105,388277,388465,188
107,0,blank,0,-323,-105,388465,388620,155
107,0,blank,0,-323,-105,388620,388683,63
107,0,blank,0,292.3242,500.5262,388699,388729,30
107,0,blank,0,328.6301,541.5195,388769,388798,29
107,0,blank,0,332.101375,533.432275,388830,388954,124
107,0,blank,0,240.80395,580.484,389140,389201,61
107,0,blank,0,204.3357,561.6307,389260,389290,30
107,0,blank,0,-323,-105,389381,389563,182
107,0,blank,0,-323,-105,389563,389738,175
107,0,blank,0,-323,-105,389738,389913,175
107,0,blank,0,-323,-105,389913,390095,182
107,0,blank,0,-323,-105,390095,390213,118
107,0,blank,0,-323,-105,390213,390401,188
107,0,blank,0,-323,-105,390401,390600,199
107,0,blank,0,-323,-105,390600,390799,199
107,0,blank,0,-323,-105,390799,390994,195
107,0,blank,0,-323,-105,390994,391168,174
107,0,blank,0,-323,-105,391168,391297,129
107,0,blank,0,-323,-105,391297,391369,72
107,0,blank,0,-323,-105,391369,391562,193
107,0,blank,0,-323,-105,391562,391743,181
107,0,blank,0,-323,-105,391743,391912,169
107,0,blank,0,-323,-105,391912,392095,183
107,0,blank,0,-323,-105,392095,392240,145
107,0,blank,0,-323,-105,392240,392430,190
107,0,blank,0,-323,-105,392430,392516,86
107,0,blank,0,-323,-105,392516,392756,240
107,0,blank,0,-323,-105,392756,392928,172
107,0,blank,0,-323,-105,392928,393123,195
107,0,blank,0,-323,-105,393123,393282,159
107,0,blank,0,-323,-105,393282,393451,169
107,0,blank,0,-323,-105,393451,393581,130
107,0,blank,0,-323,-105,393581,393790,209
107,0,blank,0,-323,-105,393790,393920,130
107,0,blank,0,-323,-105,393920,394054,134
107,0,blank,0,-323,-105,394054,394179,125
107,0,blank,0,-323,-105,394179,394372,193
107,0,blank,0,-323,-105,394372,394561,189
107,0,blank,0,-323,-105,394561,394706,145
107,0,blank,0,232.51975,506.6596,394723,394780,57
107,0,blank,0,-323,-105,394846,395029,183
107,0,blank,0,-323,-105,395029,395208,179
107,0,blank,0,-323,-105,395208,395386,178
107,0,blank,0,-323,-105,395386,395563,177
107,0,blank,0,-323,-105,395563,395670,107
107,0,blank,0,-323,-105,395670,395818,148
107,0,blank,0,-323,-105,395818,395978,160
107,0,blank,0,-323,-105,395978,396087,109
107,0,blank,0,-323,-105,396087,396179,92
107,0,blank,0,-323,-105,396179,396366,187
107,0,blank,0,-323,-105,396366,396534,168
107,0,blank,0,-323,-105,396534,396707,173
107,0,blank,0,-323,-105,396707,396888,181
107,0,blank,0,-323,-105,396888,397016,128
107,0,blank,0,-323,-105,397016,397176,160
107,0,blank,0,-323,-105,397176,397350,174
107,0,blank,0,-323,-105,397350,397515,165
107,0,blank,0,-323,-105,397515,397654,139
107,0,blank,0,-323,-105,397654,397829,175
107,0,blank,0,-323,-105,397829,397861,32
107,0,blank,0,-323,-105,397861,398036,175
107,0,blank,0,-323,-105,398036,398151,115
107,0,blank,0,-323,-105,398151,398276,125
107,0,blank,0,-323,-105,398276,398442,166
107,0,blank,0,-323,-105,398442,398612,170
107,0,blank,0,-323,-105,398612,398782,170
107,0,blank,0,-323,-105,398782,398963,181
107,0,blank,0,-323,-105,398963,399130,167
107,0,blank,0,-323,-105,399130,399294,164
107,0,blank,0,-323,-105,399294,399467,173
107,0,blank,0,-323,-105,399467,399612,145
107,0,blank,0,-323,-105,399612,399668,56
107,0,blank,0,-323,-105,399668,399832,164
107,0,blank,0,-323,-105,399832,400020,188
107,0,blank,0,-323,-105,400020,400198,178
107,0,blank,0,-323,-105,400198,400375,177
107,0,blank,0,-323,-105,400375,400550,175
107,0,blank,0,-323,-105,400550,400690,140
107,0,blank,0,-323,-105,400690,400867,177
107,0,blank,0,-323,-105,400867,401014,147
107,0,blank,0,-323,-105,401014,401200,186
107,0,blank,0,-323,-105,401200,401357,157
107,0,blank,0,-323,-105,401357,401554,197
107,0,blank,0,-323,-105,401554,401604,50
107,0,blank,0,-323,-105,401604,401786,182
107,0,blank,0,-323,-105,401786,401917,131
107,0,blank,0,-323,-105,401917,402088,171
107,0,blank,0,-323,-105,402088,402272,184
107,0,blank,0,-323,-105,402272,402392,120
107,0,blank,0,-323,-105,402392,402586,194
107,0,blank,0,-323,-105,402586,402774,188
107,0,blank,0,-323,-105,402774,402942,168
107,0,blank,0,-323,-105,402942,403029,87
107,65,list,356,245.6385,525.7092,403060,403091,31
107,65,list,356,250.5026,526.4205,403204,403242,38
107,65,list,356,253.5891,520.3671,403340,403368,28
107,0,blank,0,233.6735,513.4335,403457,403485,28
107,0,blank,0,210.8488,520.3005,403572,403602,30
107,0,blank,0,316.6371,528.3578,404038,404067,29
107,0,blank,0,-323,-105,404309,404505,196
107,0,blank,0,247.609566666667,497.241033333333,404647,404730,83
107,0,blank,0,211.9937,484.5468,404969,404999,30
107,0,blank,0,255.8595,494.93375,405058,405119,61
107,0,blank,0,256.7851,506.734875,405149,405269,120
107,0,blank,0,249.3097,502.2109,405419,405480,61
107,0,blank,0,-323,-105,405541,405725,184
107,0,blank,0,-323,-105,405725,405905,180
107,0,blank,0,-323,-105,405905,406084,179
107,0,blank,0,-323,-105,406084,406258,174
107,0,blank,0,-323,-105,406258,406288,30
107,0,blank,0,-323,-105,406288,406515,227
107,0,blank,0,-323,-105,406515,406670,155
107,0,blank,0,-323,-105,406670,406854,184
107,0,blank,0,-323,-105,406854,407029,175
107,0,blank,0,-323,-105,407029,407270,241
107,0,blank,0,-323,-105,407270,407510,240
107,0,blank,0,-323,-105,407510,407914,404
107,0,blank,0,-323,-105,407914,408067,153
107,0,blank,0,-323,-105,408067,408282,215
107,0,blank,0,-323,-105,408282,408308,26
107,0,blank,0,-323,-105,408308,408680,372
107,0,blank,0,-323,-105,408680,409098,418
107,0,blank,0,174.2652,645.8867,409685,409727,42
107,0,blank,0,198.8254,626.8203,410187,410217,30
107,0,blank,0,-323,-105,410276,410458,182
107,0,blank,0,-323,-105,410458,410637,179
107,0,blank,0,-323,-105,410637,410812,175
107,0,blank,0,-323,-105,410812,410988,176
107,0,blank,0,-323,-105,410988,411170,182
107,0,blank,0,-323,-105,411170,411359,189
107,0,blank,0,-323,-105,411359,411526,167
107,0,blank,0,-323,-105,411526,411656,130
107,0,blank,0,-323,-105,411656,412090,434
107,0,blank,0,-323,-105,412090,412280,190
107,0,blank,0,-323,-105,412280,412434,154
107,0,blank,0,-323,-105,412434,412731,297
107,0,blank,0,-323,-105,412731,412977,246
107,0,blank,0,-323,-105,412977,413421,444
107,53,mid,303,138.1873,250.091,413444,413469,25
107,0,blank,0,95.856975,275.3813,413530,413638,108
107,0,blank,0,-323,-105,413696,413822,126
107,0,blank,0,154.411175,325.0591,413899,414004,105
107,0,blank,0,155.90815,334.33005,414034,414092,58
107,57,i,322,179.209466666667,353.883,414180,414268,88
107,0,blank,0,249.06245,317.7668,414326,414384,58
107,0,blank,0,114.48485,292.05885,414499,414558,59
107,0,blank,0,107.72125,283.62955,414586,414643,57
107,0,blank,0,141.1703,271.5503,414815,414843,28
107,0,blank,0,276.5773,506.1911,414989,415019,30
107,0,blank,0,-323,-105,415077,415258,181
107,0,blank,0,-323,-105,415258,415439,181
107,0,blank,0,-323,-105,415439,415632,193
107,0,blank,0,-323,-105,415632,415827,195
107,0,blank,0,-323,-105,415827,416022,195
107,0,blank,0,-323,-105,416022,416216,194
107,0,blank,0,-323,-105,416216,416392,176
107,0,blank,0,-323,-105,416392,416560,168
107,0,blank,0,-323,-105,416560,416740,180
107,0,blank,0,-323,-105,416740,416813,73
107,0,blank,0,120.5567,673.8182,416830,416858,28
107,69,=,369,113.801733333333,610.831866666667,416918,417004,86
107,69,;,375,168.037,614.4382,417120,417148,28
107,0,blank,0,170.5766,628.2336,417207,417235,28
107,0,blank,0,234.5573,630.2078,417350,417379,29
107,0,blank,0,238.1201,629.6276,417437,417466,29
107,0,blank,0,237.06955,635.50415,417495,417554,59
107,0,blank,0,202.6067,616.3168,417583,417612,29
107,69,<=,373,206.2061,604.41,417759,417788,29
107,71,[,386,125.235266666667,655.359366666667,417907,418083,176
107,71,list,380,121.2459,659.4918,418083,418112,29
107,71,list,380,102.8835,647.9625,418141,418171,30
107,71,list,380,101.5131,657.3234,418229,418258,29
107,0,blank,0,101.00155,668.37975,418317,418377,60
107,71,temp,385,184.5321,659.639933333333,418620,418715,95
107,0,blank,0,193.1649,666.2045,418776,418838,62
107,71,temp,385,186.8624,655.542333333333,418869,418964,95
107,0,blank,0,188.3619,683.704,418994,419024,30
107,0,blank,0,208.0646,666.9506,419117,419147,30
107,71,temp,385,194.6373,660.9091,419209,419240,31
107,71,list,380,97.5874,652.5061,419301,419392,91
107,0,blank,0,133.5959,676.3152,419575,419606,31
107,0,blank,0,135.5455,665.84085,419726,419788,62
107,71,;,389,257.788,653.9712,419910,419970,60
107,71,;,389,261.5184,644.8935,420031,420062,31
107,0,blank,0,-323,-105,420123,420306,183
107,0,blank,0,-323,-105,420306,420491,185
107,0,blank,0,-323,-105,420491,420674,183
107,0,blank,0,-323,-105,420674,420811,137
107,0,blank,0,-323,-105,420811,420967,156
107,0,blank,0,-323,-105,420967,421160,193
107,0,blank,0,-323,-105,421160,421297,137
107,0,blank,0,-323,-105,421297,421459,162
107,0,blank,0,-323,-105,421459,421591,132
107,0,blank,0,-323,-105,421591,421728,137
107,0,blank,0,-323,-105,421728,421904,176
107,0,blank,0,-323,-105,421904,422055,151
107,0,blank,0,-323,-105,422055,422220,165
107,0,blank,0,-323,-105,422220,422394,174
107,0,blank,0,-323,-105,422394,422540,146
107,0,blank,0,-323,-105,422540,422712,172
107,0,blank,0,-323,-105,422712,422882,170
107,0,blank,0,-323,-105,422882,423075,193
107,0,blank,0,-323,-105,423075,423248,173
107,0,blank,0,-323,-105,423248,423429,181
107,0,blank,0,-323,-105,423429,423596,167
107,0,blank,0,-323,-105,423596,423751,155
107,0,blank,0,-323,-105,423751,423944,193
107,0,blank,0,-323,-105,423944,424134,190
107,0,blank,0,-323,-105,424134,424236,102
107,0,blank,0,-323,-105,424236,424339,103
107,0,blank,0,-323,-105,424339,424524,185
107,0,blank,0,-323,-105,424524,424692,168
107,0,blank,0,-323,-105,424692,424813,121
107,0,blank,0,-323,-105,424813,424923,110
107,0,blank,0,-323,-105,424923,425124,201
107,0,blank,0,-323,-105,425124,425224,100
107,0,blank,0,-323,-105,425224,425419,195
107,0,blank,0,-323,-105,425419,425591,172
107,0,blank,0,-323,-105,425591,425743,152
107,0,blank,0,-323,-105,425743,425857,114
107,0,blank,0,-323,-105,425857,426031,174
108,0,blank,0,-323,-105,429507,429694,187
108,0,blank,0,-323,-105,429694,429875,181
108,0,blank,0,-323,-105,429875,430192,317
108,0,blank,0,-323,-105,430192,430530,338
108,0,blank,0,-323,-105,430530,430769,239
108,0,blank,0,-323,-105,430769,430951,182
108,0,blank,0,-323,-105,430951,431084,133
108,0,blank,0,-323,-105,431084,431276,192
108,0,blank,0,-323,-105,431276,431476,200
108,0,blank,0,-323,-105,431476,431695,219
108,0,blank,0,-323,-105,431695,431865,170
108,0,blank,0,-323,-105,431865,432090,225
108,0,blank,0,-323,-105,432090,432524,434
108,0,blank,0,-323,-105,432524,432989,465
108,0,blank,0,-323,-105,432989,433173,184
108,0,blank,0,-323,-105,433173,433347,174
108,0,blank,0,-323,-105,433347,433531,184
108,0,blank,0,-323,-105,433531,433697,166
108,0,blank,0,-323,-105,433697,433737,40
108,0,blank,0,-323,-105,433737,434035,298
108,0,blank,0,-323,-105,434035,434221,186
108,0,blank,0,-323,-105,434221,434368,147
108,0,blank,0,-323,-105,434368,434552,184
108,0,blank,0,-323,-105,434552,434584,32
108,0,blank,0,-323,-105,434584,434761,177
108,0,blank,0,-323,-105,434761,434919,158
108,0,blank,0,-323,-105,434919,435102,183
108,0,blank,0,-323,-105,435102,435247,145
108,0,blank,0,-323,-105,435247,435336,89
108,0,blank,0,-323,-105,435336,435841,505
108,0,blank,0,-323,-105,435841,436008,167
108,0,blank,0,-323,-105,436008,436186,178
108,0,blank,0,-323,-105,436186,436363,177
108,0,blank,0,-323,-105,436363,436543,180
108,0,blank,0,-323,-105,436543,436674,131
108,0,blank,0,-323,-105,436674,436913,239
108,0,blank,0,-323,-105,436913,436982,69
108,0,blank,0,-323,-105,436982,437146,164
108,0,blank,0,-323,-105,437146,437329,183
108,0,blank,0,-323,-105,437329,437678,349
108,0,blank,0,-323,-105,437678,437871,193
108,0,blank,0,-323,-105,437871,438059,188
108,0,blank,0,-323,-105,438059,438158,99
108,0,blank,0,-323,-105,438158,438395,237
108,0,blank,0,-323,-105,438395,438646,251
108,0,blank,0,-323,-105,438646,439069,423
108,0,blank,0,-323,-105,439069,439250,181
108,0,blank,0,-323,-105,439250,439428,178
108,0,blank,0,-323,-105,439428,439562,134
108,0,blank,0,-323,-105,439562,439860,298
108,0,blank,0,-323,-105,439860,440163,303
108,0,blank,0,-323,-105,440163,440595,432
108,0,blank,0,-323,-105,440595,440780,185
108,0,blank,0,-323,-105,440780,440948,168
108,0,blank,0,-323,-105,440948,441123,175
108,0,blank,0,-323,-105,441123,441311,188
108,0,blank,0,-323,-105,441311,441481,170
108,0,blank,0,-323,-105,441481,441596,115
108,0,blank,0,-323,-105,441596,441703,107
108,0,blank,0,-323,-105,441703,441931,228
108,0,blank,0,-323,-105,441931,442040,109
108,0,blank,0,-323,-105,442040,442203,163
108,0,blank,0,-323,-105,442203,442370,167
108,0,blank,0,-323,-105,442370,442558,188
108,0,blank,0,-323,-105,442558,442731,173
108,0,blank,0,-323,-105,442731,442910,179
108,0,blank,0,-323,-105,442910,443073,163
108,0,blank,0,-323,-105,443073,443249,176
108,0,blank,0,-323,-105,443249,443374,125
108,0,blank,0,-323,-105,443374,443649,275
108,0,blank,0,-323,-105,443649,444150,501
108,0,blank,0,-323,-105,444150,444332,182
108,0,blank,0,-323,-105,444332,444511,179
108,0,blank,0,-323,-105,444511,444708,197
108,0,blank,0,-323,-105,444708,444881,173
108,0,blank,0,-323,-105,444881,445066,185
108,0,blank,0,-323,-105,445066,445243,177
108,0,blank,0,-323,-105,445243,445415,172
108,0,blank,0,-323,-105,445415,445542,127
108,0,blank,0,-323,-105,445542,445678,136
108,0,blank,0,-323,-105,445678,445987,309
108,0,blank,0,-323,-105,445987,446307,320
108,0,blank,0,-323,-105,446307,446665,358
108,0,blank,0,-323,-105,446665,446855,190
108,0,blank,0,-323,-105,446855,447032,177
108,0,blank,0,-323,-105,447032,447181,149
108,0,blank,0,-323,-105,447181,447343,162
108,0,blank,0,-323,-105,447343,447607,264
108,0,blank,0,-323,-105,447607,448047,440
108,0,blank,0,-323,-105,448047,448246,199
108,0,blank,0,-323,-105,448246,448334,88
108,0,blank,0,-323,-105,448334,448505,171
108,0,blank,0,-323,-105,448505,448677,172
108,0,blank,0,-323,-105,448677,448847,170
108,0,blank,0,-323,-105,448847,449005,158
108,0,blank,0,-323,-105,449005,449130,125
108,0,blank,0,-323,-105,449130,449224,94
108,0,blank,0,-323,-105,449224,449387,163
108,0,blank,0,-323,-105,449387,449496,109
108,0,blank,0,-323,-105,449496,449600,104
108,0,blank,0,-323,-105,449600,449795,195
108,0,blank,0,-323,-105,449795,449991,196
108,0,blank,0,-323,-105,449991,450162,171
108,0,blank,0,-323,-105,450162,450195,33
108,0,blank,0,-323,-105,450195,450429,234
108,0,blank,0,-323,-105,450429,450597,168
108,0,blank,0,-323,-105,450597,450717,120
108,0,blank,0,-323,-105,450717,450975,258
108,0,blank,0,-323,-105,450975,451170,195
108,0,blank,0,-323,-105,451170,451233,63
108,0,blank,0,-323,-105,451233,451451,218
108,0,blank,0,-323,-105,451451,451631,180
108,0,blank,0,-323,-105,451631,451831,200
108,0,blank,0,-323,-105,451831,452012,181
108,0,blank,0,-323,-105,452012,452162,150
108,0,blank,0,-323,-105,452162,452341,179
108,0,blank,0,-323,-105,452341,452525,184
108,0,blank,0,-323,-105,452525,452734,209
108,0,blank,0,-323,-105,452734,452922,188
108,0,blank,0,-323,-105,452922,453107,185
108,0,blank,0,-323,-105,453107,453305,198
108,0,blank,0,-323,-105,453305,453334,29
108,0,blank,0,-323,-105,453334,453572,238
108,0,blank,0,-323,-105,453572,453808,236
108,0,blank,0,-323,-105,453808,453986,178
108,0,blank,0,-323,-105,453986,454103,117
108,0,blank,0,-323,-105,454103,454291,188
108,0,blank,0,-323,-105,454291,454461,170
108,0,blank,0,-323,-105,454461,454611,150
108,0,blank,0,-323,-105,454611,454895,284
108,0,blank,0,-323,-105,454895,455072,177
108,0,blank,0,-323,-105,455072,455210,138
108,0,blank,0,-323,-105,455210,455404,194
108,0,blank,0,-323,-105,455404,455623,219
108,0,blank,0,-323,-105,455623,455803,180
108,0,blank,0,-323,-105,455803,455959,156
108,0,blank,0,-323,-105,455959,456145,186
108,0,blank,0,-323,-105,456145,456363,218
108,0,blank,0,-323,-105,456363,456542,179
108,0,blank,0,-323,-105,456542,456600,58
108,0,blank,0,-323,-105,456600,456801,201
108,0,blank,0,-323,-105,456801,457000,199
108,0,blank,0,-323,-105,457000,457112,112
108,0,blank,0,-323,-105,457112,457236,124
108,0,blank,0,-323,-105,457236,457552,316
108,0,blank,0,-323,-105,457552,457734,182
108,0,blank,0,-323,-105,457734,457890,156
108,0,blank,0,-323,-105,457890,458064,174
108,0,blank,0,-323,-105,458064,458238,174
108,0,blank,0,-323,-105,458238,458425,187
108,0,blank,0,-323,-105,458425,458606,181
108,0,blank,0,-323,-105,458606,458766,160
108,0,blank,0,-323,-105,458766,458929,163
108,0,blank,0,-323,-105,458929,459125,196
108,0,blank,0,-323,-105,459125,459317,192
108,0,blank,0,-323,-105,459317,459494,177
108,0,blank,0,-323,-105,459494,459682,188
108,0,blank,0,-323,-105,459682,459775,93
109,0,blank,0,-323,-105,462038,462201,163
109,0,blank,0,-323,-105,462201,462391,190
109,0,blank,0,-323,-105,462391,462580,189
109,0,blank,0,-323,-105,462580,462776,196
109,0,blank,0,-323,-105,462776,462966,190
109,0,blank,0,-323,-105,462966,463105,139
109,0,blank,0,-323,-105,463105,463210,105
109,0,blank,0,-323,-105,463210,463323,113
109,7,"Entertotalnumberofelements:",38,236.6223,144.1031,463346,463372,26
109,0,blank,0,-323,-105,463407,463591,184
109,0,blank,0,-323,-105,463591,463769,178
109,0,blank,0,-323,-105,463769,463951,182
109,0,blank,0,-323,-105,463951,464076,125
109,0,blank,0,-323,-105,464076,464345,269
109,0,blank,0,-323,-105,464345,464541,196
109,0,blank,0,-323,-105,464541,464718,177
109,0,blank,0,-323,-105,464718,464908,190
109,0,blank,0,-323,-105,464908,465077,169
109,0,blank,0,-323,-105,465077,465176,99
109,0,blank,0,-323,-105,465176,465520,344
109,0,blank,0,-323,-105,465520,465653,133
109,0,blank,0,-323,-105,465653,465822,169
109,0,blank,0,-323,-105,465822,465932,110
109,0,blank,0,-323,-105,465932,466100,168
109,0,blank,0,-323,-105,466100,466287,187
109,0,blank,0,-323,-105,466287,466415,128
109,0,blank,0,-323,-105,466415,466740,325
109,0,blank,0,-323,-105,466740,466784,44
109,0,blank,0,173.8218,310.0545,467500,467529,29
109,10,++,65,284.2512,214.4079,467731,467760,29
109,0,blank,0,-323,-105,467789,467971,182
109,0,blank,0,-323,-105,467971,468073,102
110,0,blank,0,-323,-105,469045,469468,423
110,28,list,162,212.9312,198.7383,469520,469573,53
110,0,blank,0,-323,-105,470065,470259,194
110,0,blank,0,-323,-105,470259,470439,180
110,0,blank,0,-323,-105,470439,470624,185
110,0,blank,0,-323,-105,470624,470758,134
110,0,blank,0,-323,-105,470758,470926,168
110,0,blank,0,-323,-105,470926,471000,74
110,0,blank,0,-323,-105,471000,471208,208
110,0,blank,0,-323,-105,471208,471390,182
110,0,blank,0,-323,-105,471390,471435,45
110,0,blank,0,-323,-105,471435,471661,226
110,0,blank,0,-323,-105,471661,471686,25
110,0,blank,0,-323,-105,471686,472135,449
110,0,blank,0,-323,-105,472135,472575,440
110,0,blank,0,-323,-105,472575,472757,182
110,0,blank,0,-323,-105,472757,472936,179
110,0,blank,0,-323,-105,472936,473125,189
110,0,blank,0,-323,-105,473125,473261,136
110,0,blank,0,-323,-105,473261,473394,133
110,0,blank,0,-323,-105,473394,473566,172
110,0,blank,0,-323,-105,473566,473734,168
110,0,blank,0,-323,-105,473734,473927,193
110,0,blank,0,-323,-105,473927,474095,168
110,0,blank,0,-323,-105,474095,474288,193
110,0,blank,0,-323,-105,474288,474455,167
110,0,blank,0,-323,-105,474455,474636,181
110,0,blank,0,-323,-105,474636,474736,100
110,0,blank,0,-323,-105,474736,475038,302
110,0,blank,0,-323,-105,475038,475339,301
110,0,blank,0,-323,-105,475339,475805,466
110,0,blank,0,-323,-105,475805,475980,175
110,0,blank,0,-323,-105,475980,476176,196
110,0,blank,0,-323,-105,476176,476249,73
110,0,blank,0,-323,-105,476249,476774,525
110,0,blank,0,-323,-105,476774,477178,404
110,0,blank,0,-323,-105,477178,477371,193
110,0,blank,0,-323,-105,477371,477537,166
110,0,blank,0,-323,-105,477537,477698,161
110,0,blank,0,-323,-105,477698,477922,224
110,0,blank,0,-323,-105,477922,478239,317
110,0,blank,0,-323,-105,478239,478417,178
110,0,blank,0,-323,-105,478417,478479,62
110,0,blank,0,-323,-105,478479,478742,263
110,0,blank,0,-323,-105,478742,479008,266
110,0,blank,0,-323,-105,479008,479204,196
110,0,blank,0,-323,-105,479204,479379,175
110,0,blank,0,-323,-105,479379,479526,147
110,0,blank,0,-323,-105,479526,479821,295
110,0,blank,0,-323,-105,479821,479985,164
110,0,blank,0,-323,-105,479985,480057,72
110,0,blank,0,-323,-105,480057,480474,417
110,0,blank,0,-323,-105,480474,480757,283
110,0,blank,0,-323,-105,480757,481030,273
110,0,blank,0,-323,-105,481030,481190,160
110,0,blank,0,-323,-105,481190,481425,235
110,0,blank,0,-323,-105,481425,481459,34
110,0,blank,0,-323,-105,481459,481706,247
110,0,blank,0,-323,-105,481706,481975,269
110,0,blank,0,-323,-105,481975,482168,193
110,0,blank,0,-323,-105,482168,482360,192
110,0,blank,0,-323,-105,482360,482557,197
110,0,blank,0,-323,-105,482557,482752,195
110,0,blank,0,-323,-105,482752,482922,170
110,0,blank,0,-323,-105,482922,483125,203
110,0,blank,0,-323,-105,483125,483161,36
110,0,blank,0,-323,-105,483161,483471,310
110,0,blank,0,-323,-105,483471,483800,329
110,0,blank,0,-323,-105,483800,483995,195
110,0,blank,0,-323,-105,483995,484244,249
110,0,blank,0,-323,-105,484244,484276,32
110,0,blank,0,-323,-105,484276,484970,694
110,0,blank,0,-323,-105,484970,485661,691
110,0,blank,0,-323,-105,485661,485855,194
110,0,blank,0,-323,-105,485855,486048,193
110,0,blank,0,-323,-105,486048,486245,197
110,0,blank,0,-323,-105,486245,486345,100
110,0,blank,0,-323,-105,486345,486653,308
110,0,blank,0,-323,-105,486653,486731,78
110,0,blank,0,-323,-105,486731,487104,373
110,0,blank,0,-323,-105,487104,487307,203
110,0,blank,0,-323,-105,487307,487480,173
110,0,blank,0,-323,-105,487480,487511,31
110,0,blank,0,-323,-105,487511,487698,187
110,0,blank,0,-323,-105,487698,487930,232
110,0,blank,0,-323,-105,487930,488367,437
110,0,blank,0,-323,-105,488367,488557,190
110,0,blank,0,-323,-105,488557,488744,187
110,0,blank,0,-323,-105,488744,488925,181
110,0,blank,0,-323,-105,488925,489109,184
110,0,blank,0,-323,-105,489109,489281,172
110,0,blank,0,-323,-105,489281,489705,424
110,0,blank,0,-323,-105,489705,489973,268
110,0,blank,0,-323,-105,489973,490164,191
110,0,blank,0,-323,-105,490164,490342,178
110,0,blank,0,-323,-105,490342,490537,195
110,0,blank,0,-323,-105,490537,490705,168
110,0,blank,0,-323,-105,490705,490899,194
110,0,blank,0,-323,-105,490899,491027,128
110,0,blank,0,-323,-105,491027,491184,157
110,0,blank,0,-323,-105,491184,491342,158
110,0,blank,0,-323,-105,491342,491523,181
110,0,blank,0,-323,-105,491523,491702,179
110,0,blank,0,-323,-105,491702,491896,194
110,0,blank,0,-323,-105,491896,492073,177
110,0,blank,0,-323,-105,492073,492250,177
110,0,blank,0,-323,-105,492250,492422,172
110,0,blank,0,-323,-105,492422,492509,87
110,0,blank,0,-323,-105,492509,492743,234
110,0,blank,0,-323,-105,492743,492775,32
110,0,blank,0,-323,-105,492775,493352,577
110,0,blank,0,-323,-105,493352,493769,417
110,0,blank,0,-323,-105,493769,493951,182
110,0,blank,0,-323,-105,493951,494060,109
110,0,blank,0,133.0595,257.8394,494096,494128,32
110,30,mergeSort,178,173.8706,236.7596,494238,494267,29
110,0,blank,0,-323,-105,494483,494584,101
110,29,high,175,335.6917,208.9213,494609,494635,26
110,28,mid,166,303.5413,197.7589,494684,494710,26
110,30,mid,184,319.994,233.6649,494734,494759,25
110,0,blank,0,292.7859,229.9604,494927,494956,29
110,28,mid,166,313.0688,195.6403,495128,495156,28
110,0,blank,0,374.2639,203.893,495386,495414,28
110,0,blank,0,379.7762,221.1019,495500,495529,29
110,0,blank,0,359.3319,206.5479,495645,495673,28
110,0,blank,0,358.524366666667,206.8352,495730,495815,85
110,0,blank,0,365.9703,213.2676,495843,495872,29
110,29,high,175,306.7461,221.8776,496188,496217,29
110,30,mid,184,310.2591,234.0329,496246,496275,29
110,0,blank,0,301.3612,219.1604,496304,496333,29
110,0,blank,0,357.8212,203.6899,496477,496506,29
110,0,blank,0,-323,-105,496592,496693,101
110,0,blank,0,-323,-105,496693,496901,208
110,0,blank,0,-323,-105,496901,497096,195
110,0,blank,0,-323,-105,497096,497127,31
110,28,mid,166,317.1514,197.5384,497547,497577,30
110,28,mid,166,323.2752,196.7293,497723,497752,29
110,0,blank,0,-323,-105,497887,498066,179
110,0,blank,0,-323,-105,498066,498091,25
110,0,blank,0,367.7418,180.066,498165,498190,25
110,0,blank,0,368.3119,191.7648,498212,498241,29
110,43,list,270,258.2302,527.0476,498470,498549,79
110,38,;,236,164.2801,415.6268,499487,499513,26
110,0,blank,0,-323,-105,499712,499907,195
110,0,blank,0,-323,-105,499907,500084,177
110,0,blank,0,-323,-105,500084,500271,187
110,0,blank,0,-323,-105,500271,500453,182
110,0,blank,0,-323,-105,500453,500581,128
110,0,blank,0,-323,-105,500581,500919,338
110,0,blank,0,-323,-105,500919,501214,295
110,0,blank,0,-323,-105,501214,501350,136
110,0,blank,0,-323,-105,501350,501527,177
110,0,blank,0,-323,-105,501527,501688,161
110,0,blank,0,-323,-105,501688,501777,89
110,0,blank,0,-323,-105,501777,501920,143
110,0,blank,0,-323,-105,501920,502153,233
110,0,blank,0,-323,-105,502153,502430,277
110,0,blank,0,-323,-105,502430,502616,186
110,0,blank,0,-323,-105,502616,502840,224
110,0,blank,0,-323,-105,502840,503074,234
110,0,blank,0,-323,-105,503074,503442,368
110,0,blank,0,-323,-105,503442,503629,187
110,0,blank,0,-323,-105,503629,503835,206
110,0,blank,0,-323,-105,503835,504025,190
110,0,blank,0,-323,-105,504025,504223,198
110,0,blank,0,-323,-105,504223,504305,82
110,0,blank,0,-323,-105,504305,504467,162
110,0,blank,0,-323,-105,504467,504628,161
110,0,blank,0,-323,-105,504628,504785,157
110,0,blank,0,-323,-105,504785,504958,173
110,0,blank,0,-323,-105,504958,505095,137
110,0,blank,0,-323,-105,505095,505195,100
110,0,blank,0,-323,-105,505195,505348,153
110,0,blank,0,-323,-105,505348,505467,119
110,0,blank,0,-323,-105,505467,505665,198
110,0,blank,0,-323,-105,505665,505860,195
110,0,blank,0,-323,-105,505860,505952,92
110,0,blank,0,-323,-105,505952,506218,266
110,0,blank,0,-323,-105,506218,506382,164
110,0,blank,0,-323,-105,506382,506576,194
110,0,blank,0,-323,-105,506576,506771,195
110,0,blank,0,-323,-105,506771,506818,47
110,0,blank,0,-323,-105,506818,507018,200
110,0,blank,0,-323,-105,507018,507109,91
110,0,blank,0,-323,-105,507109,507350,241
110,0,blank,0,-323,-105,507350,507527,177
110,0,blank,0,-323,-105,507527,507684,157
110,0,blank,0,-323,-105,507684,507875,191
110,0,blank,0,-323,-105,507875,508006,131
110,0,blank,0,-323,-105,508006,508152,146
110,0,blank,0,-323,-105,508152,508335,183
110,0,blank,0,-323,-105,508335,508521,186
110,0,blank,0,-323,-105,508521,508690,169
110,0,blank,0,-323,-105,508690,508866,176
110,0,blank,0,-323,-105,508866,509047,181
110,0,blank,0,-323,-105,509047,509193,146
110,0,blank,0,-323,-105,509193,509370,177
110,0,blank,0,-323,-105,509370,509461,91
110,0,blank,0,-323,-105,509461,509790,329
110,0,blank,0,-323,-105,509790,509956,166
110,0,blank,0,-323,-105,509956,510140,184
110,0,blank,0,-323,-105,510140,510306,166
110,0,blank,0,-323,-105,510306,510371,65
110,0,blank,0,-323,-105,510371,510535,164
110,0,blank,0,-323,-105,510535,510833,298
110,0,blank,0,-323,-105,510833,511215,382
110,0,blank,0,-323,-105,511215,511469,254
110,0,blank,0,-323,-105,511469,511723,254
110,0,blank,0,-323,-105,511723,511915,192
110,0,blank,0,-323,-105,511915,512149,234
110,0,blank,0,-323,-105,512149,512336,187
110,0,blank,0,-323,-105,512336,512493,157
110,0,blank,0,-323,-105,512493,512633,140
110,0,blank,0,-323,-105,512633,512739,106
110,0,blank,0,-323,-105,512739,512902,163
110,0,blank,0,-323,-105,512902,513074,172
110,0,blank,0,-323,-105,513074,513271,197
110,0,blank,0,-323,-105,513271,513392,121
110,0,blank,0,-323,-105,513392,513629,237
110,0,blank,0,-323,-105,513629,513880,251
110,0,blank,0,-323,-105,513880,514311,431
110,0,blank,0,-323,-105,514311,514482,171
110,0,blank,0,-323,-105,514482,514518,36
110,0,blank,0,-323,-105,514518,514758,240
110,0,blank,0,-323,-105,514758,514990,232
110,0,blank,0,-323,-105,514990,515318,328
110,0,blank,0,-323,-105,515454,515649,195
110,0,blank,0,-323,-105,515649,515826,177
110,0,blank,0,-323,-105,515826,516012,186
110,0,blank,0,-323,-105,516012,516152,140
110,0,blank,0,-323,-105,516739,516931,192
110,0,blank,0,-323,-105,516931,517109,178
110,0,blank,0,-323,-105,517109,517239,130
110,0,blank,0,294.6707,284.4125,517332,517357,25
110,0,blank,0,-323,-105,517504,517687,183
110,0,blank,0,-323,-105,517687,517864,177
110,0,blank,0,-323,-105,517864,517954,90
110,30,low,182,271.6725,240.0281,518306,518350,44
110,30,low,182,269.5114,247.878,518381,518410,29
110,29,mid,173,256.0159,212.295433333333,518440,518527,87
110,29,mid,173,248.555333333333,222.247433333333,518731,518820,89
110,0,blank,0,239.1392,195.7355,518908,518938,30
110,0,blank,0,-323,-105,519144,519334,190
110,0,blank,0,189.48028,172.28874,519360,519494,134
110,29,mid,173,258.8533,212.475366666667,519583,519674,91
110,28,comma,165,279.3732,199.4918,519793,519823,30
110,28,low,164,246.0605,191.4855,519942,520000,58
110,29,mid,173,243.957466666667,214.133766666667,520059,520147,88
110,29,mid,173,247.9281,208.026366666667,520205,520291,86
110,29,mid,173,245.0298,209.83365,520321,520378,57
110,29,partition,169,154.1141,220.8653,520408,520437,29
110,28,partition,160,154.0114,202.379066666667,520494,520581,87
110,27,mid,150,97.2394333333333,174.007633333333,520640,520726,86
110,0,blank,0,114.1505,182.8208,520755,520783,28
110,0,blank,0,124.848925,144.293775,520813,520928,115
110,25,<,146,115.8613,128.6872,521014,521044,30
110,0,blank,0,124.4268,128.2745,521161,521190,29
110,25,<,146,115.999016666667,130.60105,521277,521452,175
110,25,low,145,99.258275,122.242575,521568,521684,116
110,25,low,145,98.3029,128.3683,521743,521802,59
110,0,blank,0,148.3188,142.1964,521831,521860,29
110,0,blank,0,145.55325,142.9132,521918,521976,58
110,0,blank,0,145.4373,162.245,522006,522035,29
110,0,blank,0,152.0001,151.9666,522093,522122,29
110,0,blank,0,128.095,124.4558,522210,522239,29
110,0,blank,0,121.7762,118.844,522269,522298,29
110,0,blank,0,-323,-105,522386,522467,81
110,25,high,147,158.3525,121.335,522580,522605,25
110,0,blank,0,161.0674,150.155,522631,522658,27
110,0,blank,0,-323,-105,522717,522898,181
110,0,blank,0,-323,-105,522898,523065,167
110,0,blank,0,-323,-105,523065,523140,75
110,0,blank,0,183.152166666667,162.928166666667,523194,523279,85
110,27,=,151,128.704433333333,181.536933333333,523367,523457,90
110,28,partition,160,142.50995,190.38825,523487,523547,60
110,28,list,162,194.0376,198.7378,523664,523695,31
110,29,list,171,196.6849,213.0819,523784,523815,31
110,0,blank,0,240.69985,218.409,523873,523933,60
110,29,mid,173,261.3465,219.8565,523991,524020,29
110,29,mid,173,251.0654,207.6044,524136,524164,28
110,0,blank,0,-323,-105,524193,524349,156
110,27,high,155,229.69235,178.74215,524472,524522,50
110,28,list,162,197.1515,196.4934,524547,524577,30
110,27,+,154,201.3732,177.86655,524663,524723,60
110,27,(,152,151.6898,165.3363,524869,524900,31
110,27,low,153,154.14045,180.90205,524929,524989,60
110,28,partition,160,164.4519,204.7474,525019,525048,29
110,28,partition,160,145.6274,195.2763,525078,525108,30
110,30,low,182,248.46335,242.3146,525167,525228,61
110,29,mid,173,252.0802,212.0284,525290,525411,121
110,29,mid,173,253.4379,209.06395,525442,525503,61
110,28,low,164,255.136,196.135,525534,525564,30
110,29,list,171,214.5493,209.7834,525629,525660,31
110,27,high,155,220.129,183.0825,525692,525724,32
110,28,list,162,213.7763,191.058,525786,525817,31
110,0,blank,0,-323,-105,525849,525960,111
110,29,mid,173,251.76665,217.541125,526055,526170,115
110,0,blank,0,-323,-105,526232,526366,134
110,28,low,164,273.07395,193.82825,526486,526538,52
110,27,/,157,278.0274,180.1951,526569,526601,32
110,28,comma,165,276.33345,189.18445,526632,526821,189
110,0,blank,0,-323,-105,526917,527025,108
110,29,comma,174,285.2039,217.60525,527210,527263,53
110,0,blank,0,277.7306,222.53955,527294,527356,62
110,30,low,182,248.2194,230.9525,527387,527418,31
110,0,blank,0,242.9696,212.5467,527511,527542,31
110,29,mid,173,250.1347,218.9967,527573,527635,62
110,0,blank,0,-323,-105,527696,527802,106
110,0,blank,0,-323,-105,527854,527906,52
110,29,mid,173,270.209816666667,226.612633333333,527932,528100,168
110,0,blank,0,240.48155,213.7876,528130,528250,120
110,0,blank,0,-323,-105,528342,528524,182
110,0,blank,0,-323,-105,528524,528719,195
110,0,blank,0,-323,-105,528719,528909,190
110,0,blank,0,-323,-105,528909,529009,100
110,0,blank,0,-323,-105,529009,529336,327
110,0,blank,0,-323,-105,529336,529368,32
110,0,blank,0,-323,-105,529368,529783,415
110,0,blank,0,-323,-105,529783,530430,647
110,0,blank,0,-323,-105,530430,530619,189
110,0,blank,0,-323,-105,530619,530760,141
110,0,blank,0,-323,-105,530760,530876,116
110,0,blank,0,-323,-105,530876,531069,193
110,0,blank,0,-323,-105,531069,531232,163
110,0,blank,0,-323,-105,531232,531673,441
110,0,blank,0,-323,-105,531673,531870,197
110,0,blank,0,-323,-105,531870,532058,188
110,0,blank,0,-323,-105,532058,532396,338
110,0,blank,0,-323,-105,532396,532563,167
110,0,blank,0,-323,-105,532563,532853,290
110,0,blank,0,-323,-105,532853,533029,176
110,0,blank,0,-323,-105,533029,533211,182
110,0,blank,0,-323,-105,533211,533305,94
110,0,blank,0,-323,-105,533305,533456,151
110,0,blank,0,-323,-105,533456,533528,72
110,0,blank,0,-323,-105,533528,533657,129
110,0,blank,0,-323,-105,533657,534074,417
110,0,blank,0,-323,-105,534074,534287,213
110,0,blank,0,-323,-105,534287,534467,180
110,0,blank,0,-323,-105,534467,534493,26
110,0,blank,0,-323,-105,534493,534744,251
110,0,blank,0,-323,-105,534744,534929,185
110,0,blank,0,-323,-105,534929,535356,427
110,0,blank,0,-323,-105,535356,536022,666
110,0,blank,0,-323,-105,536022,536208,186
110,0,blank,0,-323,-105,536208,536374,166
110,0,blank,0,-323,-105,536374,536534,160
110,0,blank,0,-323,-105,536534,536647,113
110,0,blank,0,-323,-105,536647,537000,353
110,0,blank,0,-323,-105,537000,537254,254
110,0,blank,0,-323,-105,537254,537411,157
110,0,blank,0,-323,-105,537411,537581,170
110,0,blank,0,-323,-105,537581,537732,151
110,0,blank,0,-323,-105,537732,537910,178
110,0,blank,0,-323,-105,537910,538052,142
110,0,blank,0,-323,-105,538052,538236,184
110,0,blank,0,-323,-105,538236,538326,90
110,0,blank,0,-323,-105,538326,538644,318
110,0,blank,0,-323,-105,538644,538671,27
110,0,blank,0,-323,-105,538671,538957,286
110,0,blank,0,-323,-105,538957,538996,39
110,0,blank,0,1039.4965,228.3501,539845,539903,58
110,0,blank,0,1055.2745,300.22225,540522,540580,58
110,0,blank,0,-323,-105,540719,540851,132
110,0,blank,0,-323,-105,540851,540957,106
110,0,blank,0,158.44395,141.3775,541272,541330,58
110,28,partition,160,148.2131,200.7919,541535,541563,28
110,0,blank,0,116.2918,181.2243,541649,541677,28
110,28,partition,160,131.99,188.730666666667,541764,541851,87
110,28,partition,160,115.7399,195.7187,541909,541938,29
110,0,blank,0,-323,-105,541996,542177,181
110,28,(,161,178.9195,186.3118,542283,542308,25
111,0,blank,0,-323,-105,543284,543466,182
111,0,blank,0,-323,-105,543466,543653,187
111,0,blank,0,-323,-105,543653,543827,174
111,0,blank,0,-323,-105,543827,544003,176
111,0,blank,0,-323,-105,544003,544132,129
111,0,blank,0,-323,-105,544132,544352,220
111,0,blank,0,-323,-105,544352,544549,197
111,0,blank,0,-323,-105,544549,544743,194
111,0,blank,0,-323,-105,544743,544908,165
111,0,blank,0,-323,-105,544908,545049,141
111,0,blank,0,-323,-105,545049,545190,141
111,0,blank,0,-323,-105,545190,545354,164
111,0,blank,0,-323,-105,545354,545532,178
111,0,blank,0,-323,-105,545532,545569,37
111,33,comma,204,338.2158,124.5232,545584,545612,28
111,0,blank,0,380.0065,135.1033,545698,545725,27
111,0,blank,0,377.4269,122.4744,545755,545784,29
111,33,mid,203,388.8844,125.2193,545813,545842,29
111,0,blank,0,381.3812,152.6419,545870,545899,29
111,0,blank,0,384.4003,135.8981,545928,545957,29
111,0,blank,0,333.991866666667,98.7840666666667,546016,546103,87
111,0,blank,0,280.1655,68.9653,546249,546279,30
111,30,low,182,274.3809,55.1589,546308,546337,29
111,0,blank,0,241.5206,30.3096,546483,546513,30
111,33,low,200,306.8849,117.019233333333,546749,546837,88
111,0,blank,0,301.7375,130.8907,546867,546897,30
111,0,blank,0,-323,-105,546956,547035,79
111,29,mid,173,270.5439,39.4818,547148,547174,26
111,28,low,164,272.2639,23.433,547223,547248,25
111,0,blank,0,235.3658,11.5572,547307,547335,28
111,29,list,171,219.7747,29.4757,547365,547395,30
111,0,blank,0,-323,-105,547633,547815,182
111,0,blank,0,-323,-105,547815,547984,169
111,0,blank,0,-323,-105,547984,548160,176
111,0,blank,0,-323,-105,548160,548350,190
111,0,blank,0,-323,-105,548350,548540,190
111,0,blank,0,-323,-105,548540,548584,44
111,0,blank,0,-323,-105,548584,548790,206
111,0,blank,0,-323,-105,548790,548988,198
111,0,blank,0,-323,-105,548988,549124,136
111,0,blank,0,-323,-105,549124,549293,169
111,0,blank,0,-323,-105,549293,549444,151
111,0,blank,0,-323,-105,549444,549569,125
111,0,blank,0,-323,-105,549569,549747,178
111,0,blank,0,-323,-105,549747,549854,107
111,0,blank,0,314.0165,-16.7881,549997,550035,38
111,0,blank,0,-323,-105,550114,550285,171
111,0,blank,0,-323,-105,550285,550361,76
111,0,blank,0,324.21115,-10.3425,550616,550680,64
111,0,blank,0,314.944766666667,-14.8488666666667,550710,550800,90
111,0,blank,0,316.519,1.0492,550862,550892,30
111,28,mid,166,303.9669,17.14515,550982,551043,61
111,28,mid,166,303.975566666667,10.9541666666667,551160,551279,119
111,28,mid,166,295.3974,21.9532,551363,551392,29
111,28,mid,166,317.86035,21.2484,551451,551512,61
111,28,mid,166,316.123225,14.837925,551541,551664,123
111,28,mid,166,313.0084,10.9432333333333,551691,551782,91
111,28,mid,166,302.2319,9.4906,551842,551871,29
111,29,high,175,323.2943,25.8237,551902,551933,31
111,0,blank,0,-323,-105,551992,552099,107
111,28,mid,166,308.3851,3.76519999999999,552215,552239,24
111,28,mid,166,309.1356,19.7095,552264,552293,29
111,0,blank,0,318.2953,0.305899999999994,552438,552464,26
111,0,blank,0,309.96435,-5.56135,552496,552556,60
111,0,blank,0,329.6896,-8.3292,552586,552616,30
111,28,mid,166,310.6086,3.39,552800,552830,30
111,28,mid,166,317.9872,13.8309,552890,552920,30
111,0,blank,0,305.5667,-22.0297,552950,552981,31
111,0,blank,0,362.487266666667,-8.5043,553102,553193,91
111,0,blank,0,368.041,13.9238,553222,553253,31
111,0,blank,0,-323,-105,553449,553578,129
111,0,blank,0,355.9448,-8.271,553739,553764,25
111,28,mid,166,307.0975,7.53789999999999,553819,553850,31
111,0,blank,0,296.11115,-6.7724,554004,554064,60
111,28,mid,166,318.625,8.62009999999999,554094,554125,31
111,28,mid,166,302.6678,5.3556,554240,554267,27
111,0,blank,0,339.40555,2.3192,554388,554449,61
111,0,blank,0,-323,-105,554510,554641,131
111,0,blank,0,368.90675,6.41825,554861,554922,61
111,0,blank,0,353.71205,20.204,555013,555074,61
111,0,blank,0,217.07135,104.34635,555317,555377,60
111,28,),167,329.52735,21.55585,555557,555618,61
111,29,high,175,330.4562,30.2125,555677,555710,33
111,0,blank,0,232.6474,24.8201,555831,555862,31
111,0,blank,0,229.9789,1.2663,555891,555923,32
111,0,blank,0,240.4547,30.3042,555952,555983,31
111,28,mid,166,307.5231,19.0128,556209,556238,29
111,0,blank,0,-323,-105,556298,556425,127
111,0,blank,0,352.9801,31.4732,556579,556604,25
111,29,high,175,336.8776,34.2928,556634,556695,61
111,28,),167,326.6843,16.7,556725,556755,30
111,30,mid,184,322.8873,47.1129,556785,556816,31
111,29,high,175,327.6221,30.4568,556846,556878,32
111,29,high,175,330.948425,33.707525,556970,557092,122
111,29,high,175,325.418,31.1191,557304,557335,31
111,29,;,177,358.6583,29.761,557456,557488,32
111,0,blank,0,368.1001,18.2992,557548,557579,31
111,0,blank,0,-323,-105,557817,558000,183
111,28,mid,166,295.090966666667,6.9671,558100,558182,82
111,28,mid,166,295.04355,3.4613,558213,558273,60
111,29,),176,351.589633333333,42.9487333333333,558456,558548,92
111,30,comma,185,326.54075,64.14075,558914,558972,58
111,30,high,186,347.878,48.86038,559063,559234,171
111,30,high,186,357.2911,47.9181,559294,559325,31
111,0,blank,0,-323,-105,559446,559629,183
111,0,blank,0,-323,-105,559629,559823,194
111,0,blank,0,-323,-105,559823,560010,187
111,0,blank,0,-323,-105,560010,560133,123
111,0,blank,0,-323,-105,560133,560342,209
111,0,blank,0,-323,-105,560342,560371,29
111,0,blank,0,-323,-105,560371,560636,265
111,0,blank,0,-323,-105,560636,560770,134
111,0,blank,0,-323,-105,560770,560930,160
111,0,blank,0,-323,-105,560930,561080,150
111,0,blank,0,-323,-105,561080,561194,114
111,0,blank,0,-323,-105,561194,561366,172
111,0,blank,0,-323,-105,561366,561559,193
111,0,blank,0,-323,-105,561559,561735,176
111,0,blank,0,-323,-105,561735,561886,151
111,0,blank,0,-323,-105,561886,562045,159
111,0,blank,0,-323,-105,562045,562151,106
111,0,blank,0,-323,-105,562151,562343,192
111,0,blank,0,-323,-105,562343,562518,175
111,0,blank,0,-323,-105,562518,562687,169
111,35,i,210,85.5287,175.258,562709,562735,26
111,36,low,225,105.9227,192.3515,562823,562884,61
111,36,low,225,117.21285,197.564575,562915,563038,123
111,0,blank,0,-323,-105,563098,563279,181
111,0,blank,0,-323,-105,563279,563448,169
111,0,blank,0,-323,-105,563448,563617,169
111,0,blank,0,-323,-105,563617,563788,171
111,0,blank,0,-323,-105,563788,563984,196
111,0,blank,0,-323,-105,563984,564170,186
111,0,blank,0,-323,-105,564170,564309,139
111,0,blank,0,-323,-105,564309,564479,170
111,0,blank,0,-323,-105,564479,564627,148
111,0,blank,0,-323,-105,564627,564781,154
111,0,blank,0,-323,-105,564781,564949,168
111,0,blank,0,-323,-105,564949,565026,77
111,0,blank,0,-323,-105,565026,565212,186
111,0,blank,0,-323,-105,565212,565301,89
111,0,blank,0,-323,-105,565301,565464,163
111,0,blank,0,-323,-105,565464,565554,90
111,0,blank,0,-323,-105,565554,565696,142
111,0,blank,0,-323,-105,565696,565848,152
111,0,blank,0,-323,-105,565848,565933,85
111,0,blank,0,-323,-105,565933,566097,164
111,0,blank,0,-323,-105,566097,566166,69
111,0,blank,0,-323,-105,566166,566365,199
111,0,blank,0,-323,-105,566365,566484,119
111,0,blank,0,-323,-105,566484,566611,127
111,0,blank,0,-323,-105,566611,566798,187
111,0,blank,0,-323,-105,566798,566979,181
111,28,mid,166,322.8817,3.71120000000001,567136,567165,29
111,28,;,168,340.4402,15.0866,567195,567225,30
111,0,blank,0,336.9852,24.8455,567315,567346,31
111,28,mid,166,309.0385,11.7577,567497,567527,30
111,0,blank,0,-323,-105,567700,567807,107
111,0,blank,0,-321.796733333333,-104.74535,567896,568081,185
111,0,blank,0,-321.85605,-105.0139,568081,568142,61
111,29,high,175,331.1235,38.2982,568232,568257,25
111,28,;,168,336.3778,23.94775,568528,568590,62
111,0,blank,0,-323,-105,568651,568785,134
111,0,blank,0,375.6904,-21.0829,568974,569000,26
111,0,blank,0,846.837,-39.3469,569116,569146,30
111,0,blank,0,847.044,-58.64565,569292,569343,51
111,0,blank,0,957.932,-99.5504,569404,569434,30
111,0,blank,0,965.363666666667,-92.8478666666667,569496,569587,91
111,0,blank,0,977.05,-94.8163,569647,569678,31
111,0,blank,0,948.664,-105.0023,569738,569769,31
111,0,blank,0,959.127,-105.0096,569799,569829,30
111,0,blank,0,952.341,-76.2311,569859,569890,31
111,0,blank,0,958.259,-97.2493,569920,569950,30
111,0,blank,0,944.3144,-88.7081,570072,570225,153
111,0,blank,0,-323,-105,570311,570463,152
111,0,blank,0,-323,-105,570794,570978,184
111,0,blank,0,254.7698,-76.95,571338,571373,35
111,0,blank,0,-323,-105,571525,571698,173
111,0,blank,0,-323,-105,571698,571889,191
111,0,blank,0,-323,-105,571889,572035,146
111,0,blank,0,-323,-105,572035,572227,192
111,0,blank,0,-323,-105,572227,572425,198
111,0,blank,0,-323,-105,572425,572585,160
111,0,blank,0,-323,-105,572585,572706,121
111,0,blank,0,-323,-105,572706,572904,198
111,0,blank,0,-323,-105,572904,573068,164
111,0,blank,0,-323,-105,573068,573204,136
111,0,blank,0,-323,-105,573204,573323,119
111,0,blank,0,-323,-105,573323,573482,159
111,0,blank,0,-323,-105,573482,573669,187
111,0,blank,0,-323,-105,573669,573856,187
111,0,blank,0,-323,-105,573856,574037,181
111,0,blank,0,-323,-105,574037,574218,181
111,0,blank,0,-323,-105,574218,574383,165
111,0,blank,0,-323,-105,574383,574556,173
111,0,blank,0,-323,-105,574556,574731,175
111,0,blank,0,-323,-105,574731,574929,198
111,0,blank,0,-323,-105,574929,575113,184
111,0,blank,0,-323,-105,575113,575310,197
111,0,blank,0,-323,-105,575310,575499,189
111,0,blank,0,-323,-105,575499,575694,195
111,0,blank,0,-323,-105,575694,575883,189
111,0,blank,0,-323,-105,575883,576073,190
111,0,blank,0,-323,-105,576073,576253,180
111,0,blank,0,-323,-105,576253,576422,169
111,0,blank,0,-323,-105,576422,576610,188
111,0,blank,0,-323,-105,576610,576804,194
111,0,blank,0,-323,-105,576804,576994,190
111,0,blank,0,-323,-105,576994,577180,186
111,0,blank,0,-323,-105,577180,577370,190
111,0,blank,0,-323,-105,577370,577566,196
111,0,blank,0,-323,-105,577566,577754,188
111,0,blank,0,-323,-105,577754,577924,170
111,0,blank,0,-323,-105,577924,578069,145
111,0,blank,0,-323,-105,578069,578208,139
111,0,blank,0,-323,-105,578208,578398,190
111,0,blank,0,-323,-105,578398,578553,155
111,0,blank,0,-323,-105,578553,578691,138
111,0,blank,0,-323,-105,578691,578794,103
111,0,blank,0,-323,-105,578794,578927,133
111,0,blank,0,-323,-105,578927,579075,148
111,0,blank,0,-323,-105,579075,579270,195
111,0,blank,0,-323,-105,579270,579383,113
111,0,blank,0,-323,-105,579383,579576,193
111,0,blank,0,-323,-105,579576,579753,177
111,0,blank,0,-323,-105,579753,579882,129
111,0,blank,0,-323,-105,579882,580070,188
111,0,blank,0,-323,-105,580070,580254,184
111,0,blank,0,-323,-105,580254,580412,158
111,0,blank,0,-323,-105,580412,580516,104
111,0,blank,0,-323,-105,580516,580752,236
111,0,blank,0,-323,-105,580752,580981,229
111,0,blank,0,-323,-105,580981,581148,167
111,0,blank,0,-323,-105,581148,581305,157
111,0,blank,0,-323,-105,581305,581493,188
111,0,blank,0,-323,-105,581493,581678,185
111,0,blank,0,-323,-105,581678,581869,191
111,0,blank,0,-323,-105,581869,582039,170
111,0,blank,0,-323,-105,582039,582229,190
111,0,blank,0,-323,-105,582229,582398,169
111,0,blank,0,-323,-105,582398,582561,163
111,0,blank,0,-323,-105,582561,582632,71
111,0,blank,0,-323,-105,582632,582800,168
111,0,blank,0,-323,-105,582800,582986,186
111,0,blank,0,-323,-105,582986,583176,190
111,0,blank,0,-323,-105,583176,583364,188
111,0,blank,0,-323,-105,583364,583804,440
111,0,blank,0,-323,-105,583804,584035,231
111,0,blank,0,-323,-105,584035,584173,138
111,0,blank,0,-323,-105,584173,584356,183
111,0,blank,0,-323,-105,584356,584548,192
111,0,blank,0,-323,-105,584548,584747,199
111,0,blank,0,-323,-105,584747,584860,113
111,0,blank,0,-323,-105,584860,585124,264
111,0,blank,0,-323,-105,585124,585409,285
111,0,blank,0,-323,-105,585409,585577,168
111,0,blank,0,-323,-105,585577,585735,158
111,0,blank,0,-323,-105,585735,585865,130
111,0,blank,0,-323,-105,585865,585999,134
111,0,blank,0,-323,-105,585999,586165,166
111,0,blank,0,-323,-105,586165,586387,222
111,0,blank,0,-323,-105,586387,586470,83
111,0,blank,0,-323,-105,586470,586668,198
111,0,blank,0,-323,-105,586668,586801,133
111,0,blank,0,-323,-105,586801,586959,158
111,0,blank,0,-323,-105,586959,587107,148
111,0,blank,0,-323,-105,587107,587322,215
111,0,blank,0,-323,-105,587322,587519,197
111,0,blank,0,-323,-105,587519,587585,66
111,0,blank,0,-323,-105,587585,587748,163
111,0,blank,0,-323,-105,587748,588018,270
111,0,blank,0,-323,-105,588018,588147,129
111,0,blank,0,-323,-105,588147,588515,368
111,0,blank,0,-323,-105,588515,588708,193
111,0,blank,0,-323,-105,588708,588859,151
111,0,blank,0,-323,-105,588859,589009,150
111,0,blank,0,-323,-105,589009,589081,72
111,0,blank,0,-323,-105,589081,589222,141
111,0,blank,0,-323,-105,589222,589389,167
111,0,blank,0,-323,-105,589389,589524,135
111,0,blank,0,-323,-105,589524,589715,191
111,0,blank,0,-323,-105,589715,589907,192
111,0,blank,0,-323,-105,589907,590064,157
111,0,blank,0,-323,-105,590064,590239,175
111,0,blank,0,-323,-105,590239,590383,144
111,0,blank,0,-323,-105,590383,590579,196
111,0,blank,0,-323,-105,590579,590742,163
111,0,blank,0,-323,-105,590742,590905,163
111,0,blank,0,-323,-105,590905,591083,178
111,0,blank,0,-323,-105,591083,591200,117
111,0,blank,0,-323,-105,591200,591371,171
111,0,blank,0,-323,-105,591371,591548,177
111,0,blank,0,-323,-105,591548,591693,145
111,0,blank,0,-323,-105,591693,591864,171
111,0,blank,0,-323,-105,591864,592045,181
111,0,blank,0,-323,-105,592045,592109,64
111,0,blank,0,-323,-105,592109,592338,229
111,0,blank,0,-323,-105,592338,592569,231
111,0,blank,0,-323,-105,592569,592752,183
111,0,blank,0,-323,-105,592752,592934,182
111,0,blank,0,-323,-105,592934,593111,177
111,0,blank,0,-323,-105,593111,593289,178
111,0,blank,0,-323,-105,593289,593468,179
111,0,blank,0,-323,-105,593468,593649,181
111,0,blank,0,-323,-105,593649,593832,183
111,0,blank,0,-323,-105,593832,593996,164
111,0,blank,0,-323,-105,593996,594147,151
111,0,blank,0,-323,-105,594147,594288,141
111,0,blank,0,-323,-105,594288,594487,199
111,0,blank,0,-323,-105,594487,594684,197
111,0,blank,0,-323,-105,594684,594863,179
111,0,blank,0,-323,-105,594863,595062,199
111,0,blank,0,-323,-105,595062,595229,167
111,0,blank,0,-323,-105,595229,595293,64
111,0,blank,0,-323,-105,595293,595477,184
111,0,blank,0,-323,-105,595477,595635,158
111,0,blank,0,-323,-105,595635,595787,152
111,0,blank,0,-323,-105,595787,595984,197
111,0,blank,0,-323,-105,595984,596147,163
111,0,blank,0,-323,-105,596147,596327,180
111,0,blank,0,-323,-105,596327,596510,183
111,0,blank,0,-323,-105,596510,596696,186
111,0,blank,0,-323,-105,596696,596876,180
111,0,blank,0,-323,-105,596876,597059,183
111,0,blank,0,-323,-105,597059,597235,176
111,0,blank,0,-323,-105,597235,597410,175
111,0,blank,0,-323,-105,597410,597592,182
111,0,blank,0,-323,-105,597592,597770,178
111,0,blank,0,-323,-105,597770,597954,184
111,0,blank,0,-323,-105,597954,598132,178
111,0,blank,0,-323,-105,598132,598310,178
111,0,blank,0,-323,-105,598310,598491,181
112,0,blank,0,-323,-105,599742,599922,180
112,0,blank,0,-323,-105,599922,600106,184
112,0,blank,0,-323,-105,600106,600286,180
112,0,blank,0,-323,-105,600286,600468,182
112,0,blank,0,-323,-105,600468,600646,178
112,0,blank,0,-323,-105,600646,600820,174
112,0,blank,0,-323,-105,600820,600995,175
112,0,blank,0,-323,-105,600995,601177,182
112,0,blank,0,-323,-105,601177,601354,177
112,0,blank,0,-323,-105,601354,601552,198
112,0,blank,0,-323,-105,601552,601751,199
112,0,blank,0,-323,-105,601751,601936,185
112,0,blank,0,-323,-105,601936,602121,185
112,0,blank,0,-323,-105,602121,602284,163
112,0,blank,0,-323,-105,602284,602473,189
112,0,blank,0,-323,-105,602473,602656,183
112,0,blank,0,-323,-105,602656,602837,181
112,0,blank,0,-323,-105,602837,603014,177
112,0,blank,0,-323,-105,603014,603189,175
112,0,blank,0,-323,-105,603189,603364,175
112,0,blank,0,-323,-105,603364,603547,183
112,0,blank,0,-323,-105,603547,603725,178
112,0,blank,0,-323,-105,603725,603902,177
112,0,blank,0,-323,-105,603902,604081,179
112,0,blank,0,-323,-105,604081,604261,180
112,0,blank,0,-323,-105,604261,604442,181
112,0,blank,0,-323,-105,604442,604631,189
112,0,blank,0,-323,-105,604631,604805,174
112,0,blank,0,-323,-105,604805,604996,191
112,0,blank,0,-323,-105,604996,605169,173
112,0,blank,0,-323,-105,605169,605283,114
112,0,blank,0,-323,-105,605283,605459,176
112,0,blank,0,-323,-105,605459,605639,180
112,0,blank,0,-323,-105,605639,605827,188
112,0,blank,0,-323,-105,605827,606010,183
112,0,blank,0,-323,-105,606010,606182,172
112,0,blank,0,-323,-105,606182,606365,183
112,0,blank,0,-323,-105,606365,606541,176
112,0,blank,0,-323,-105,606541,606720,179
112,0,blank,0,-323,-105,606720,606899,179
112,0,blank,0,-323,-105,606899,607054,155
112,0,blank,0,-323,-105,607054,607235,181
112,0,blank,0,-323,-105,607235,607422,187
112,0,blank,0,-323,-105,607422,607587,165
112,0,blank,0,-323,-105,607587,607768,181
112,0,blank,0,-323,-105,607768,607955,187
112,0,blank,0,-323,-105,607955,608129,174
112,0,blank,0,-323,-105,608129,608303,174
112,0,blank,0,-323,-105,608303,608480,177
112,0,blank,0,-323,-105,608480,608656,176
112,0,blank,0,-323,-105,608656,608834,178
112,0,blank,0,-323,-105,608834,609018,184
112,0,blank,0,-323,-105,609018,609196,178
112,0,blank,0,-323,-105,609196,609378,182
112,0,blank,0,-323,-105,609378,609559,181
112,0,blank,0,-323,-105,609559,609738,179
112,0,blank,0,-323,-105,609738,609912,174
112,0,blank,0,-323,-105,609912,610088,176
112,0,blank,0,-323,-105,610088,610285,197
112,0,blank,0,-323,-105,610285,610440,155
112,0,blank,0,-323,-105,610440,610609,169
112,0,blank,0,-323,-105,610609,610778,169
112,0,blank,0,-323,-105,610778,610956,178
112,0,blank,0,-323,-105,610956,610992,36
112,0,blank,0,-323,-105,610992,611246,254
112,0,blank,0,-323,-105,611246,611500,254
112,0,blank,0,-323,-105,611500,611755,255
112,0,blank,0,-323,-105,611755,611931,176
112,0,blank,0,-323,-105,611931,612110,179
112,0,blank,0,-323,-105,612110,612184,74
112,0,blank,0,-323,-105,612184,612438,254
112,0,blank,0,-323,-105,612438,612692,254
112,0,blank,0,-323,-105,612692,612946,254
112,0,blank,0,-323,-105,612946,613121,175
112,0,blank,0,-323,-105,613121,613304,183
112,0,blank,0,-323,-105,613304,613491,187
112,0,blank,0,-323,-105,613491,613666,175
112,0,blank,0,-323,-105,613666,613840,174
112,0,blank,0,-323,-105,613840,614015,175
112,0,blank,0,-323,-105,614015,614193,178
112,0,blank,0,-323,-105,614193,614383,190
112,0,blank,0,-323,-105,614383,614571,188
112,0,blank,0,-323,-105,614571,614730,159
112,0,blank,0,-323,-105,614730,614862,132
112,0,blank,0,-323,-105,614862,615016,154
112,0,blank,0,-323,-105,615016,615200,184
112,0,blank,0,-323,-105,615200,615373,173
112,0,blank,0,-323,-105,615373,615561,188
112,0,blank,0,-323,-105,615561,615753,192
112,0,blank,0,-323,-105,615753,615931,178
112,0,blank,0,-323,-105,615931,616121,190
112,0,blank,0,-323,-105,616121,616313,192
112,0,blank,0,-323,-105,616313,616427,114
112,0,blank,0,103.5808,-103.8827,616452,616478,26
112,0,blank,0,-323,-105,616542,616727,185
112,0,blank,0,-323,-105,616727,616903,176
112,0,blank,0,-323,-105,616903,617083,180
112,0,blank,0,-323,-105,617083,617260,177
112,0,blank,0,-323,-105,617260,617438,178
112,0,blank,0,-323,-105,617438,617617,179
112,0,blank,0,-323,-105,617617,617798,181
112,0,blank,0,-323,-105,617798,617986,188
112,0,blank,0,-323,-105,617986,618160,174
112,0,blank,0,-323,-105,618160,618335,175
112,0,blank,0,-323,-105,618335,618512,177
112,0,blank,0,-323,-105,618512,618688,176
112,0,blank,0,-323,-105,618688,618865,177
112,0,blank,0,-323,-105,618865,619049,184
112,0,blank,0,-323,-105,619049,619205,156
112,0,blank,0,-323,-105,619205,619365,160
112,0,blank,0,-323,-105,619365,619480,115
112,0,blank,0,-323,-105,619480,619666,186
112,0,blank,0,-323,-105,619666,619786,120
112,0,blank,0,-323,-105,619786,619881,95
112,0,blank,0,-323,-105,619881,620239,358
112,0,blank,0,-323,-105,620239,620419,180
112,0,blank,0,-323,-105,620419,620611,192
112,0,blank,0,-323,-105,620611,620810,199
112,0,blank,0,-323,-105,620810,620992,182
112,0,blank,0,-323,-105,620992,621183,191
112,0,blank,0,-323,-105,621183,621366,183
112,0,blank,0,-323,-105,621366,621501,135
112,0,blank,0,-323,-105,621501,621688,187
112,0,blank,0,-323,-105,621688,621858,170
112,0,blank,0,-323,-105,621858,622042,184
112,0,blank,0,-323,-105,622042,622222,180
112,0,blank,0,-323,-105,622222,622391,169
112,0,blank,0,-323,-105,622391,622530,139
112,0,blank,0,-323,-105,622729,622909,180
112,0,blank,0,-323,-105,622909,623098,189
112,0,blank,0,-323,-105,623098,623293,195
112,0,blank,0,-323,-105,623293,623480,187
112,0,blank,0,-323,-105,623480,623663,183
112,0,blank,0,-323,-105,623663,623841,178
112,0,blank,0,-323,-105,623841,624016,175
112,0,blank,0,-323,-105,624016,624193,177
112,0,blank,0,-323,-105,624193,624370,177
112,0,blank,0,-323,-105,624370,624553,183
112,0,blank,0,-323,-105,624553,624732,179
112,0,blank,0,-323,-105,624732,624911,179
112,0,blank,0,-323,-105,624911,625091,180
112,0,blank,0,-323,-105,625091,625277,186
112,0,blank,0,-323,-105,625277,625474,197
112,0,blank,0,-323,-105,625474,625650,176
112,0,blank,0,-323,-105,625650,625781,131
112,0,blank,0,-323,-105,625781,625944,163
112,0,blank,0,-323,-105,625944,626097,153
112,0,blank,0,-323,-105,626097,626267,170
112,0,blank,0,-323,-105,626267,626432,165
112,0,blank,0,-323,-105,626432,626605,173
112,0,blank,0,-323,-105,626605,626779,174
112,0,blank,0,-323,-105,626779,626960,181
112,0,blank,0,-323,-105,626960,627137,177
112,0,blank,0,-323,-105,627137,627315,178
112,0,blank,0,-323,-105,627315,627493,178
112,0,blank,0,-323,-105,627493,627672,179
112,0,blank,0,-323,-105,627672,627851,179
112,0,blank,0,-323,-105,627851,628040,189
112,0,blank,0,-323,-105,628040,628221,181
112,0,blank,0,-323,-105,628221,628396,175
112,0,blank,0,-323,-105,628396,628571,175
112,0,blank,0,-323,-105,628571,628746,175
112,0,blank,0,-323,-105,628746,628928,182
112,0,blank,0,-323,-105,628928,629111,183
112,0,blank,0,-323,-105,629111,629254,143
112,0,blank,0,-323,-105,629254,629430,176
112,0,blank,0,-323,-105,629430,629628,198
112,0,blank,0,-323,-105,629628,629815,187
112,0,blank,0,-323,-105,629815,630014,199
112,0,blank,0,-323,-105,630014,630188,174
112,0,blank,0,-323,-105,630188,630372,184
112,0,blank,0,-323,-105,630372,630551,179
112,0,blank,0,-323,-105,630551,630731,180
112,0,blank,0,-323,-105,630731,630912,181
112,0,blank,0,-323,-105,630912,631091,179
112,0,blank,0,-323,-105,631091,631265,174
112,0,blank,0,-323,-105,631265,631435,170
112,0,blank,0,-323,-105,631435,631533,98
112,0,blank,0,-323,-105,631533,631698,165
112,0,blank,0,-323,-105,631698,631874,176
112,0,blank,0,-323,-105,631874,631971,97
112,0,blank,0,-323,-105,631971,632143,172
112,0,blank,0,-323,-105,632143,632324,181
112,0,blank,0,-323,-105,632324,632507,183
112,0,blank,0,-323,-105,632507,632686,179
112,0,blank,0,-323,-105,632686,632865,179
112,0,blank,0,-323,-105,632865,633045,180
112,0,blank,0,-323,-105,633045,633226,181
112,0,blank,0,-323,-105,633226,633407,181
112,0,blank,0,-323,-105,633407,633587,180
112,0,blank,0,-323,-105,633587,633762,175
112,0,blank,0,-323,-105,633762,633939,177
112,0,blank,0,-323,-105,633939,634115,176
112,0,blank,0,-323,-105,634115,634226,111
112,0,blank,0,-323,-105,634226,634360,134
112,0,blank,0,-323,-105,634360,634485,125
112,0,blank,0,-323,-105,634485,634666,181
112,0,blank,0,-323,-105,634666,634854,188
112,0,blank,0,-323,-105,634854,635038,184
112,0,blank,0,-323,-105,635038,635236,198
112,0,blank,0,-323,-105,635236,635414,178
112,0,blank,0,-323,-105,635414,635592,178
112,0,blank,0,-323,-105,635592,635784,192
112,0,blank,0,-323,-105,635784,635970,186
112,0,blank,0,-323,-105,635970,636145,175
112,0,blank,0,-323,-105,636145,636275,130
112,0,blank,0,-323,-105,636275,636457,182
112,0,blank,0,-323,-105,636457,636636,179
112,0,blank,0,-323,-105,636636,636810,174
112,0,blank,0,-323,-105,636810,636985,175
112,0,blank,0,-323,-105,636985,637162,177
112,0,blank,0,-323,-105,637162,637339,177
112,0,blank,0,-323,-105,637339,637529,190
112,0,blank,0,-323,-105,637529,637727,198
112,0,blank,0,-323,-105,637974,638158,184
112,0,blank,0,-323,-105,638158,638331,173
112,0,blank,0,-323,-105,638331,638506,175
112,0,blank,0,-323,-105,638506,638684,178
112,0,blank,0,-323,-105,638684,638868,184
112,0,blank,0,-323,-105,638868,639050,182
112,0,blank,0,-323,-105,639050,639231,181
112,0,blank,0,-323,-105,639231,639400,169
112,0,blank,0,-323,-105,639400,639590,190
112,0,blank,0,-323,-105,639590,639783,193
112,0,blank,0,-323,-105,639783,639940,157
112,0,blank,0,-323,-105,639940,640118,178
112,0,blank,0,-323,-105,640118,640279,161
112,0,blank,0,-323,-105,640279,640443,164
112,0,blank,0,-323,-105,640443,640620,177
112,0,blank,0,-323,-105,640620,640802,182
112,0,blank,0,-323,-105,640802,640993,191
112,0,blank,0,-323,-105,640993,641177,184
112,0,blank,0,-323,-105,641177,641354,177
112,0,blank,0,-323,-105,641354,641531,177
112,0,blank,0,-323,-105,641531,641698,167
112,0,blank,0,-323,-105,641698,641880,182
112,0,blank,0,-323,-105,641880,642058,178
112,0,blank,0,-323,-105,642058,642236,178
112,0,blank,0,-323,-105,642236,642415,179
112,0,blank,0,-323,-105,642415,642596,181
112,0,blank,0,-323,-105,642596,642777,181
112,0,blank,0,-323,-105,642777,642964,187
112,0,blank,0,-323,-105,642964,643142,178
112,0,blank,0,-323,-105,643142,643316,174
112,0,blank,0,-323,-105,643316,643493,177
112,0,blank,0,-323,-105,643493,643670,177
112,0,blank,0,-323,-105,643670,643848,178
112,0,blank,0,-323,-105,643848,644032,184
112,0,blank,0,-323,-105,644032,644210,178
112,0,blank,0,-323,-105,644210,644391,181
112,0,blank,0,-323,-105,644391,644572,181
112,0,blank,0,-323,-105,644796,644985,189
112,0,blank,0,-323,-105,644985,645162,177
112,0,blank,0,-323,-105,645162,645351,189
112,0,blank,0,-323,-105,645351,645527,176
112,0,blank,0,-323,-105,645527,645702,175
112,0,blank,0,-323,-105,645702,645877,175
112,0,blank,0,-323,-105,645877,646055,178
112,0,blank,0,-323,-105,646055,646233,178
112,0,blank,0,-323,-105,646233,646417,184
112,0,blank,0,-323,-105,646417,646596,179
112,0,blank,0,-323,-105,646596,646789,193
112,0,blank,0,-323,-105,646789,646966,177
112,0,blank,0,-323,-105,646966,647152,186
112,0,blank,0,-323,-105,647152,647323,171
112,0,blank,0,-323,-105,647323,647503,180
112,0,blank,0,-323,-105,647503,647617,114
112,0,blank,0,-323,-105,647617,647807,190
112,0,blank,0,-323,-105,647807,647980,173
112,0,blank,0,-323,-105,647980,648154,174
112,0,blank,0,-323,-105,648154,648329,175
112,0,blank,0,-323,-105,648329,648504,175
112,0,blank,0,-323,-105,648504,648701,197
112,0,blank,0,-323,-105,648701,648876,175
112,0,blank,0,-323,-105,648876,649034,158
112,0,blank,0,-323,-105,649034,649231,197
112,0,blank,0,-323,-105,649231,649406,175
112,0,blank,0,-323,-105,649406,649604,198
112,0,blank,0,-323,-105,649604,649777,173
112,0,blank,0,-323,-105,649777,649912,135
112,0,blank,0,-323,-105,649912,650085,173
112,0,blank,0,-323,-105,650085,650260,175
112,0,blank,0,-323,-105,650260,650447,187
112,0,blank,0,-323,-105,650447,650621,174
112,0,blank,0,-323,-105,650621,650799,178
112,0,blank,0,-323,-105,650799,650985,186
112,0,blank,0,-323,-105,650985,651157,172
112,0,blank,0,-323,-105,651157,651332,175
112,0,blank,0,-323,-105,651332,651506,174
112,0,blank,0,-323,-105,651506,651685,179
112,0,blank,0,-323,-105,651685,651861,176
112,0,blank,0,-323,-105,651861,652038,177
112,0,blank,0,-323,-105,652038,652228,190
112,0,blank,0,-323,-105,652228,652398,170
112,0,blank,0,-323,-105,652398,652573,175
112,0,blank,0,-323,-105,652573,652766,193
112,0,blank,0,-323,-105,652766,652952,186
112,0,blank,0,-323,-105,652952,653127,175
112,0,blank,0,-323,-105,653127,653302,175
112,0,blank,0,-323,-105,653302,653479,177
112,0,blank,0,-323,-105,653479,653657,178
112,0,blank,0,-323,-105,653657,653772,115
112,0,blank,0,-323,-105,653772,653968,196
112,0,blank,0,-323,-105,653968,654162,194
112,0,blank,0,-323,-105,654162,654337,175
112,0,blank,0,-323,-105,654337,654532,195
112,0,blank,0,-323,-105,654532,654707,175
112,0,blank,0,-323,-105,654707,654906,199
112,0,blank,0,-323,-105,654906,655075,169
112,0,blank,0,-323,-105,655075,655249,174
112,0,blank,0,-323,-105,655249,655431,182
112,0,blank,0,-323,-105,655431,655605,174
112,0,blank,0,-323,-105,655605,655782,177
112,0,blank,0,-323,-105,655782,655976,194
112,0,blank,0,-323,-105,655976,656138,162
112,0,blank,0,-323,-105,656138,656281,143
112,0,blank,0,-323,-105,656281,656430,149
112,0,blank,0,-323,-105,656430,656627,197
112,0,blank,0,-323,-105,656627,656803,176
112,0,blank,0,-323,-105,656803,656976,173
112,0,blank,0,-323,-105,656976,657156,180
112,0,blank,0,-323,-105,657156,657332,176
112,0,blank,0,-323,-105,657332,657509,177
112,0,blank,0,-323,-105,657509,657686,177
112,0,blank,0,-323,-105,657686,657859,173
112,0,blank,0,-323,-105,657859,658018,159
112,0,blank,0,-323,-105,658018,658216,198
112,0,blank,0,-323,-105,658216,658323,107
112,0,blank,0,-323,-105,658323,658522,199
112,0,blank,0,-323,-105,658522,658656,134
112,0,blank,0,-323,-105,658656,658851,195
112,0,blank,0,-323,-105,658851,659028,177
112,0,blank,0,-323,-105,659028,659215,187
112,0,blank,0,-323,-105,659215,659397,182
112,0,blank,0,-323,-105,659397,659569,172
112,0,blank,0,-323,-105,659569,659607,38
112,0,blank,0,-323,-105,659607,659871,264
112,0,blank,0,-323,-105,659871,660061,190
112,0,blank,0,-323,-105,660827,661012,185
112,0,blank,0,-323,-105,661012,661192,180
112,0,blank,0,-323,-105,661192,661377,185
112,0,blank,0,-323,-105,661377,661535,158
112,0,blank,0,-323,-105,661535,661663,128
112,0,blank,0,-323,-105,661663,661806,143
112,0,blank,0,-323,-105,661806,661874,68
112,0,blank,0,-323,-105,661874,662069,195
112,0,blank,0,-323,-105,662069,662261,192
112,0,blank,0,-323,-105,662261,662777,516
112,0,blank,0,-323,-105,662777,662970,193
112,0,blank,0,-323,-105,662970,663140,170
112,0,blank,0,-323,-105,663140,663175,35
