Frameno_fix,lineno_fix,Tokenname_fix,tokens_id,gaze_X_fix,gaze_Y_fix,timestamp_fix_start,timestamp_fix_end,time_duration
100,0,blank,0,123.85056,-38.40028,3888,4060,172
100,0,blank,0,140.2399,-34.03994,4060,4232,172
100,0,blank,0,140.519333333333,-40.5758333333333,4232,4336,104
100,1,are,13,551.0282,16.69772,4405,4576,171
100,0,blank,0,577.25485,17.2295,4576,4644,68
100,0,blank,0,-350,-105,4711,4820,109
100,0,blank,0,728.55,-29.3844,4864,4920,56
100,0,blank,0,712.435166666667,-21.3568333333333,4990,5179,189
100,0,blank,0,698.7122,-15.15484,5179,5349,170
100,0,blank,0,687.1014,-13.45092,5349,5518,169
100,0,blank,0,636.57204,-19.75402,5518,5685,167
100,0,blank,0,639.19575,-19.81815,5685,5752,67
100,9,row1,80,235.14918,182.14584,5785,5952,167
100,8,"EntertheorderofthematrixA\n",72,233.1225,160.40835,5952,6019,67
100,2,stdio,20,147.30565,39.7852166666667,6053,6250,197
100,2,stdio,20,153.29032,28.40326,6250,6416,166
100,1,accept,6,202.1431,22.0194,6416,6587,171
100,1,matrices,8,273.961116666667,18.4608666666667,6587,6786,199
100,1,matrices,8,287.710516666667,17.1597,6786,6984,198
100,0,blank,0,354.22776,11.61018,6984,7156,172
100,1,matrices,8,338.34426,14.24902,7156,7326,170
100,1,matrices,8,327.716333333333,13.5021333333333,7326,7426,100
100,0,blank,0,460.77515,11.46205,7461,7659,198
100,0,blank,0,489.02184,0.5548,7659,7827,168
100,0,blank,0,540.02066,-0.282540000000003,7827,7997,170
100,0,blank,0,603.94958,-1.8745,7997,8168,171
100,0,blank,0,586.92464,-2.8113,8168,8343,175
100,0,blank,0,568.420575,-0.629949999999997,8343,8485,142
100,3,stdlib,27,155.55358,53.0168,8521,8692,171
100,3,stdlib,27,124.1363,50.1914,8692,8868,176
100,3,stdlib,27,151.2217,52.66386,8868,9040,172
100,0,blank,0,196.22778,71.94798,9040,9214,174
100,0,blank,0,202.48192,67.20058,9214,9387,173
100,0,blank,0,196.47242,60.77782,9387,9562,175
100,0,blank,0,192.81252,65.11852,9562,9734,172
100,0,blank,0,132.19084,109.81502,9734,9907,173
100,0,blank,0,164.56176,110.00742,9907,10079,172
100,6,b,45,193.82126,118.07436,10079,10249,170
100,6,comma,44,178.82952,124.0939,10249,10418,169
100,6,[,49,249.928,116.80438,10418,10591,173
100,0,blank,0,267.73196,113.90684,10591,10763,172
100,0,blank,0,199.19042,141.46842,10763,10934,171
100,7,row1,58,166.3296,145.3793,10934,11104,170
100,0,blank,0,138.59096,149.90062,11104,11273,169
100,7,comma,65,125.98458,146.42968,11273,11444,171
100,0,blank,0,127.9797,113.18828,11444,11617,173
100,0,blank,0,128.96794,97.74922,11617,11790,173
100,6,10,50,147.26328,114.57538,11790,11962,172
100,7,row1,58,174.4767,138.7964,11962,12135,173
100,7,row1,58,174.3684,137.93304,12135,12309,174
100,7,row1,58,172.24272,146.97152,12309,12480,171
100,7,row1,58,178.16182,149.72838,12480,12648,168
100,0,blank,0,201.30554,151.85436,12648,12816,168
100,7,column1,60,203.897966666667,149.79055,12816,13015,199
100,7,comma,65,185.85485,154.422366666667,13015,13213,198
100,0,blank,0,199.071433333333,151.233233333333,13213,13410,197
100,8,"EntertheorderofthematrixA\n",72,172.858866666667,158.0826,13410,13542,132
100,7,row1,58,144.504,148.787,13542,13661,119
100,7,row1,58,147.543,149.7469,13661,13773,112
100,7,column1,60,216.40145,150.03855,13773,13971,198
100,7,column1,60,233.327266666667,154.535466666667,13971,14167,196
100,7,column1,60,237.272233333333,148.166983333333,14167,14365,198
100,7,column1,60,263.3993,152.48282,14365,14533,168
100,7,row2,62,325.22238,148.2168,14533,14706,173
100,7,row2,62,308.739,152.35724,14706,14875,169
100,7,comma,65,339.7117,143.613816666667,14875,15073,198
100,7,row2,62,323.864766666667,142.370683333333,15073,15271,198
100,7,column2,64,355.6465,148.24266,15271,15441,170
100,0,blank,0,390.189783333333,134.82515,15441,15640,199
100,7,column2,64,395.058783333333,145.063766666667,15640,15834,194
100,7,flag,66,450.1906,152.7041,15834,16032,198
100,7,flag,66,445.877116666667,140.88015,16032,16225,193
100,7,flag,66,459.673183333333,145.695383333333,16225,16420,195
100,0,blank,0,503.414266666667,131.843366666667,16420,16619,199
100,0,blank,0,520.668566666667,132.8196,16619,16817,198
100,7,;,69,528.58978,142.45916,16817,16983,166
100,0,blank,0,511.82612,139.18156,16983,17151,168
100,8,"EntertheorderofthematrixA\n",72,470.9962,162.80325,17151,17287,136
100,8,"EntertheorderofthematrixA\n",72,179.853,160.621816666667,17320,17518,198
100,8,"EntertheorderofthematrixA\n",72,152.7416,164.963,17518,17687,169
100,8,"EntertheorderofthematrixA\n",72,144.16364,167.86982,17687,17854,167
100,8,"EntertheorderofthematrixA\n",72,145.91475,158.6312,17854,18053,199
100,8,"EntertheorderofthematrixA\n",72,151.264466666667,157.044983333333,18053,18251,198
100,8,"EntertheorderofthematrixA\n",72,190.12395,158.556966666667,18251,18447,196
100,8,"EntertheorderofthematrixA\n",72,224.723816666667,168.988683333333,18447,18643,196
100,8,"EntertheorderofthematrixA\n",72,224.9762,164.401166666667,18643,18838,195
100,8,"EntertheorderofthematrixA\n",72,293.0363,161.559233333333,18838,19035,197
100,8,"EntertheorderofthematrixA\n",72,326.657583333333,165.643883333333,19035,19229,194
100,8,"EntertheorderofthematrixA\n",72,368.635383333333,168.02,19229,19426,197
100,8,"EntertheorderofthematrixA\n",72,402.455366666667,170.595483333333,19426,19625,199
100,8,"EntertheorderofthematrixA\n",72,447.284,175.03115,19625,19824,199
100,8,),73,481.884033333333,170.204983333333,19824,20023,199
100,8,),73,474.56958,166.00814,20023,20190,167
100,8,"EntertheorderofthematrixA\n",72,467.2681,172.713033333333,20190,20389,199
100,0,blank,0,493.49162,163.94546,20389,20555,166
100,8,;,74,488.849566666667,165.596733333333,20555,20754,199
100,8,"EntertheorderofthematrixA\n",72,468.440533333333,159.950316666667,20754,20952,198
100,8,"EntertheorderofthematrixA\n",72,285.896183333333,168.43665,20985,21180,195
100,8,"EntertheorderofthematrixA\n",72,197.00455,169.360466666667,21180,21377,197
100,8,"EntertheorderofthematrixA\n",72,186.037566666667,168.438233333333,21377,21574,197
100,0,blank,0,211.522383333333,178.911366666667,21574,21769,195
100,9,column1,83,288.9692,186.885283333333,21769,21968,199
100,9,column1,83,282.19765,189.215516666667,21968,22164,196
100,9,column1,83,298.37305,192.117683333333,22164,22363,199
100,9,column1,83,323.12836,195.47286,22363,22532,169
100,9,column1,83,300.52296,190.27862,22532,22699,167
100,9,column1,83,289.779566666667,194.50105,22699,22898,199
100,0,blank,0,296.439966666667,200.332266666667,22898,23093,195
100,9,column1,83,301.950416666667,194.44615,23093,23290,197
100,9,column1,83,287.910383333333,194.509566666667,23290,23488,198
100,9,column1,83,283.45015,195.725683333333,23488,23685,197
100,9,column1,83,295.10072,191.23112,23685,23853,168
100,9,column1,83,319.89596,196.31104,23853,24023,170
100,9,column1,83,307.65258,189.44172,24023,24194,171
100,9,column1,83,330.44016,186.75406,24194,24364,170
100,9,column1,83,340.62598,186.65836,24364,24537,173
100,9,column1,83,295.10192,189.58174,24537,24705,168
100,9,column1,83,281.73486,190.43148,24705,24875,170
100,9,column1,83,301.74152,194.2631,24875,25046,171
100,9,column1,83,309.18198,189.215,25046,25214,168
100,9,column1,83,286.68484,192.80128,25214,25383,169
100,0,blank,0,255.23364,189.4589,25383,25552,169
100,9,row1,80,223.52386,196.36772,25552,25722,170
100,9,row1,80,222.47296,193.34446,25722,25894,172
100,9,&,82,274.37612,194.70122,25894,26067,173
100,9,column1,83,289.09312,194.71986,26067,26238,171
100,9,&,82,273.05662,193.8335,26238,26407,169
100,9,&,82,270.4704,199.7121,26407,26441,34
100,0,blank,0,-350,-105,26476,26612,136
100,8,"EntertheorderofthematrixA\n",72,165.6948,171.659,26652,26685,33
100,8,"EntertheorderofthematrixA\n",72,167.198016666667,157.331566666667,26765,26963,198
100,0,blank,0,290.81624,153.88192,26963,27132,169
100,7,row2,62,300.25152,155.71328,27132,27300,168
100,8,"EntertheorderofthematrixA\n",72,326.74606,161.27482,27300,27469,169
100,8,"EntertheorderofthematrixA\n",72,326.73298,158.59316,27469,27641,172
100,7,row2,62,305.56612,149.00042,27641,27808,167
100,7,column2,64,379.3788,155.4533,27808,27979,171
100,7,column2,64,376.21596,155.63022,27979,28152,173
100,8,"EntertheorderofthematrixA\n",72,369.08612,166.08082,28152,28321,169
100,8,"EntertheorderofthematrixA\n",72,320.86824,167.5684,28321,28489,168
100,8,"EntertheorderofthematrixA\n",72,328.44484,166.82042,28489,28657,168
100,8,"EntertheorderofthematrixA\n",72,341.48058,167.45544,28657,28827,170
100,8,"EntertheorderofthematrixA\n",72,320.9288,158.44316,28827,28998,171
100,0,blank,0,283.01662,154.96904,28998,29164,166
100,7,column1,60,237.79476,152.35676,29164,29335,171
100,7,column1,60,227.0726,146.439675,29335,29471,136
100,0,blank,0,374.34396,156.74898,29505,29675,170
100,8,"EntertheorderofthematrixA\n",72,402.93088,158.26868,29675,29843,168
100,0,blank,0,444.916925,156.8763,29843,29975,132
100,8,"EntertheorderofthematrixA\n",72,319.1556,175.9305,30011,30177,166
100,8,"EntertheorderofthematrixA\n",72,274.13958,175.59128,30177,30346,169
100,9,row1,80,229.27832,183.91346,30346,30515,169
100,9,&,82,199.08784,186.3557,30515,30681,166
100,9,"%d%d",77,144.8584,188.43792,30681,30851,170
100,9,"%d%d",77,143.427466666667,197.986066666667,30851,30953,102
100,9,column1,83,289.108116666667,185.904183333333,30987,31186,199
100,9,column1,83,276.03186,179.39244,31186,31353,167
100,9,column1,83,325.09252,182.7567,31353,31520,167
100,0,blank,0,363.59216,185.74264,31520,31690,170
100,9,column1,83,340.32986,187.8405,31690,31862,172
100,10,"EntertheorderofthematrixB\n",88,284.722433333333,202.134066666667,31862,32061,199
100,8,"EntertheorderofthematrixA\n",72,282.69994,177.79018,32061,32229,168
100,0,blank,0,283.25525,144.43865,32229,32366,137
100,8,"EntertheorderofthematrixA\n",72,363.97656,174.3034,32401,32572,171
100,0,blank,0,286.05112,110.74892,32605,32776,171
100,0,blank,0,224.9202,106.45086,32776,32944,168
100,6,10,50,215.16606,115.26568,32944,33115,171
100,0,blank,0,214.5848,113.74756,33115,33284,169
100,0,blank,0,196.0274,113.49132,33284,33453,169
100,0,blank,0,158.70706,113.00804,33453,33626,173
100,0,blank,0,188.459375,116.87745,33626,33764,138
100,0,blank,0,-350,-105,33832,33944,112
100,0,blank,0,-350,-105,33944,34063,119
100,0,blank,0,-350,-105,34063,34242,179
100,0,blank,0,-350,-105,34242,34430,188
100,0,blank,0,-350,-105,34430,34610,180
100,0,blank,0,-350,-105,34610,34804,194
100,0,blank,0,-350,-105,34804,34956,152
100,0,blank,0,-350,-105,34956,35030,74
100,0,blank,0,-350,-105,35030,35210,180
100,0,blank,0,-350,-105,35210,35376,166
100,0,blank,0,-350,-105,35376,35555,179
100,0,blank,0,-350,-105,35555,35684,129
100,0,blank,0,-350,-105,35684,35800,116
100,0,blank,0,-350,-105,35800,35989,189
100,0,blank,0,-350,-105,35989,36157,168
100,0,blank,0,-350,-105,36157,36328,171
100,0,blank,0,-350,-105,36328,36458,130
100,0,blank,0,-350,-105,36458,36588,130
100,0,blank,0,-350,-105,36588,36718,130
100,0,blank,0,-350,-105,36718,36856,138
100,0,blank,0,-350,-105,36856,37088,232
100,0,blank,0,-350,-105,37088,37176,88
100,0,blank,0,-350,-105,37176,37370,194
100,7,comma,65,128.18005,140.70575,38044,38225,181
100,7,row1,58,159.42264,152.16456,38225,38403,178
100,7,row1,58,176.52868,147.503,38403,38586,183
100,7,row1,58,174.01344,148.80154,38586,38771,185
100,0,blank,0,141.32928,149.37516,38771,38955,184
100,7,column1,60,208.409,150.15052,38955,39141,186
100,7,comma,65,184.0253,144.94364,39141,39323,182
100,7,column1,60,203.4045,141.59998,39323,39501,178
100,7,column1,60,223.63578,140.2036,39501,39680,179
100,7,column1,60,256.93146,136.90708,39680,39857,177
100,7,comma,65,279.2663,141.31398,39857,40033,176
100,0,blank,0,293.8958,135.60254,40033,40207,174
100,0,blank,0,314.8904,135.2665,40207,40383,176
100,7,column2,64,353.88944,140.15626,40383,40558,175
100,7,column2,64,374.72678,140.9102,40558,40731,173
100,7,column2,64,412.08446,140.87042,40731,40905,174
100,0,blank,0,440.78422,136.30646,40905,41078,173
100,0,blank,0,508.24946,141.28482,41078,41251,173
100,7,1,68,522.72538,140.92732,41251,41422,171
100,7,;,69,525.37016,140.04738,41422,41594,172
100,7,;,69,527.58194,141.8593,41594,41765,171
100,7,;,69,530.36282,149.34896,41765,41936,171
100,7,;,69,531.35992,148.18862,41936,42107,171
100,0,blank,0,534.5173,147.9873,42107,42140,33
100,0,blank,0,-350,-105,42208,42398,190
100,0,blank,0,-350,-105,42398,42566,168
100,0,blank,0,-350,-105,42566,42738,172
100,0,blank,0,-350,-105,42738,42923,185
100,0,blank,0,-350,-105,42923,43103,180
100,0,blank,0,-350,-105,43103,43250,147
100,0,blank,0,-350,-105,43250,43437,187
100,0,blank,0,-350,-105,43437,43584,147
100,0,blank,0,-350,-105,43584,43779,195
100,0,blank,0,-350,-105,43779,43976,197
100,0,blank,0,-350,-105,43976,44170,194
100,0,blank,0,-350,-105,44170,44355,185
100,0,blank,0,-350,-105,44355,44547,192
100,0,blank,0,-350,-105,44547,44739,192
100,0,blank,0,-350,-105,44739,44925,186
100,7,column1,60,243.2102,146.35948,45284,45456,172
100,7,comma,65,186.75396,142.45812,45456,45625,169
100,7,row1,58,144.023766666667,142.875883333333,45625,45823,198
100,8,"EntertheorderofthematrixA\n",72,122.468883333333,172.426566666667,45823,46021,198
100,9,row1,80,218.39708,184.96476,46021,46188,167
100,9,row1,80,223.810933333333,182.669583333333,46188,46387,199
100,9,row1,80,221.6379,183.05532,46387,46556,169
100,9,comma,81,178.87498,191.52534,46556,46727,171
100,10,"EntertheorderofthematrixB\n",88,146.8834,202.30398,46727,46899,172
100,8,"EntertheorderofthematrixA\n",72,233.2976,172.8781,46899,47072,173
100,9,row1,80,235.0532,180.04848,47072,47245,173
100,9,row1,80,229.86266,180.4653,47245,47419,174
100,10,"EntertheorderofthematrixB\n",88,194.54182,221.41328,47419,47588,169
100,9,row1,80,211.24184,192.00588,47588,47754,166
100,8,"EntertheorderofthematrixA\n",72,230.19722,173.2558,47754,47923,169
100,8,"EntertheorderofthematrixA\n",72,274.02842,170.03438,47923,48091,168
100,8,"EntertheorderofthematrixA\n",72,269.143283333333,171.4496,48091,48290,199
100,10,"EntertheorderofthematrixB\n",88,209.219383333333,220.296716666667,48290,48489,199
100,10,"EntertheorderofthematrixB\n",88,194.871533333333,218.561916666667,48489,48688,199
100,9,(,76,99.41355,189.200216666667,48688,48887,199
100,9,scanf,75,76.0153,195.11316,48887,49057,170
100,9,scanf,75,68.1033,186.8592,49057,49091,34
100,9,column1,83,327.52074,193.57762,49123,49290,167
100,0,blank,0,372.0852,199.40342,49290,49457,167
100,0,blank,0,377.301533333333,194.244866666667,49457,49555,98
100,11,scanf,91,92.2419166666667,238.971283333333,49587,49785,198
100,12,printf,102,64.8782666666667,248.627583333333,49785,49978,193
100,0,blank,0,191.496483333333,230.271,49978,50173,195
100,8,"EntertheorderofthematrixA\n",72,217.8305,161.815783333333,50173,50369,196
100,8,"EntertheorderofthematrixA\n",72,355.6672,162.858716666667,50401,50597,196
100,7,column2,64,377.555066666667,153.8729,50597,50795,198
100,8,"EntertheorderofthematrixA\n",72,371.639066666667,158.139683333333,50795,50991,196
100,0,blank,0,366.97805,195.83765,50991,51190,199
100,0,blank,0,396.26426,193.21916,51190,51353,163
100,12,printf,102,103.796783333333,257.83155,51417,51615,198
100,12,printf,102,72.95308,248.29098,51615,51786,171
100,12,printf,102,71.11305,248.69765,51786,51852,66
100,11,comma,97,179.80638,243.68418,51884,52054,170
100,12,"EntertheelementsofmatrixA\n",104,163.21212,252.40196,52054,52224,170
100,12,"EntertheelementsofmatrixA\n",104,135.24558,250.40746,52224,52389,165
100,11,row2,96,238.98578,241.99446,52424,52597,173
100,0,blank,0,248.29038,244.93082,52597,52777,180
100,11,column2,99,294.231566666667,235.984866666667,52777,52974,197
100,0,blank,0,256.2893,234.489866666667,52974,53166,192
100,0,blank,0,254.77092,237.53728,53166,53338,172
100,11,column2,99,312.386266666667,238.350566666667,53338,53536,198
100,11,column2,99,299.183,238.4827,53536,53735,199
100,0,blank,0,254.59165,242.813333333333,53735,53934,199
100,11,comma,97,250.038683333333,240.922516666667,53934,54133,199
100,11,column2,99,309.30304,241.0806,54133,54312,179
100,11,column2,99,330.1169,239.6604,54312,54493,181
100,11,column2,99,313.2813,238.3738,54694,54719,25
100,11,column2,99,341.4309,239.428983333333,54803,54992,189
100,0,blank,0,363.86944,240.16594,54992,55161,169
100,11,),100,347.493616666667,241.251216666667,55161,55360,199
100,11,row2,96,241.7905,242.26178,55360,55529,169
100,0,blank,0,113.78504,255.95896,55563,55731,168
100,12,"EntertheelementsofmatrixA\n",104,137.1442,250.26562,55731,55897,166
100,12,"EntertheelementsofmatrixA\n",104,156.9665,248.18616,55897,56065,168
100,12,"EntertheelementsofmatrixA\n",104,146.775216666667,246.397633333333,56065,56264,199
100,11,"%d%d",93,140.14024,240.38984,56264,56432,168
100,0,blank,0,196.0253,244.86024,56432,56599,167
100,0,blank,0,198.561116666667,244.261266666667,56599,56798,199
100,0,blank,0,165.002183333333,244.277283333333,56798,56995,197
100,12,"EntertheelementsofmatrixA\n",104,162.939433333333,245.472833333333,56995,57191,196
100,11,"%d%d",93,134.94186,242.42724,57191,57359,168
100,12,"EntertheelementsofmatrixA\n",104,128.67012,245.5423,57359,57526,167
100,0,blank,0,190.317466666667,244.5545,57526,57725,199
100,0,blank,0,204.65026,244.23332,57725,57894,169
100,11,"%d%d",93,171.064966666667,237.433466666667,57894,58092,198
100,11,"%d%d",93,167.699033333333,235.443483333333,58092,58290,198
100,0,blank,0,228.015016666667,244.991166666667,58290,58487,197
100,11,row2,96,243.1738,237.975383333333,58487,58685,198
100,11,column2,99,276.27588,233.87114,58685,58854,169
100,11,column2,99,276.202,228.39242,58854,59026,172
100,12,"EntertheelementsofmatrixA\n",104,294.566716666667,245.7012,59026,59224,198
100,10,"EntertheorderofthematrixB\n",88,265.5936,207.2811,59224,59257,33
100,0,blank,0,256.17052,230.24936,59333,59512,179
100,12,"EntertheelementsofmatrixA\n",104,245.3778,245.65462,59512,59681,169
100,11,column2,99,285.93138,240.76634,59681,59852,171
100,11,comma,97,245.68905,240.30605,59852,60051,199
100,12,"EntertheelementsofmatrixA\n",104,200.248266666667,245.965933333333,60051,60250,199
100,0,blank,0,142.254783333333,244.187266666667,60250,60449,199
100,12,"EntertheelementsofmatrixA\n",104,141.612,248.146516666667,60449,60648,199
100,12,"EntertheelementsofmatrixA\n",104,222.952816666667,250.934733333333,60648,60845,197
100,12,"EntertheelementsofmatrixA\n",104,294.876333333333,254.4976,60845,61042,197
100,12,"EntertheelementsofmatrixA\n",104,325.224783333333,251.6195,61042,61240,198
100,12,"EntertheelementsofmatrixA\n",104,345.635683333333,250.826766666667,61240,61433,193
100,12,"EntertheelementsofmatrixA\n",104,338.0195,247.590916666667,61433,61631,198
100,12,"EntertheelementsofmatrixA\n",104,311.772233333333,249.920766666667,61631,61828,197
100,0,blank,0,367.3306,240.494733333333,61828,62024,196
100,0,blank,0,369.79525,241.10145,62024,62089,65
100,11,row2,96,222.655183333333,241.620416666667,62122,62321,199
100,11,row2,96,224.48974,236.57678,62321,62490,169
100,12,"EntertheelementsofmatrixA\n",104,158.16654,255.78924,62490,62658,168
100,12,"EntertheelementsofmatrixA\n",104,132.806216666667,252.190933333333,62658,62857,199
100,12,printf,102,80.78624,249.49256,62857,63024,167
100,12,printf,102,56.49555,245.24715,63024,63220,196
100,11,scanf,91,57.0305333333333,243.804033333333,63220,63415,195
100,12,(,103,109.92862,251.74472,63415,63583,168
100,11,"%d%d",93,120.58336,242.0074,63583,63760,177
100,12,printf,102,101.9277,245.60316,63760,63933,173
100,12,"EntertheelementsofmatrixA\n",104,121.93298,249.64818,63933,64115,182
100,12,"EntertheelementsofmatrixA\n",104,149.06372,246.3182,64115,64280,165
100,11,"%d%d",93,161.558416666667,242.54675,64280,64474,194
100,10,"EntertheorderofthematrixB\n",88,201.70262,217.27922,64474,64646,172
100,11,comma,97,177.2648,243.2448,64646,64838,192
100,10,"EntertheorderofthematrixB\n",88,231.71675,219.0811,64838,64976,138
100,11,row2,96,235.04295,240.7139,64976,65143,167
100,11,row2,96,241.2738,231.3696,65143,65218,75
100,12,"EntertheelementsofmatrixA\n",104,276.53766,261.40914,65291,65468,177
100,12,"EntertheelementsofmatrixA\n",104,306.248433333333,248.278583333333,65468,65662,194
100,12,"EntertheelementsofmatrixA\n",104,246.05916,249.21424,65662,65840,178
100,11,&,98,268.63036,243.27674,65840,66026,186
100,12,"EntertheelementsofmatrixA\n",104,321.32602,257.30462,66026,66192,166
100,12,"EntertheelementsofmatrixA\n",104,374.31745,246.636975,66192,66371,179
100,12,"EntertheelementsofmatrixA\n",104,413.96478,251.34532,66371,66541,170
100,0,blank,0,406.9027,243.7095,66541,66678,137
100,12,"EntertheelementsofmatrixA\n",104,377.59605,253.72835,66710,66778,68
100,10,"EntertheorderofthematrixB\n",88,402.42565,213.5138,66852,66922,70
100,0,blank,0,105.44988,271.78908,66960,67128,168
100,13,(,108,92.20235,267.306066666667,67128,67320,192
100,12,printf,102,83.1877833333333,245.1091,67320,67515,195
100,0,blank,0,86.8450833333333,244.7127,67515,67711,196
100,12,"EntertheelementsofmatrixA\n",104,206.89535,251.57725,67711,67910,199
100,12,"EntertheelementsofmatrixA\n",104,186.8099,256.071566666667,67910,68101,191
100,0,blank,0,109.7293,266.20252,68101,68273,172
100,13,=,110,119.98488,267.7692,68273,68444,171
100,12,"EntertheelementsofmatrixA\n",104,123.39902,257.39024,68444,68616,172
100,12,"EntertheelementsofmatrixA\n",104,139.80788,262.79382,68616,68787,171
100,13,<,114,186.0996,273.7385,68787,68959,172
100,12,"EntertheelementsofmatrixA\n",104,191.25655,264.696025,68959,69127,168
100,0,blank,0,200.295866666667,271.179166666667,69127,69322,195
100,13,row1,115,204.883566666667,283.633316666667,69322,69517,195
100,15,;,130,186.645816666667,322.045616666667,69517,69709,192
100,15,j,131,141.42305,319.8224,69709,69904,195
100,15,=,124,155.94474,312.75502,69904,70073,169
100,0,blank,0,172.78282,308.5416,70073,70255,182
100,15,<,128,228.719283333333,318.205333333333,70255,70450,195
100,15,<,128,228.763566666667,320.237766666667,70450,70641,191
100,15,column1,129,254.559616666667,314.270683333333,70641,70835,194
100,0,blank,0,241.219866666667,310.095266666667,70835,70932,97
100,0,blank,0,249.2346,306.30648,70996,71172,176
100,0,blank,0,307.16215,304.801833333333,71172,71369,197
100,0,blank,0,294.810533333333,307.236766666667,71369,71565,196
100,17,(,136,182.215366666667,362.66395,71565,71760,195
100,17,"%d",137,218.008583333333,360.198133333333,71760,71957,197
100,0,blank,0,242.830183333333,350.2433,71957,72152,195
100,0,blank,0,238.907033333333,349.570716666667,72152,72348,196
100,0,blank,0,237.962983333333,347.83065,72348,72545,197
100,0,blank,0,223.176216666667,343.77165,72545,72742,197
100,0,blank,0,249.758816666667,350.959766666667,72742,72939,197
100,0,blank,0,250.551116666667,348.84285,72939,73135,196
100,0,blank,0,93.2776,408.928533333333,73135,73333,198
100,20,printf,151,76.18326,425.4069,73333,73503,170
100,20,"EntertheelementsofmatrixB\n",153,180.530466666667,428.4188,73503,73699,196
100,20,"EntertheelementsofmatrixB\n",153,160.677433333333,427.263033333333,73699,73896,197
100,20,"EntertheelementsofmatrixB\n",153,131.791333333333,434.929833333333,73896,74092,196
100,20,"EntertheelementsofmatrixB\n",153,179.875,435.79332,74092,74265,173
100,20,"EntertheelementsofmatrixB\n",153,190.459516666667,428.847066666667,74265,74463,198
100,20,"EntertheelementsofmatrixB\n",153,188.721916666667,434.303566666667,74463,74658,195
100,20,"EntertheelementsofmatrixB\n",153,188.2342,426.6746,74658,74699,41
100,20,"EntertheelementsofmatrixB\n",153,315.6747,424.6565,74765,74895,130
100,20,"EntertheelementsofmatrixB\n",153,258.1624,423.7239,74895,75015,120
100,20,"EntertheelementsofmatrixB\n",153,207.041675,423.472225,75015,75201,186
100,21,i,166,168.24972,451.53806,75201,75373,172
100,0,blank,0,135.93022,442.17772,75373,75543,170
100,20,"EntertheelementsofmatrixB\n",153,122.09218,428.20938,75543,75714,171
100,20,"EntertheelementsofmatrixB\n",153,148.186666666667,425.278883333333,75714,75913,199
100,20,"EntertheelementsofmatrixB\n",153,156.244483333333,425.33465,75913,76105,192
100,20,"EntertheelementsofmatrixB\n",153,158.02524,427.18292,76105,76272,167
100,20,"EntertheelementsofmatrixB\n",153,176.687266666667,424.121666666667,76272,76467,195
100,20,"EntertheelementsofmatrixB\n",153,218.28374,425.2586,76467,76635,168
100,0,blank,0,222.10606,418.22828,76635,76807,172
100,20,"EntertheelementsofmatrixB\n",153,223.1723,422.50028,76807,76978,171
100,20,"EntertheelementsofmatrixB\n",153,227.62896,425.9149,76978,77146,168
100,20,"EntertheelementsofmatrixB\n",153,265.09526,427.72986,77146,77316,170
100,20,"EntertheelementsofmatrixB\n",153,315.24202,431.58582,77316,77488,172
100,20,"EntertheelementsofmatrixB\n",153,329.66286,427.32422,77488,77660,172
100,20,"EntertheelementsofmatrixB\n",153,338.95296,433.00908,77660,77831,171
100,20,"EntertheelementsofmatrixB\n",153,354.17954,434.4236,77831,78003,172
100,20,"EntertheelementsofmatrixB\n",153,376.99648,435.22252,78003,78173,170
100,20,"EntertheelementsofmatrixB\n",153,365.0328,425.5748,78173,78208,35
100,0,blank,0,145.68106,466.7384,78243,78411,168
100,0,blank,0,109.28304,453.40836,78411,78581,170
100,21,=,159,118.5356,452.4022,78581,78753,172
100,0,blank,0,125.23034,448.21678,78753,78921,168
100,0,blank,0,159.924,451.224466666667,78921,79117,196
100,21,i,166,169.245883333333,453.4627,79117,79313,196
100,0,blank,0,179.559883333333,446.08085,79313,79511,198
100,21,i,166,164.3508,453.272683333333,79511,79709,198
100,0,blank,0,181.136066666667,446.444166666667,79709,79908,199
100,0,blank,0,180.25894,453.7531,79908,80074,166
100,21,<,163,185.50112,451.01622,80074,80241,167
100,21,<,163,188.7113,452.157,80241,80409,168
100,0,blank,0,194.721125,455.45895,80409,80541,132
100,0,blank,0,-350,-105,80575,80685,110
100,21,row2,164,232.83355,452.768283333333,80821,81013,192
100,21,row2,164,234.48332,453.75386,81013,81184,171
100,21,row2,164,238.36768,451.67222,81184,81366,182
100,21,row2,164,234.2474,453.488,81366,81441,75
100,23,(,171,131.8267,499.7636,81479,81647,168
100,0,blank,0,183.271383333333,475.149833333333,81647,81846,199
100,21,row2,164,229.12445,458.145766666667,81846,82044,198
100,0,blank,0,153.84804,486.7927,82044,82217,173
100,23,j,180,139.25822,492.62972,82217,82387,170
100,0,blank,0,116.33894,478.60154,82387,82559,172
100,0,blank,0,100.99938,470.9548,82559,82731,172
100,0,blank,0,120.43678,469.29452,82731,82906,175
100,0,blank,0,160.84566,485.67472,82906,83078,172
100,0,blank,0,202.78474,492.1047,83078,83251,173
100,23,j,180,208.27468,489.8714,83251,83424,173
100,0,blank,0,242.05686,491.50608,83424,83593,169
100,0,blank,0,211.5891,482.40414,83593,83763,170
100,0,blank,0,201.24418,476.44758,83763,83934,171
100,0,blank,0,242.59968,488.26966,83934,84102,168
100,0,blank,0,223.29108,473.84408,84102,84267,165
100,0,blank,0,237.9226,470.35778,84267,84441,174
100,0,blank,0,299.06958,479.30186,84441,84613,172
100,0,blank,0,293.74138,485.60276,84613,84790,177
100,25,scanf,184,150.10378,537.33752,84829,85005,176
100,25,scanf,184,166.49888,537.20862,85005,85186,181
100,0,blank,0,241.34408,535.46428,85186,85355,169
100,0,blank,0,236.58268,533.38966,85355,85539,184
100,25,"%d",186,217.52196,533.7622,85539,85713,174
100,0,blank,0,223.2828,524.62104,85713,85884,171
100,23,<,177,225.30204,501.15172,85884,86054,170
100,23,<,177,231.65902,495.68364,86054,86223,169
100,23,column2,178,258.33242,497.12488,86223,86398,175
100,23,column2,178,248.8904,506.2936,86398,86463,65
100,28,"MATRIXAis\n",202,126.01934,606.20166,86496,86676,180
100,28,(,201,107.05236,606.4521,86676,86854,178
100,28,printf,200,71.41642,601.32854,86854,87025,171
100,28,printf,200,53.82148,603.8198,87025,87197,172
100,28,"MATRIXAis\n",202,159.11474,599.14408,87197,87367,170
100,28,"MATRIXAis\n",202,180.01926,598.2016,87367,87540,173
100,28,"MATRIXAis\n",202,150.39246,597.2547,87540,87711,171
100,28,"MATRIXAis\n",202,121.22606,604.6957,87711,87887,176
100,28,"MATRIXAis\n",202,167.19372,610.2888,87887,88058,171
100,28,"MATRIXAis\n",202,194.67166,600.73364,88058,88240,182
100,28,"MATRIXAis\n",202,204.91664,600.84296,88240,88425,185
100,0,blank,0,190.60726,593.60942,88425,88608,183
100,28,"MATRIXAis\n",202,180.70255,601.83955,88608,88758,150
100,28,"MATRIXAis\n",202,189.59822,597.56628,88792,88976,184
100,28,"MATRIXAis\n",202,211.08902,597.5173,88976,89152,176
100,28,"MATRIXAis\n",202,220.1245,598.86996,89152,89332,180
100,0,blank,0,198.94184,593.56842,89332,89506,174
100,0,blank,0,128.52384,448.90122,89506,89674,168
100,20,"EntertheelementsofmatrixB\n",153,118.2038,430.8818,89674,89872,198
100,0,blank,0,101.70785,399.7687,89872,89940,68
100,9,scanf,75,57.8642666666667,187.480433333333,89972,90168,196
100,9,scanf,75,53.4168,195.13325,90168,90232,64
100,10,"EntertheorderofthematrixB\n",88,176.96075,212.52255,90266,90462,196
100,0,blank,0,186.40068,237.98234,90462,90628,166
100,10,"EntertheorderofthematrixB\n",88,146.79278,213.12886,90628,90794,166
100,10,"EntertheorderofthematrixB\n",88,137.9669,203.95094,90794,90965,171
100,13,0,111,140.254633333333,267.86225,90965,91162,197
100,13,0,111,139.566183333333,283.569333333333,91162,91361,199
100,0,blank,0,162.23828,345.25302,91361,91535,174
100,13,for,107,55.5375,277.0109,91535,91704,169
100,13,(,108,92.46656,277.94618,91704,91876,172
100,12,"EntertheelementsofmatrixA\n",104,125.49472,265.3198,91876,92044,168
100,12,"EntertheelementsofmatrixA\n",104,161.07325,260.5309,92044,92242,198
100,12,"EntertheelementsofmatrixA\n",104,180.25176,262.30102,92242,92410,168
100,12,"EntertheelementsofmatrixA\n",104,172.9626,260.7103,92410,92442,32
100,21,0,160,137.61444,448.43432,92476,92644,168
100,21,=,159,118.01508,448.98504,92644,92814,170
100,21,=,159,113.55684,451.36948,92814,92980,166
100,21,i,166,100.632233333333,447.186733333333,92980,93179,199
100,20,printf,151,82.32254,433.01684,93179,93347,168
100,0,blank,0,131.303516666667,443.891466666667,93347,93543,196
100,0,blank,0,156.902016666667,447.73535,93543,93741,198
100,0,blank,0,155.16992,451.22268,93741,93909,168
100,17,scanf,135,126.857833333333,360.92875,93909,94107,198
100,0,blank,0,112.638166666667,390.53475,94107,94306,199
100,20,printf,151,97.50488,431.04906,94306,94473,167
100,20,printf,151,84.9013,438.5674,94473,94644,171
100,11,scanf,91,91.55326,235.98324,94679,94848,169
100,12,(,103,109.46855,245.698283333333,94848,95047,199
100,0,blank,0,147.7491,266.7394,95047,95141,94
100,13,i,117,165.7473,270.0964,95141,95262,121
100,13,i,117,170.655,269.236,95262,95355,93
100,12,"EntertheelementsofmatrixA\n",104,181.81475,261.4576,95355,95514,159
100,0,blank,0,171.19064,343.53032,95514,95702,188
100,0,blank,0,168.26864,442.65128,95702,95871,169
100,0,blank,0,193.60408,448.21478,95871,96042,171
100,0,blank,0,163.5737,471.6384,96042,96211,169
100,0,blank,0,123.66516,518.82342,96211,96381,170
100,0,blank,0,123.31294,505.04916,96381,96551,170
100,25,scanf,184,139.98984,548.67622,96551,96720,169
100,28,"MATRIXAis\n",202,127.649283333333,616.852866666667,96720,96918,198
100,28,printf,200,99.72095,610.030133333333,96918,97116,198
100,28,printf,200,59.97094,608.22898,97116,97283,167
100,28,printf,200,51.2607,603.535325,97283,97418,135
100,28,"MATRIXAis\n",202,161.68754,602.077,97451,97619,168
100,28,"MATRIXAis\n",202,163.15444,598.66004,97619,97789,170
100,28,"MATRIXAis\n",202,180.10766,600.17466,97789,97958,169
100,28,"MATRIXAis\n",202,199.42772,608.97372,97958,98131,173
100,28,"MATRIXAis\n",202,213.23364,607.98416,98131,98303,172
100,28,"MATRIXAis\n",202,216.66074,615.47064,98303,98472,169
100,28,"MATRIXAis\n",202,190.17014,608.79064,98540,98711,171
100,28,"MATRIXAis\n",202,191.59472,611.25368,98711,98881,170
100,29,(,206,88.7719,621.98738,98881,99050,169
100,29,(,206,88.19576,622.5351,99050,99218,168
100,29,for,205,67.80724,620.07334,99218,99388,170
100,28,printf,200,64.779625,614.12095,99388,99526,138
100,0,blank,0,165.32814,586.79018,99560,99730,170
100,0,blank,0,125.1449,621.70338,99730,99902,172
100,0,blank,0,125.78454,618.93046,99902,100069,167
100,0,blank,0,105.5162,621.0805,100069,100239,170
100,28,(,201,112.34836,616.9681,100239,100407,168
100,28,"MATRIXAis\n",202,138.09914,614.06138,100407,100575,168
100,0,blank,0,163.30742,620.65222,100575,100744,169
100,28,"MATRIXAis\n",202,185.58764,609.35076,100744,100917,173
100,28,"MATRIXAis\n",202,161.86618,612.40604,100917,101086,169
100,28,"MATRIXAis\n",202,169.3887,617.77076,101086,101256,170
100,0,blank,0,195.65754,623.14028,101256,101426,170
100,0,blank,0,194.2813,624.17372,101426,101609,183
100,29,row1,213,237.12334,621.40694,101609,101793,184
100,29,row1,213,237.57932,621.5676,101793,101968,175
100,29,row1,213,216.57286,620.03488,101968,102139,171
100,28,"MATRIXAis\n",202,236.35716,615.40342,102139,102318,179
100,28,"MATRIXAis\n",202,248.8763,612.36126,102318,102512,194
100,28,"MATRIXAis\n",202,242.31128,614.97086,102512,102691,179
100,0,blank,0,145.88814,662.92756,102725,102898,173
100,0,blank,0,176.9912,662.99146,102898,103068,170
100,0,blank,0,189.18032,660.97058,103068,103235,167
100,0,blank,0,167.944866666667,667.910033333333,103235,103433,198
100,0,blank,0,143.7242,661.932383333333,103433,103630,197
100,0,blank,0,169.200033333333,665.313983333333,103630,103825,195
100,31,j,229,204.23645,666.212,103825,104023,198
100,0,blank,0,221.139816666667,675.0739,104023,104222,199
100,31,<,226,229.595366666667,671.952866666667,104222,104416,194
100,31,<,226,231.05722,679.358,104416,104584,168
100,31,column1,227,264.999666666667,673.5311,104584,104783,199
100,31,column1,227,280.22446,680.41066,104783,104954,171
100,31,column1,227,281.47394,670.85096,104954,105126,172
100,0,blank,0,231.64342,641.73958,105126,105298,172
100,0,blank,0,192.57452,665.55484,105298,105468,170
100,0,blank,0,255.8183,660.96445,105468,105603,135
100,0,blank,0,1005.278,309.02722,105705,105872,167
100,0,blank,0,1004.08883333333,315.9956,105872,106070,198
100,0,blank,0,1002.2464,301.29766,106070,106237,167
100,0,blank,0,1006.6592,297.71692,106237,106404,167
100,0,blank,0,989.8254,307.5851,106404,106578,174
100,0,blank,0,997.6856,290.05696,106578,106753,175
100,0,blank,0,991.2662,293.88262,106753,106927,174
100,0,blank,0,989.1108,297.08538,106927,107102,175
100,0,blank,0,548.227075,522.28865,107171,107308,137
100,31,column1,227,293.38958,664.15544,107343,107511,168
100,31,column1,227,308.13864,672.16214,107511,107682,171
100,31,j,229,336.33638,669.57258,107682,107849,167
100,0,blank,0,323.85034,666.38498,107849,108016,167
100,31,;,228,314.878866666667,663.919366666667,108016,108213,197
100,31,;,228,318.981633333333,671.715066666667,108213,108411,198
100,0,blank,0,331.7813,684.0103,108411,108445,34
101,0,blank,0,238.279416666667,675.810883333333,109605,109797,192
101,0,blank,0,236.573266666667,667.911633333333,109797,109990,193
101,0,blank,0,254.358833333333,656.0081,109990,110183,193
101,0,blank,0,256.651016666667,658.504266666667,110183,110376,193
101,0,blank,0,259.969966666667,644.253416666667,110376,110574,198
101,0,blank,0,261.9936,627.6311,110574,110742,168
101,0,blank,0,274.290333333333,642.069616666667,110742,110936,194
101,33,comma,236,247.604166666667,643.701616666667,110936,111132,196
101,33,"%3d",235,237.07414,650.77682,111132,111300,168
101,33,"%3d",235,238.19164,650.0773,111300,111470,170
101,33,comma,236,246.09635,640.5497,111470,111669,199
101,0,blank,0,228.649,620.024983333333,111669,111868,199
101,0,blank,0,215.700783333333,602.42015,111868,112067,199
101,0,blank,0,188.86548,581.39938,112067,112236,169
101,0,blank,0,190.99194,593.18098,112236,112404,168
101,0,blank,0,202.026983333333,610.9642,112404,112602,198
101,0,blank,0,192.74145,610.07225,112602,112801,199
101,0,blank,0,196.648233333333,619.68575,112801,112999,198
101,0,blank,0,218.849333333333,604.7584,112999,113196,197
101,0,blank,0,191.2186,581.781833333333,113196,113395,199
101,0,blank,0,215.637633333333,582.343566666667,113395,113593,198
101,0,blank,0,231.327716666667,591.453916666667,113593,113789,196
101,31,<,226,225.2021,601.582366666667,113789,113984,195
101,0,blank,0,235.039233333333,606.142533333333,113984,114181,197
101,31,column1,227,253.066683333333,607.939683333333,114181,114377,196
101,0,blank,0,238.160366666667,608.839883333333,114377,114573,196
101,31,column1,227,254.898033333333,601.693833333333,114573,114772,199
101,31,column1,227,268.743733333333,595.343083333333,114772,114967,195
101,31,column1,227,275.2768,597.136483333333,114967,115160,193
101,29,i,215,267.797616666667,570.185033333333,115160,115355,195
101,0,blank,0,252.65844,581.72926,115355,115552,197
101,29,row1,213,232.39485,567.96725,115552,115741,189
101,0,blank,0,236.089,586.3469,115741,115906,165
101,0,blank,0,231.88875,571.522183333333,115906,116101,195
101,29,row1,213,214.914683333333,566.888416666667,116101,116293,192
101,0,blank,0,248.818266666667,574.172716666667,116293,116485,192
101,0,blank,0,245.6651,571.83045,116485,116681,196
101,0,blank,0,241.780283333333,576.570033333333,116681,116873,192
101,0,blank,0,233.336916666667,579.849716666667,116873,117067,194
101,29,row1,213,215.1144,569.5979,117067,117255,188
101,29,row1,213,211.230266666667,569.882983333333,117255,117447,192
101,0,blank,0,232.915133333333,582.16215,117447,117639,192
101,29,row1,213,216.229833333333,569.652466666667,117639,117833,194
101,29,row1,213,211.693283333333,565.325483333333,117833,118028,195
101,0,blank,0,214.2376,573.2353,118028,118220,192
101,0,blank,0,207.76975,576.470666666667,118220,118417,197
101,0,blank,0,197.558,569.5707,118417,118612,195
101,29,row1,213,206.971166666667,567.267816666667,118612,118807,195
101,0,blank,0,199.492833333333,561.494866666667,118807,119001,194
101,0,blank,0,194.5431,559.3141,119001,119199,198
101,29,row1,213,213.871033333333,565.374133333333,119199,119397,198
101,29,row1,213,226.63208,565.9652,119397,119564,167
101,29,row1,213,228.13266,568.53236,119564,119731,167
101,29,;,214,250.69584,561.2365,119731,119900,169
101,29,++,216,274.46325,559.641233333333,119900,120097,197
101,29,i,215,271.538516666667,558.996416666667,120097,120291,194
101,29,row1,213,242.181166666667,550.8535,120291,120487,196
101,0,blank,0,317.753533333333,556.548816666667,120487,120682,195
101,0,blank,0,311.759233333333,572.130983333333,120682,120877,195
101,31,column1,227,268.761966666667,611.707466666667,120877,121072,195
101,31,<,226,227.831616666667,600.242716666667,121072,121265,193
101,0,blank,0,242.878616666667,617.525,121265,121458,193
101,31,column1,227,267.104816666667,610.843516666667,121458,121654,196
101,31,column1,227,260.924183333333,609.420716666667,121654,121849,195
101,31,column1,227,261.456116666667,604.767983333333,121849,122044,195
101,31,column1,227,276.109716666667,608.74545,122044,122241,197
101,31,column1,227,296.389383333333,613.17925,122241,122437,196
101,31,++,230,343.4435,612.631683333333,122437,122633,196
101,31,++,230,364.878833333333,606.589866666667,122633,122829,196
101,0,blank,0,403.2197,611.577983333333,122829,123027,198
101,0,blank,0,402.576916666667,609.297966666667,123027,123223,196
101,33,a,237,264.432983333333,638.3865,123223,123417,194
101,33,"%3d",235,228.526516666667,653.128616666667,123417,123610,193
101,0,blank,0,274.524333333333,631.407966666667,123610,123802,192
101,0,blank,0,267.5934,633.8162,123802,123834,32
101,0,blank,0,355.054616666667,641.938133333333,123867,124062,195
101,33,),244,340.381083333333,641.279683333333,124062,124259,197
101,33,i,239,285.330883333333,641.359166666667,124259,124454,195
101,33,a,237,269.3692,644.754616666667,124454,124648,194
101,33,a,237,271.184833333333,651.2616,124648,124843,195
101,33,a,237,268.052166666667,646.707066666667,124843,125039,196
101,0,blank,0,261.706866666667,617.175633333333,125039,125234,195
101,0,blank,0,263.36855,579.693483333333,125234,125430,196
101,0,blank,0,274.040783333333,519.122666666667,125430,125625,195
101,0,blank,0,274.326,446.206983333333,125625,125819,194
101,25,[,193,266.21015,471.869566666667,125819,126018,199
101,25,comma,187,229.7708,471.901533333333,126018,126215,197
101,0,blank,0,232.233733333333,479.1562,126215,126313,98
101,0,blank,0,288.32795,636.689516666667,126346,126536,190
101,33,;,245,346.4402,652.4919,126536,126568,32
101,31,column1,227,254.2684,601.909533333333,126632,126778,146
101,0,blank,0,318.3208,616.1279,126907,127105,198
101,0,blank,0,113.058125,713.655425,127145,127339,194
101,0,blank,0,131.2487,728.7639,127339,127386,47
101,0,blank,0,219.63892,685.8419,127471,127657,186
101,0,blank,0,211.470533333333,679.26045,127657,127844,187
101,35,;,251,204.0716,691.12295,127844,127969,125
101,0,blank,0,-350,-105,128031,128092,61
101,0,blank,0,350.691966666667,728.5398,128249,128434,185
101,0,blank,0,363.55375,-103.99375,128462,128525,63
101,0,blank,0,-350,-105,128556,128584,28
101,35,),250,194.98336,687.38842,128722,128885,163
101,0,blank,0,174.476233333333,677.484433333333,128885,129032,147
101,0,blank,0,155.7896,718.632,129032,129222,190
101,0,blank,0,195.8521,677.865475,129222,129413,191
101,33,printf,233,157.4278,656.5554,129413,129457,44
101,0,blank,0,152.199,525.19305,129506,129601,95
101,28,"MATRIXAis\n",202,219.43895,543.595825,129696,129877,181
101,28,"MATRIXAis\n",202,179.2419,532.811816666667,129877,130073,196
101,28,"MATRIXAis\n",202,158.643433333333,533.214283333333,130073,130267,194
101,28,"MATRIXAis\n",202,156.8825,530.1315,130267,130464,197
101,28,"MATRIXAis\n",202,145.378666666667,537.917166666667,130464,130561,97
101,0,blank,0,870.986,354.8491,130659,130690,31
101,0,blank,0,1004.71083333333,316.569033333333,130722,130914,192
101,0,blank,0,1002.061,302.928466666667,130914,131106,192
101,0,blank,0,997.620166666667,290.502116666667,131106,131299,193
101,0,blank,0,1003.21416666667,289.013283333333,131299,131497,198
101,0,blank,0,1009.1442,291.05804,131497,131663,166
101,0,blank,0,998.183,308.42162,131663,131830,167
101,0,blank,0,1001.37266666667,332.902533333333,131830,131934,104
102,0,blank,0,220.56766,425.9342,132729,132897,168
102,37,"MATRIXBis\n",255,245.74396,454.79566,132897,133069,172
102,38,),270,296.5723,462.25566,133069,133236,167
102,38,++,269,293.712233333333,461.154766666667,133236,133337,101
102,0,blank,0,-350,-105,133370,133529,159
102,0,blank,0,-350,-105,133529,133579,50
102,40,<,279,232.529666666667,503.784966666667,133605,133691,86
102,0,blank,0,-350,-105,133723,133857,134
102,0,blank,0,306.0444,738.5119,133883,133909,26
102,40,<,279,232.852633333333,506.30525,133966,134144,178
102,0,blank,0,213.8032,497.87875,134144,134338,194
102,0,blank,0,213.92336,498.20246,134338,134506,168
102,0,blank,0,203.165933333333,487.287166666667,134506,134705,199
102,38,row2,266,232.820683333333,476.619233333333,134705,134901,196
102,38,;,267,246.510833333333,471.917366666667,134901,135099,198
102,0,blank,0,229.688916666667,478.043416666667,135099,135295,196
102,0,blank,0,260.57994,469.34396,135295,135462,167
102,38,i,268,273.608266666667,475.796116666667,135462,135659,197
102,38,++,269,285.07015,476.555283333333,135659,135857,198
102,0,blank,0,329.8005,476.83705,135857,135954,97
102,0,blank,0,328.2344,469.6268,135954,136073,119
102,0,blank,0,329.1072,472.1862,136073,136197,124
102,0,blank,0,335.00645,473.7372,136197,136391,194
102,0,blank,0,294.94848,488.65042,136391,136556,165
102,0,blank,0,225.830883333333,532.5363,136556,136754,198
102,0,blank,0,231.93725,524.77045,136754,136953,199
102,0,blank,0,217.452533333333,518.834583333333,136953,137151,198
102,0,blank,0,205.836616666667,523.1762,137151,137350,199
102,0,blank,0,212.024166666667,525.50585,137350,137547,197
102,40,<,279,231.016766666667,515.738583333333,137547,137740,193
102,0,blank,0,228.982383333333,522.516516666667,137740,137931,191
102,40,column2,280,271.134283333333,521.573616666667,137931,138126,195
102,0,blank,0,306.727366666667,528.940083333333,138126,138321,195
102,0,blank,0,330.16134,521.76138,138321,138507,186
102,40,column2,280,299.85175,501.979533333333,138507,138699,192
102,40,j,282,336.662316666667,506.29455,138699,138895,196
102,40,j,282,338.277466666667,502.41985,138895,139091,196
102,0,blank,0,324.675666666667,506.153116666667,139091,139286,195
102,0,blank,0,332.09005,504.50825,139286,139481,195
102,0,blank,0,384.1889,508.948133333333,139481,139674,193
102,0,blank,0,391.818916666667,508.59505,139674,139867,193
102,0,blank,0,393.762866666667,516.106666666667,139867,140065,198
102,0,blank,0,387.124033333333,515.8559,140065,140163,98
102,0,blank,0,224.690266666667,541.8232,140196,140392,196
102,42,b,290,270.9655,559.186766666667,140392,140589,197
102,42,i,292,284.473583333333,556.8218,140589,140783,194
102,42,[,294,306.709683333333,558.124266666667,140783,140978,195
102,42,),297,336.64815,565.866766666667,140978,141175,197
102,42,;,298,349.63162,564.92268,141175,141349,174
102,42,],296,328.5383,559.1092,141349,141543,194
102,0,blank,0,354.95345,564.70895,141543,141736,193
102,0,blank,0,361.119833333333,568.514383333333,141736,141924,188
102,0,blank,0,228.188716666667,599.808733333333,141924,142115,191
102,0,blank,0,232.231066666667,610.380833333333,142115,142308,193
102,0,blank,0,233.34885,607.829316666667,142308,142502,194
102,42,],296,331.8962,564.179433333333,142502,142698,196
102,0,blank,0,325.5146,514.406833333333,142698,142892,194
102,0,blank,0,316.71572,490.87804,142892,143057,165
102,0,blank,0,356.367616666667,344.7428,143089,143285,196
102,33,),244,335.786866666667,358.835116666667,143285,143482,197
102,0,blank,0,346.637383333333,185.27165,143516,143713,197
102,25,;,197,339.235783333333,180.582033333333,143713,143910,197
102,25,),196,327.9977,179.55045,143910,144106,196
102,0,blank,0,325.512183333333,145.79175,144106,144304,198
102,20,"EntertheelementsofmatrixB\n",153,336.211783333333,66.08275,144304,144500,196
102,0,blank,0,346.195733333333,1.59135,144500,144695,195
102,0,blank,0,326.758633333333,3.0256,144695,144892,197
102,0,blank,0,322.17332,27.27876,144892,145056,164
102,0,blank,0,-350,-105,145090,145275,185
102,0,blank,0,239.99645,651.648716666667,145384,145569,185
102,0,blank,0,201.66338,657.04034,145569,145736,167
102,46,row2,310,182.4386,643.91858,145736,145902,166
102,0,blank,0,160.451416666667,657.83005,145902,146100,198
102,46,row2,310,175.7275,646.649833333333,146100,146297,197
102,0,blank,0,205.650483333333,637.732916666667,146297,146495,198
102,0,blank,0,206.829483333333,652.36245,146495,146691,196
102,46,row2,310,196.5781,648.70012,146691,146856,165
102,46,row2,310,177.61776,650.1167,146856,147025,169
102,46,==,313,148.01996,647.9566,147025,147195,170
102,46,row2,310,180.76286,644.89138,147195,147364,169
102,46,row2,310,203.19736,646.1448,147364,147533,169
102,46,row2,310,186.8226,647.58574,147533,147703,170
102,0,blank,0,180.33034,655.18706,147703,147873,170
102,0,blank,0,243.70484,655.62148,147873,148045,172
102,46,&&,311,231.57894,648.17528,148045,148213,168
102,46,&&,311,221.34466,644.25056,148213,148384,171
102,46,&&,311,212.60226,638.72456,148384,148551,167
102,46,column1,312,255.98034,651.85334,148551,148718,167
102,46,column1,312,266.91572,641.54958,148718,148884,166
102,46,column1,312,246.324,649.056216666667,148884,149083,199
102,0,blank,0,253.73654,656.21222,149083,149249,166
102,46,column1,312,254.750166666667,650.84375,149249,149447,198
102,46,column1,312,249.97855,648.693383333333,149447,149642,195
102,46,column1,312,255.539283333333,651.902133333333,149642,149838,196
102,46,column1,312,250.1217,641.193816666667,149838,150036,198
102,46,column1,312,254.566216666667,642.08655,150036,150235,199
102,46,column1,312,257.46664,648.73586,150235,150403,168
102,46,column1,312,258.1787,652.19804,150403,150571,168
102,46,column1,312,251.70888,649.57842,150571,150742,171
102,46,column1,312,249.5481,646.83154,150742,150914,172
102,46,column1,312,249.2485,643.67026,150914,151085,171
102,0,blank,0,241.63068,642.97054,151085,151253,168
102,46,column1,312,252.56846,652.81084,151253,151421,168
102,46,column1,312,247.84926,650.66078,151421,151589,168
102,0,blank,0,237.1226,642.92744,151589,151758,169
102,0,blank,0,237.1162,647.47678,151758,151929,171
102,46,column1,312,248.77544,650.56818,151929,152099,170
102,0,blank,0,238.22318,644.14316,152099,152270,171
102,46,column1,312,243.42914,641.14636,152270,152440,170
102,0,blank,0,238.92318,642.24254,152440,152607,167
102,46,column1,312,244.56192,644.16044,152607,152775,168
102,46,column1,312,251.69205,642.04225,152775,152974,199
102,46,&&,311,215.59546,641.41644,152974,153144,170
102,46,row2,310,188.82534,642.4261,153144,153316,172
102,46,row2,310,182.91998,646.314,153316,153489,173
102,46,row2,310,183.00782,652.66018,153489,153658,169
102,0,blank,0,182.8109,662.07512,153658,153827,169
102,0,blank,0,182.26484,661.02604,153827,153994,167
102,0,blank,0,182.804833333333,659.736483333333,153994,154192,198
102,0,blank,0,178.811666666667,657.25185,154192,154391,199
102,46,row2,310,182.52672,652.9952,154391,154559,168
102,0,blank,0,188.013883333333,657.16295,154559,154758,199
102,0,blank,0,208.36858,646.97944,154758,154927,169
102,46,&&,311,212.139666666667,652.778533333333,154927,155125,198
102,46,row2,310,200.633,649.94762,155125,155292,167
102,0,blank,0,219.084366666667,654.069766666667,155292,155491,199
102,0,blank,0,208.425316666667,649.349683333333,155491,155689,198
102,0,blank,0,192.35702,657.62186,155689,155855,166
102,0,blank,0,213.39298,666.23818,155855,156023,168
102,0,blank,0,235.8184,661.621083333333,156023,156218,195
102,0,blank,0,242.432366666667,660.339366666667,156218,156343,125
102,46,&&,311,233.5934,644.4533,156343,156462,119
102,0,blank,0,236.0869,631.5674,156462,156588,126
102,46,column1,312,254.627675,639.5661,156588,156773,185
102,46,column1,312,300.641266666667,649.588166666667,156773,156963,190
102,46,==,313,331.1076,644.24105,156963,157154,191
102,0,blank,0,350.483033333333,643.634183333333,157154,157346,192
102,46,==,313,337.342233333333,653.970583333333,157346,157537,191
102,0,blank,0,360.152416666667,659.1727,157537,157727,190
102,46,column2,314,404.111866666667,640.290333333333,157727,157920,193
102,46,column2,314,408.885433333333,646.05715,157920,158106,186
102,0,blank,0,443.618316666667,637.497283333333,158106,158294,188
102,46,column2,314,362.121466666667,639.074083333333,158294,158483,189
102,0,blank,0,331.927816666667,631.276683333333,158483,158673,190
102,46,column1,312,252.430283333333,646.471833333333,158673,158863,190
102,46,column1,312,251.08145,648.031133333333,158863,159057,194
102,46,column1,312,247.6533,638.9438,159057,159089,32
102,0,blank,0,193.180283333333,656.133133333333,159185,159375,190
102,48,"Matricescanbecompared\n",319,179.196983333333,684.552483333333,159375,159566,191
102,48,"Matricescanbecompared\n",319,186.93994,685.74586,159566,159730,164
102,48,"Matricescanbecompared\n",319,313.8951,688.42854,159764,159930,166
102,48,"Matricescanbecompared\n",319,317.61124,682.33576,159930,160102,172
102,48,"Matricescanbecompared\n",319,323.15484,684.03212,160102,160274,172
102,48,"Matricescanbecompared\n",319,363.30098,685.44958,160274,160444,170
102,48,"Matricescanbecompared\n",319,375.6592,687.54365,160444,160511,67
102,48,"Matricescanbecompared\n",319,239.95258,682.1057,160546,160719,173
102,48,"Matricescanbecompared\n",319,248.77342,695.82446,160719,160897,178
102,0,blank,0,320.1121,704.03846,160897,161073,176
102,0,blank,0,283.49638,702.925,161073,161268,195
102,0,blank,0,-350,-105,161598,161768,170
102,0,blank,0,-350,-105,161768,161875,107
102,0,blank,0,-350,-105,161875,162061,186
102,0,blank,0,-350,-105,162061,162249,188
102,0,blank,0,-350,-105,162249,162443,194
102,0,blank,0,-350,-105,162443,162588,145
102,0,blank,0,-350,-105,162588,162754,166
102,0,blank,0,-350,-105,162754,162935,181
102,0,blank,0,-350,-105,162935,163134,199
102,0,blank,0,-350,-105,163134,163313,179
102,0,blank,0,-350,-105,163313,163507,194
102,0,blank,0,-350,-105,163507,163625,118
102,0,blank,0,-350,-105,163625,163756,131
102,0,blank,0,-350,-105,163756,163913,157
102,0,blank,0,-350,-105,163913,164036,123
102,0,blank,0,-350,-105,164036,164164,128
102,0,blank,0,-350,-105,164164,164354,190
102,0,blank,0,-350,-105,164354,164541,187
102,0,blank,0,-350,-105,164541,164695,154
102,0,blank,0,-350,-105,164695,164868,173
102,0,blank,0,-350,-105,164868,165044,176
102,0,blank,0,-350,-105,165044,165238,194
102,0,blank,0,-350,-105,165238,165429,191
102,0,blank,0,-350,-105,165429,165577,148
102,0,blank,0,-350,-105,165577,165682,105
102,0,blank,0,-350,-105,165682,165871,189
102,0,blank,0,-350,-105,165871,166049,178
102,0,blank,0,-350,-105,166049,166244,195
102,0,blank,0,-350,-105,166244,166421,177
102,0,blank,0,-350,-105,166421,166585,164
102,0,blank,0,-350,-105,166585,166707,122
102,0,blank,0,-350,-105,166707,166904,197
102,0,blank,0,-350,-105,166904,167085,181
102,0,blank,0,-350,-105,167085,167270,185
102,0,blank,0,-350,-105,167270,167456,186
102,0,blank,0,-350,-105,167456,167593,137
102,0,blank,0,-350,-105,167593,167760,167
102,0,blank,0,-350,-105,167760,167920,160
102,0,blank,0,-350,-105,167920,168103,183
102,0,blank,0,-350,-105,168103,168284,181
102,0,blank,0,-350,-105,168284,168481,197
102,0,blank,0,-350,-105,168481,168625,144
102,0,blank,0,-350,-105,168625,169082,457
102,0,blank,0,-350,-105,169082,169525,443
102,0,blank,0,-350,-105,169525,169672,147
102,0,blank,0,-350,-105,169672,169863,191
102,0,blank,0,-350,-105,169863,170043,180
102,0,blank,0,-350,-105,170043,170221,178
102,0,blank,0,-350,-105,170221,170314,93
102,0,blank,0,-350,-105,170314,170513,199
102,0,blank,0,-350,-105,170513,170682,169
102,0,blank,0,-350,-105,170682,170845,163
102,0,blank,0,-350,-105,170845,171013,168
102,0,blank,0,-350,-105,171013,171176,163
102,46,column1,312,267.433566666667,641.198533333333,173723,173815,92
102,46,column2,314,418.67462,643.86234,173850,174019,169
102,46,column2,314,401.152266666667,653.4349,174019,174218,199
102,0,blank,0,364.9615,671.7448,174218,174355,137
103,49,row1,330,273.158,470.196766666667,175853,176052,199
103,49,row1,330,283.14686,471.84892,176052,176221,169
103,49,++,333,316.01794,475.97382,176221,176391,170
103,49,++,333,320.58926,482.61982,176391,176559,168
103,0,blank,0,345.131525,473.19285,176559,176727,168
103,48,"Matricescanbecompared\n",319,349.5081,467.8042,176727,176848,121
103,48,"Matricescanbecompared\n",319,416.1895,463.6814,176848,176974,126
103,48,"Matricescanbecompared\n",319,403.313475,468.302625,176974,177163,189
103,0,blank,0,346.8439,471.0521,177163,177333,170
103,49,row1,330,251.70346,480.5143,177333,177503,170
103,0,blank,0,202.79902,473.04614,177503,177673,170
103,49,0,326,182.55106,476.98382,177673,177841,168
103,49,0,326,181.5577,482.54512,177841,178011,170
103,48,"Matricescanbecompared\n",319,280.70726,460.6502,178011,178182,171
103,48,"Matricescanbecompared\n",319,364.73302,460.71934,178182,178355,173
103,48,"Matricescanbecompared\n",319,401.44274,454.98286,178355,178524,169
103,0,blank,0,400.5049,446.72816,178524,178692,168
103,48,"Matricescanbecompared\n",319,380.72842,451.49926,178692,178861,169
103,0,blank,0,339.25302,446.33422,178861,179029,168
103,48,"Matricescanbecompared\n",319,342.509,451.1984,179029,179063,34
103,48,"Matricescanbecompared\n",319,230.34388,448.11078,179097,179263,166
103,48,"Matricescanbecompared\n",319,227.29392,454.47472,179263,179434,171
103,46,row2,310,180.983,416.516575,179434,179571,137
103,0,blank,0,-350,-105,179605,179795,190
103,0,blank,0,-350,-105,179795,179964,169
103,0,blank,0,-350,-105,179964,180152,188
103,0,blank,0,-350,-105,180152,180313,161
103,0,blank,0,-350,-105,180313,180453,140
103,0,blank,0,-350,-105,180453,180596,143
103,0,blank,0,-350,-105,180596,180784,188
103,0,blank,0,-350,-105,180784,180976,192
103,0,blank,0,-350,-105,180976,181150,174
103,0,blank,0,-350,-105,181150,181295,145
103,0,blank,0,-350,-105,181295,181474,179
103,0,blank,0,-350,-105,181474,181671,197
103,0,blank,0,-350,-105,181671,181867,196
103,0,blank,0,-350,-105,181867,182045,178
103,0,blank,0,-350,-105,182045,182227,182
103,48,"Matricescanbecompared\n",319,242.65765,457.081775,182471,182664,193
103,0,blank,0,-350,-105,182762,182841,79
103,0,blank,0,-350,-105,182841,182980,139
103,0,blank,0,-350,-105,182980,183142,162
103,0,blank,0,-350,-105,183142,183337,195
103,0,blank,0,-350,-105,183337,183529,192
103,0,blank,0,-350,-105,183529,183629,100
103,0,blank,0,-350,-105,183629,183764,135
103,0,blank,0,-350,-105,183764,183949,185
103,0,blank,0,-350,-105,183949,184141,192
103,0,blank,0,-350,-105,184141,184317,176
103,0,blank,0,-350,-105,184317,184495,178
103,0,blank,0,-350,-105,184495,184637,142
103,0,blank,0,-350,-105,184637,184720,83
103,0,blank,0,-350,-105,184720,184837,117
103,0,blank,0,-350,-105,184837,184972,135
103,0,blank,0,-350,-105,184972,185162,190
103,0,blank,0,-350,-105,185162,185357,195
103,0,blank,0,-350,-105,185357,185510,153
103,0,blank,0,-350,-105,185510,185700,190
103,0,blank,0,-350,-105,185700,185803,103
103,0,blank,0,-350,-105,185803,185960,157
103,0,blank,0,-350,-105,185960,186137,177
103,0,blank,0,-350,-105,186137,186321,184
103,0,blank,0,-350,-105,186321,186491,170
103,0,blank,0,-350,-105,186491,186647,156
103,0,blank,0,-350,-105,186647,186836,189
103,0,blank,0,-350,-105,186836,186946,110
103,0,blank,0,-350,-105,186946,187137,191
103,0,blank,0,-350,-105,187137,187275,138
103,0,blank,0,-350,-105,187275,187454,179
103,0,blank,0,-350,-105,187454,187557,103
103,0,blank,0,-350,-105,187557,187663,106
103,0,blank,0,-350,-105,187663,187781,118
103,0,blank,0,-350,-105,187781,187922,141
103,0,blank,0,-350,-105,187922,188013,91
103,0,blank,0,-350,-105,188013,188186,173
103,0,blank,0,-350,-105,188186,188275,89
103,0,blank,0,-350,-105,188275,188412,137
103,0,blank,0,-350,-105,188412,188587,175
103,0,blank,0,176.9355,513.93955,188621,188818,197
103,0,blank,0,195.9775,548.7431,188818,188922,104
103,0,blank,0,216.8965,486.4316,188922,189027,105
103,0,blank,0,249.2431,497.875,189027,189272,245
103,49,row1,330,278.54786,479.23018,189382,189552,170
103,49,row1,330,270.5916,470.2778,189552,189618,66
103,48,"Matricescanbecompared\n",319,298.9551,455.4197,189618,189809,191
103,48,"Matricescanbecompared\n",319,310.65404,464.02766,189809,189989,180
103,49,row1,330,267.12636,488.85242,189989,190157,168
103,49,row1,330,265.26902,475.66696,190157,190329,172
103,48,"Matricescanbecompared\n",319,300.49718,468.15504,190329,190500,171
103,0,blank,0,303.35588,474.15028,190500,190671,171
103,0,blank,0,297.15555,471.3553,190671,190808,137
103,0,blank,0,235.90532,431.82152,190842,191015,173
103,49,row1,330,275.86006,482.15696,191015,191187,172
103,48,"Matricescanbecompared\n",319,295.37318,468.72496,191187,191356,169
103,49,i,332,307.21606,480.22636,191356,191525,169
103,49,i,332,308.37722,480.44054,191525,191697,172
103,49,),334,341.35702,471.7774,191697,191867,170
103,0,blank,0,346.87572,479.33656,191867,192037,170
103,0,blank,0,345.24184,477.80392,192037,192206,169
103,0,blank,0,368.85738,499.38616,192206,192375,169
103,0,blank,0,369.9119,475.10688,192375,192545,170
103,0,blank,0,356.09324,470.90162,192545,192717,172
103,0,blank,0,350.91152,432.66568,192717,192888,171
103,48,"Matricescanbecompared\n",319,242.70208,455.64462,192921,193098,177
103,0,blank,0,240.82026,518.38076,193132,193304,172
103,0,blank,0,255.38806,521.39574,193304,193475,171
103,51,column2,344,285.16332,517.44948,193475,193647,172
103,51,column2,344,331.35058,519.6329,193647,193823,176
103,0,blank,0,366.31014,501.81446,193823,193997,174
103,0,blank,0,376.0513,501.62214,193997,194170,173
103,0,blank,0,379.85374,508.5983,194170,194340,170
103,0,blank,0,402.31312,489.29502,194340,194514,174
103,0,blank,0,427.74384,500.75066,194514,194688,174
103,51,),348,410.76226,515.99224,194688,194863,175
103,0,blank,0,342.36308,552.33846,194863,195034,171
103,0,blank,0,292.85272,553.54874,195034,195208,174
103,0,blank,0,297.55984,555.01012,195208,195379,171
103,0,blank,0,312.69748,568.9803,195379,195548,169
103,53,!=,359,296.6135,567.71182,195548,195718,170
103,53,],366,237.52854,574.70246,195718,195887,169
103,53,[,364,217.74588,567.61194,195887,196055,168
103,0,blank,0,263.56924,587.44668,196055,196224,169
103,53,],366,271.12456,577.3251,196224,196393,169
103,53,],366,268.30378,578.04802,196393,196561,168
103,53,!=,359,295.90194,561.83932,196561,196730,169
103,0,blank,0,317.75272,556.8088,196730,196897,167
103,0,blank,0,380.29612,556.93358,196897,197085,188
103,53,],366,374.53455,564.04735,197085,197282,197
103,53,[,364,359.27305,566.0506,197282,197474,192
103,53,b,360,318.0141,561.61554,197474,197672,198
103,53,],366,350.8807,572.372966666667,197672,197871,199
103,0,blank,0,392.6856,552.52098,197871,198037,166
103,0,blank,0,310.93314,591.38018,198037,198205,168
103,55,;,372,288.442566666667,611.702833333333,198205,198403,198
103,0,blank,0,295.599533333333,621.2197,198403,198600,197
103,0,blank,0,314.8019,608.07325,198600,198799,199
103,0,blank,0,287.830075,630.986525,198799,198973,174
103,0,blank,0,285.720883333333,638.393866666667,198973,199172,199
103,55,;,372,291.43168,617.0615,199172,199340,168
103,0,blank,0,294.28608,619.77206,199340,199507,167
103,55,0,371,280.283,604.72988,199507,199674,167
103,55,0,371,279.857533333333,619.5819,199674,199873,199
103,55,;,372,284.673666666667,617.856116666667,199873,200071,198
103,55,;,372,286.247716666667,615.9248,200071,200270,199
103,55,=,370,260.4793,604.14482,200270,200437,167
103,0,blank,0,272.15892,581.42296,200437,200604,167
103,0,blank,0,285.7509,573.25442,200604,200773,169
103,0,blank,0,325.89346,557.10012,200773,200942,169
103,53,],366,380.87118,570.61856,201011,201180,169
103,0,blank,0,394.54942,560.16372,201180,201348,168
103,0,blank,0,392.1889,560.47892,201348,201514,166
103,53,],366,350.83444,577.87984,201514,201681,167
103,53,],366,350.5099,570.2268,201681,201715,34
103,0,blank,0,279.3198,642.121983333333,201749,201948,199
103,0,blank,0,262.52166,625.28494,201948,202114,166
103,0,blank,0,270.55498,623.19302,202114,202282,168
103,0,blank,0,280.29752,625.6664,202282,202449,167
103,0,blank,0,293.173266666667,626.825316666667,202449,202644,195
103,0,blank,0,291.6731,628.3353,202644,202743,99
103,49,row1,330,251.1452,478.47792,202777,202943,166
103,49,row1,330,246.16742,478.79494,202943,203107,164
103,0,blank,0,290.91625,634.437116666667,203140,203338,198
103,0,blank,0,290.282766666667,640.4039,203338,203537,199
103,55,;,372,289.78774,621.83572,203537,203706,169
103,0,blank,0,278.8407,600.6122,203706,203775,69
103,0,blank,0,909.1806,435.00456,203882,204052,170
103,0,blank,0,951.2452,415.39622,204052,204222,170
103,0,blank,0,970.117,417.8245,204222,204257,35
103,0,blank,0,966.8004,291.74022,204292,204466,174
103,0,blank,0,973.6288,318.34038,204466,204642,176
103,0,blank,0,982.584,351.842,204642,204819,177
103,0,blank,0,985.44275,351.549,204819,204960,141
103,51,column2,344,318.6484,524.5983,205100,205135,35
103,55,0,371,283.94518,614.49844,205171,205343,172
103,0,blank,0,263.0885,643.1492,205343,205380,37
104,0,blank,0,130.76594,563.30148,206245,206420,175
104,0,blank,0,142.26956,566.46062,206420,206591,171
104,63,"Cannotbecompared\n",383,308.86548,589.89368,206625,206796,171
104,63,"Cannotbecompared\n",383,276.14844,601.69424,206796,206963,167
104,63,"Cannotbecompared\n",383,244.33928,596.38682,206963,207131,168
104,63,"Cannotbecompared\n",383,215.233033333333,585.317766666667,207131,207327,196
104,0,blank,0,160.249716666667,553.677866666667,207327,207523,196
104,0,blank,0,157.83405,532.452875,207523,207652,129
104,48,"Matricescanbecompared\n",319,155.685833333333,254.753366666667,207715,207908,193
104,48,"Matricescanbecompared\n",319,166.96708,270.36156,207908,208080,172
104,0,blank,0,196.80334,232.72712,208080,208246,166
104,46,&&,311,234.3413,223.79256,208246,208415,169
104,46,column1,312,275.47868,217.13304,208415,208582,167
104,46,column1,312,278.93374,217.0837,208582,208752,170
104,46,column1,312,281.08125,220.8496,208752,208820,68
104,46,),315,425.08886,219.97228,208854,209023,169
104,0,blank,0,425.9971,231.1946,209023,209058,35
104,0,blank,0,261.80766,576.79734,209158,209326,168
104,63,"Cannotbecompared\n",383,264.662,592.527166666667,209326,209427,101
104,0,blank,0,355.03956,553.05504,209461,209630,169
104,0,blank,0,362.32666,558.67164,209630,209800,170
104,0,blank,0,-350,-105,209834,209974,140
104,0,blank,0,181.858083333333,606.241533333333,210108,210297,189
104,0,blank,0,180.84616,608.78562,210297,210468,171
104,0,blank,0,177.14786,611.8031,210468,210638,170
104,0,blank,0,183.38008,613.31522,210638,210807,169
104,0,blank,0,177.06598,609.07544,210807,210976,169
104,0,blank,0,180.820616666667,616.099016666667,210976,211174,198
104,0,blank,0,190.53062,611.6049,211174,211342,168
104,0,blank,0,189.43496,605.10032,211342,211518,176
104,0,blank,0,185.07814,566.65766,211518,211688,170
104,63,"Cannotbecompared\n",383,281.48636,596.9199,211688,211863,175
104,0,blank,0,314.22536,604.61214,211863,212036,173
104,0,blank,0,278.0781,579.59184,212036,212207,171
104,63,"Cannotbecompared\n",383,226.18874,589.05188,212207,212379,172
104,63,"Cannotbecompared\n",383,203.43088,588.3614,212379,212550,171
104,0,blank,0,201.3699,610.16878,212550,212721,171
104,0,blank,0,207.5638,611.8843,212721,212755,34
104,0,blank,0,351.73896,573.91424,212788,212959,171
104,0,blank,0,336.0591,553.7444,212959,212994,35
104,48,"Matricescanbecompared\n",319,325.58276,264.19398,213028,213196,168
104,46,==,313,342.65665,226.39925,213196,213395,199
104,48,"Matricescanbecompared\n",319,381.47128,256.06604,213395,213562,167
104,48,"Matricescanbecompared\n",319,388.4013,266.6746,213562,213595,33
104,0,blank,0,-350,-105,213729,213928,199
104,0,blank,0,-350,-105,213928,214107,179
104,0,blank,0,-350,-105,214107,214291,184
104,0,blank,0,-350,-105,214291,214454,163
104,0,blank,0,-350,-105,214454,214642,188
104,0,blank,0,-350,-105,214642,214824,182
104,0,blank,0,-350,-105,214824,215011,187
104,0,blank,0,-350,-105,215011,215176,165
104,0,blank,0,-350,-105,215176,215361,185
104,0,blank,0,-350,-105,215361,215538,177
104,0,blank,0,-350,-105,215538,215736,198
104,0,blank,0,-350,-105,215736,215912,176
104,0,blank,0,-350,-105,215912,216083,171
104,0,blank,0,-350,-105,216083,216213,130
104,0,blank,0,-350,-105,216213,216388,175
104,0,blank,0,-350,-105,216388,216756,368
104,0,blank,0,-350,-105,216756,216869,113
104,66,),397,174.77405,656.112816666667,216903,217091,188
104,66,==,395,139.89082,661.7112,217091,217260,169
104,66,==,395,148.47892,653.52694,217260,217431,171
104,0,blank,0,195.8657,657.25535,217431,217600,169
104,0,blank,0,190.1165,662.462,217600,217699,99
104,0,blank,0,212.6915,658.30225,217699,217865,166
104,0,blank,0,210.84276,662.24424,217865,218040,175
104,0,blank,0,188.73722,663.0966,218040,218213,173
104,0,blank,0,188.14236,666.27438,218213,218383,170
104,0,blank,0,186.33594,664.32132,218383,218553,170
104,0,blank,0,210.03996,665.64536,218553,218723,170
104,0,blank,0,208.83918,662.3338,218723,218894,171
104,0,blank,0,197.48716,652.73226,218894,219065,171
104,67,"Twomatricesareequal\n",400,246.17754,681.07062,219065,219239,174
104,67,"Twomatricesareequal\n",400,277.0005,689.01098,219239,219407,168
104,67,"Twomatricesareequal\n",400,336.85908,680.63674,219407,219577,170
104,67,"Twomatricesareequal\n",400,378.49954,674.56766,219577,219745,168
104,67,"Twomatricesareequal\n",400,348.27286,680.37242,219745,219914,169
104,67,"Twomatricesareequal\n",400,336.2885,686.34,219914,219948,34
104,0,blank,0,195.5746,657.307266666667,219982,220081,99
104,67,"Twomatricesareequal\n",400,315.194,678.07726,220115,220286,171
104,67,"Twomatricesareequal\n",400,348.11812,677.29472,220286,220454,168
104,67,"Twomatricesareequal\n",400,375.54492,675.7073,220454,220623,169
104,0,blank,0,187.61298,668.7436,220656,220824,168
104,0,blank,0,205.95714,662.01646,220824,220992,168
104,0,blank,0,220.56006,657.65864,220992,221159,167
104,0,blank,0,230.064583333333,661.850033333333,221159,221358,199
104,0,blank,0,194.982,660.17592,221358,221528,170
104,67,"Twomatricesareequal\n",400,186.38728,669.11504,221528,221700,172
104,0,blank,0,183.36546,659.87476,221700,221871,171
104,0,blank,0,192.54886,665.73842,221871,222038,167
104,0,blank,0,200.34174,666.19472,222038,222207,169
104,0,blank,0,215.23322,656.39552,222207,222374,167
104,0,blank,0,216.90822,658.1058,222374,222543,169
104,0,blank,0,198.5903,666.71918,222543,222712,169
104,0,blank,0,184.08988,663.1577,222712,222881,169
104,0,blank,0,187.2091,659.0364,222881,223050,169
104,67,"Twomatricesareequal\n",400,223.0656,671.97024,223050,223219,169
104,0,blank,0,236.63526,663.37762,223219,223386,167
104,67,"Twomatricesareequal\n",400,303.40968,683.04978,223386,223556,170
104,67,"Twomatricesareequal\n",400,289.57446,672.87688,223556,223725,169
104,67,"Twomatricesareequal\n",400,377.79608,677.9887,223725,223896,171
104,67,"Twomatricesareequal\n",400,401.2812,669.022,223896,223962,66
104,0,blank,0,940.138,463.55954,224029,224195,166
104,0,blank,0,987.590333333333,467.839183333333,224195,224393,198
104,0,blank,0,996.490333333333,466.6755,224393,224491,98
104,0,blank,0,987.1226,657.94128,224523,224690,167
104,0,blank,0,992.4918,647.99676,224690,224859,169
104,0,blank,0,322.794266666667,662.890416666667,224927,225126,199
104,67,"Twomatricesareequal\n",400,319.4698,678.9233,225126,225194,68
104,0,blank,0,190.1973,690.10605,225228,225295,67
105,0,blank,0,215.48662,662.65272,225558,225726,168
105,69,"But,twomatricesarenotequal\n",406,249.408583333333,681.453766666667,225726,225925,199
105,69,"But,twomatricesarenotequal\n",406,285.56388,682.97582,225925,226092,167
105,0,blank,0,259.8239,687.267,226092,226260,168
105,69,"But,twomatricesarenotequal\n",406,245.197116666667,681.4704,226260,226459,199
105,69,"But,twomatricesarenotequal\n",406,343.5703,685.05576,226459,226628,169
105,69,"But,twomatricesarenotequal\n",406,370.096966666667,677.68685,226628,226827,199
105,69,"But,twomatricesarenotequal\n",406,437.224783333333,673.7003,226827,227022,195
105,69,"But,twomatricesarenotequal\n",406,425.19074,671.42008,227022,227188,166
105,69,"But,twomatricesarenotequal\n",406,421.843266666667,675.610266666667,227188,227291,103
105,67,"Twomatricesareequal\n",400,255.56338,635.45256,227326,227499,173
105,67,"Twomatricesareequal\n",400,198.63478,622.10022,227499,227678,179
105,0,blank,0,192.71752,642.17226,227678,227851,173
105,69,"But,twomatricesarenotequal\n",406,154.64856,665.9553,227851,228026,175
105,0,blank,0,170.44966,658.03782,228026,228197,171
105,67,"Twomatricesareequal\n",400,206.18146,623.90764,228197,228369,172
105,0,blank,0,218.03516,615.12408,228369,228539,170
105,0,blank,0,219.26988,618.74768,228539,228707,168
105,0,blank,0,196.85726,557.5249,228707,228875,168
105,63,"Cannotbecompared\n",383,193.6071,550.10595,228875,228942,67
105,0,blank,0,302.76216,388.13124,228976,229143,167
105,0,blank,0,313.71185,345.9756,229143,229342,199
105,0,blank,0,337.504883333333,308.6146,229342,229540,198
105,0,blank,0,312.255516666667,311.4414,229540,229735,195
105,0,blank,0,304.1034,319.24825,229735,229802,67
105,67,"Twomatricesareequal\n",400,212.7589,634.587783333333,229867,230066,199
105,0,blank,0,193.572766666667,620.250233333333,230066,230265,199
105,0,blank,0,224.676483333333,610.503,230265,230460,195
105,0,blank,0,208.47225,562.446066666667,230460,230656,196
105,0,blank,0,206.20285,646.426233333333,230656,230853,197
105,0,blank,0,207.002833333333,644.671483333333,230853,231049,196
105,0,blank,0,208.6793,643.637016666667,231049,231247,198
105,67,"Twomatricesareequal\n",400,210.25344,623.18378,231247,231410,163
105,67,;,402,440.61935,634.9784,231442,231638,196
105,67,"Twomatricesareequal\n",400,413.76985,641.775166666667,231638,231836,198
105,67,"Twomatricesareequal\n",400,389.542,626.201733333333,231836,231934,98
105,0,blank,0,271.9696,303.569816666667,231967,232165,198
105,0,blank,0,324.139516666667,306.83955,232165,232363,198
105,0,blank,0,375.248225,305.4731,232363,232499,136
105,46,column1,312,287.92712,164.02034,232532,232702,170
105,46,column1,312,281.62714,168.20272,232702,232870,168
105,0,blank,0,251.3829,156.75056,232870,233039,169
105,0,blank,0,254.306133333333,141.456866666667,233039,233238,199
105,0,blank,0,265.462083333333,70.008,233238,233436,198
105,0,blank,0,311.72005,59.4704833333333,233436,233635,199
105,0,blank,0,356.1848,54.39518,233635,233802,167
105,40,;,281,317.33134,37.70234,233802,233969,167
105,0,blank,0,293.68916,25.28342,233969,234138,169
105,0,blank,0,251.50834,22.80868,234138,234309,171
105,0,blank,0,256.101766666667,26.2459333333333,234309,234413,104
105,0,blank,0,887.4244,428.08428,234483,234651,168
105,0,blank,0,973.9034,463.08824,234651,234822,171
105,0,blank,0,1003.6104,495.50824,234822,234995,173
105,0,blank,0,1009.70875,514.201375,234995,235134,139
105,49,++,333,325.17036,228.98518,235204,235371,167
105,0,blank,0,311.59512,261.51306,235371,235545,174
105,0,blank,0,293.18044,363.07356,235545,235719,174
105,0,blank,0,293.65558,353.10844,235719,235892,173
105,53,!=,359,297.1756,315.52312,235892,236060,168
105,0,blank,0,347.06148,312.03662,236060,236230,170
105,0,blank,0,394.91012,324.67578,236230,236397,167
105,0,blank,0,378.54565,293.8538,236397,236595,198
105,51,;,345,358.2391,270.28918,236595,236764,169
105,0,blank,0,293.87378,253.03016,236764,236932,168
105,0,blank,0,295.0285,236.07242,236932,237102,170
105,49,i,332,311.61034,230.2062,237102,237273,171
105,48,"Matricescanbecompared\n",319,322.94916,222.6195,237273,237444,171
105,49,++,333,315.03232,226.54398,237444,237616,172
105,0,blank,0,296.0252,237.0324,237616,237685,69
106,0,blank,0,353.1702,258.586533333333,237754,237884,130
106,0,blank,0,364.0244,268.6001,237884,238010,126
106,48,"Matricescanbecompared\n",319,254.699125,214.270575,238136,238324,188
106,0,blank,0,267.84852,202.12308,238324,238498,174
106,46,column2,314,338.5956,170.55464,238498,238670,172
106,0,blank,0,306.33384,158.69032,238670,238843,173
106,0,blank,0,283.36638,148.04748,238843,239012,169
106,47,{,316,428.95036,164.0734,239046,239216,170
106,47,{,316,430.73115,165.6867,239216,239284,68
106,0,blank,0,347.32708,55.78228,239318,239490,172
106,0,blank,0,339.6248,55.78604,239490,239658,168
106,0,blank,0,331.09328,44.31054,239658,239827,169
106,0,blank,0,272.83332,51.36164,239827,239994,167
106,42,b,290,265.328416666667,74.0978666666667,239994,240193,199
106,0,blank,0,269.63528,67.21126,240193,240361,168
106,0,blank,0,328.21888,28.6193,240361,240531,170
106,40,++,283,349.90638,28.07394,240531,240706,175
106,0,blank,0,387.06988,19.22112,240706,240875,169
106,0,blank,0,385.5912,17.8747833333333,240875,241073,198
106,0,blank,0,394.1431,16.48,241073,241106,33
106,42,],296,297.59866,82.35478,241140,241311,171
106,0,blank,0,231.6654,112.31092,241311,241481,170
106,0,blank,0,231.41622,119.78514,241481,241652,171
106,0,blank,0,225.19966,49.5575,241652,241824,172
106,0,blank,0,218.98844,56.51296,241824,242002,178
106,0,blank,0,228.2745,109.35606,242002,242173,171
106,0,blank,0,227.16562,109.28184,242173,242343,170
106,42,"%3d",288,231.3879,91.50516,242343,242515,172
106,40,column2,280,253.68984,42.80512,242515,242689,174
106,40,column2,280,275.29514,36.498,242689,242860,171
106,40,column2,280,306.03978,29.47536,242860,243031,171
106,40,j,282,342.87918,28.03044,243031,243203,172
106,40,++,283,343.66428,27.30594,243203,243375,172
106,0,blank,0,381.199,22.03202,243375,243548,173
106,0,blank,0,390.56048,21.3503,243548,243720,172
106,0,blank,0,341.20108,60.76994,243720,243892,172
106,0,blank,0,333.15484,60.23972,243892,244065,173
106,0,blank,0,342.40534,70.46364,244065,244239,174
106,0,blank,0,361.1197,75.46386,244239,244412,173
106,0,blank,0,331.5182,38.1801,244412,244588,176
106,40,column2,280,290.99746,35.86982,244588,244762,174
106,0,blank,0,215.94546,60.02996,244762,244934,172
106,0,blank,0,242.21364,105.06884,244934,245104,170
106,0,blank,0,258.0042,292.3286,245139,245173,34
106,0,blank,0,252.21405,654.83345,245243,245437,194
106,63,"Cannotbecompared\n",383,252.48075,540.206016666667,245470,245667,197
106,0,blank,0,257.344433333333,290.388366666667,245700,245896,196
106,51,column2,344,287.1005,289.29986,245896,246065,169
106,0,blank,0,363.930766666667,292.416216666667,246065,246260,195
106,53,j,365,357.385433333333,315.1487,246260,246455,195
106,53,!=,359,286.50214,328.08822,246455,246625,170
106,53,!=,359,284.232,331.72858,246625,246795,170
106,53,!=,359,270.26668,324.97904,246795,246966,171
106,53,],366,262.921,321.20294,246966,247136,170
106,53,b,360,298.742,330.42558,247136,247306,170
106,53,[,364,322.97436,325.88756,247306,247474,168
106,0,blank,0,354.268716666667,316.642133333333,247474,247672,198
106,0,blank,0,352.234116666667,332.715533333333,247672,247871,199
106,56,break,373,296.45302,367.85826,247871,248038,167
106,56,break,373,292.12815,369.0689,248038,248170,132
106,0,blank,0,364.275766666667,265.749133333333,248204,248402,198
106,0,blank,0,310.69476,260.81084,248402,248569,167
106,0,blank,0,265.65528,260.73636,248569,248737,168
106,0,blank,0,265.78426,262.06814,248737,248905,168
106,49,row1,330,259.7601,241.9301,248905,249072,167
106,48,"Matricescanbecompared\n",319,253.616866666667,217.453066666667,249072,249271,199
106,48,"Matricescanbecompared\n",319,327.789933333333,220.98885,249271,249469,198
106,0,blank,0,345.274516666667,191.614016666667,249469,249665,196
106,46,==,313,320.76946,168.5147,249665,249833,168
106,0,blank,0,327.91158,157.98152,249833,250002,169
106,0,blank,0,382.68912,152.37144,250002,250171,169
106,0,blank,0,401.091475,157.689325,250171,250303,132
106,0,blank,0,259.43516,146.50972,250337,250504,167
106,0,blank,0,283.75982,154.58216,250504,250672,168
106,46,column1,312,296.2038,172.047225,250672,250805,133
106,0,blank,0,270.47274,369.77704,250839,251007,168
106,56,break,373,287.2943,383.54538,251007,251175,168
106,0,blank,0,273.9833,414.0016,251175,251243,68
106,0,blank,0,227.99466,598.06076,251276,251446,170
106,0,blank,0,226.982525,588.916675,251446,251579,133
106,53,],366,233.57136,320.641,251613,251780,167
106,53,[,364,234.2266,322.0338,251780,251813,33
106,0,blank,0,351.75336,594.69808,251847,252010,163
106,67,"Twomatricesareequal\n",400,375.08964,641.52036,252010,252196,186
106,69,"But,twomatricesarenotequal\n",406,375.908566666667,666.165266666667,252196,252292,96
106,0,blank,0,217.4455,664.408333333333,252325,252521,196
106,0,blank,0,181.551616666667,648.54425,252521,252718,197
106,0,blank,0,206.095233333333,564.9189,252718,252915,197
106,0,blank,0,209.613766666667,584.318933333333,252915,253111,196
106,0,blank,0,191.75615,582.4639,253111,253308,197
106,0,blank,0,178.690733333333,587.56945,253308,253506,198
106,0,blank,0,189.32502,582.34416,253506,253672,166
106,0,blank,0,186.99264,573.53776,253672,253838,166
106,0,blank,0,168.48062,569.03764,253838,254001,163
106,0,blank,0,-350,-105,254034,254168,134
106,0,blank,0,173.879816666667,584.59025,254283,254471,188
106,0,blank,0,157.01,583.40045,254471,254664,193
106,67,printf,398,174.121466666667,602.583,254664,254858,194
106,67,printf,398,200.481233333333,628.290483333333,254858,255045,187
106,0,blank,0,212.3975,574.813116666667,255045,255231,186
106,63,"Cannotbecompared\n",383,258.4977,551.602983333333,255231,255423,192
106,63,"Cannotbecompared\n",383,299.882816666667,543.082366666667,255423,255613,190
106,63,"Cannotbecompared\n",383,290.4892,537.1561,255613,255805,192
106,63,"Cannotbecompared\n",383,311.1957,551.844416666667,255805,255998,193
106,0,blank,0,351.60155,554.1274,255998,256190,192
106,63,"Cannotbecompared\n",383,350.6754,548.8912,256190,256253,63
106,0,blank,0,211.675416666667,654.668716666667,256285,256478,193
106,0,blank,0,215.93698,643.36794,256478,256641,163
106,0,blank,0,185.5825,692.068133333333,256641,256834,193
106,69,"But,twomatricesarenotequal\n",406,259.9762,675.9241,256834,257028,194
106,69,"But,twomatricesarenotequal\n",406,276.69906,677.41216,257028,257202,174
106,0,blank,0,206.21064,650.14954,257202,257381,179
106,67,printf,398,177.71072,635.42548,257381,257548,167
106,0,blank,0,179.690366666667,642.2422,257548,257649,101
106,0,blank,0,357.42526,645.67616,257682,257848,166
106,0,blank,0,305.2463,650.65022,257848,258014,166
106,0,blank,0,278.38654,649.25366,258014,258180,166
106,67,"Twomatricesareequal\n",400,261.0158,641.1233,258180,258280,100
106,67,"Twomatricesareequal\n",400,260.3405,639.6397,258280,258395,115
106,0,blank,0,327.9448,645.8441,258395,258521,126
106,0,blank,0,318.613225,645.494525,258521,258718,197
106,67,"Twomatricesareequal\n",400,329.91142,639.80608,258718,258892,174
106,67,"Twomatricesareequal\n",400,381.66535,641.45495,258892,259091,199
106,67,"Twomatricesareequal\n",400,393.33076,637.3172,259091,259259,168
106,0,blank,0,423.14052,634.2962,259259,259427,168
106,68,else,403,440.4172,642.8486,259427,259495,68
106,69,"But,twomatricesarenotequal\n",406,256.6387,683.39562,259529,259698,169
106,69,"But,twomatricesarenotequal\n",406,271.3104,679.3806,259698,259866,168
106,69,"But,twomatricesarenotequal\n",406,324.14954,681.10256,259866,260034,168
106,69,"But,twomatricesarenotequal\n",406,381.312983333333,680.055183333333,260034,260233,199
106,69,"But,twomatricesarenotequal\n",406,419.97966,679.83642,260233,260404,171
106,69,"But,twomatricesarenotequal\n",406,454.127783333333,669.102783333333,260404,260603,199
106,68,else,403,497.152533333333,650.006983333333,260603,260799,196
106,68,else,403,448.669983333333,640.70305,260799,260994,195
106,0,blank,0,394.944616666667,646.6318,260994,261193,199
106,0,blank,0,395.486533333333,645.1712,261193,261292,99
106,0,blank,0,270.96715,650.993383333333,261324,261522,198
106,67,"Twomatricesareequal\n",400,173.04786,623.35712,261522,261688,166
106,67,printf,398,198.881633333333,623.721716666667,261688,261887,199
106,67,printf,398,221.57435,611.99395,261887,262085,198
106,0,blank,0,199.44705,585.04065,262085,262219,134
106,0,blank,0,955.128166666667,514.784216666667,262287,262483,196
106,0,blank,0,990.9045,533.893116666667,262483,262680,197
106,0,blank,0,997.2035,529.19525,262680,262747,67
106,67,printf,398,218.12555,609.08625,262813,263008,195
106,0,blank,0,225.40195,582.89505,263008,263206,198
106,0,blank,0,219.97792,529.84512,263206,263365,159
106,0,blank,0,284.560316666667,249.482916666667,263431,263623,192
106,0,blank,0,267.636083333333,146.449966666667,263655,263846,191
106,46,column1,312,265.8049,165.7047,263846,263879,33
107,37,"MATRIXBis\n",255,227.55076,307.1501,264594,264760,166
107,37,"MATRIXBis\n",255,224.54812,311.16048,264760,264930,170
107,37,"MATRIXBis\n",255,223.93722,309.27586,264930,265096,166
107,37,"MATRIXBis\n",255,249.7184,306.3775,265096,265293,197
107,37,"MATRIXBis\n",255,277.08505,313.435866666667,265293,265490,197
107,37,"MATRIXBis\n",255,266.010816666667,309.317366666667,265490,265685,195
107,37,),256,290.17495,317.899616666667,265685,265878,193
107,37,),256,291.670125,307.240725,265878,266006,128
107,28,"MATRIXAis\n",202,231.500666666667,118.796566666667,266039,266230,191
107,28,"MATRIXAis\n",202,256.06345,112.11925,266230,266421,191
107,28,"MATRIXAis\n",202,254.652766666667,111.456383333333,266421,266616,195
107,28,"MATRIXAis\n",202,270.3879,103.229,266616,266815,199
107,0,blank,0,227.36875,99.7468333333333,266815,267014,199
107,28,"MATRIXAis\n",202,255.66696,102.44392,267014,267181,167
107,0,blank,0,272.842,100.61556,267181,267355,174
107,0,blank,0,262.82436,95.26036,267355,267527,172
107,28,"MATRIXAis\n",202,266.64022,106.5388,267527,267703,176
107,0,blank,0,292.16246,95.07832,267703,267877,174
107,0,blank,0,299.7298,92.0616,267877,268052,175
107,28,),203,288.27124,102.37374,268052,268228,176
107,28,),203,288.11192,108.67154,268228,268401,173
107,0,blank,0,296.76922,239.18142,268433,268602,169
107,0,blank,0,297.86352,295.28174,268602,268771,169
107,0,blank,0,293.08236,304.17292,268771,268940,169
107,0,blank,0,292.276983333333,313.6274,268940,269139,199
107,37,),256,288.8516,318.568816666667,269139,269338,199
107,38,++,269,281.2505,325.94465,269338,269533,195
107,0,blank,0,241.291133333333,379.699183333333,269533,269726,193
107,0,blank,0,236.645375,380.4759,269726,269858,132
107,46,column1,312,268.629216666667,502.747733333333,269891,270086,195
107,46,column1,312,270.333833333333,511.997783333333,270086,270280,194
107,0,blank,0,297.755766666667,524.17195,270280,270476,196
107,33,a,237,266.707583333333,215.2277,270541,270735,194
107,0,blank,0,267.093066666667,210.616933333333,270735,270933,198
107,0,blank,0,355.3076,217.352283333333,270933,271128,195
107,33,[,241,310.747883333333,219.170983333333,271128,271321,193
107,33,i,239,293.89915,226.19945,271321,271385,64
107,0,blank,0,274.087816666667,442.590216666667,271417,271611,194
107,0,blank,0,285.41045,479.2886,271611,271807,196
107,46,column1,312,262.707066666667,516.1967,271807,271997,190
107,0,blank,0,431.939083333333,490.084916666667,271997,272191,194
107,0,blank,0,450.89375,490.66805,272191,272256,65
107,0,blank,0,992.645,447.7779,272321,272514,193
107,0,blank,0,986.058166666667,453.814633333333,272514,272706,192
107,0,blank,0,985.2325,455.0664,272706,272898,192
107,0,blank,0,983.437666666667,455.627783333333,272898,273090,192
107,0,blank,0,976.04025,459.35675,273090,273221,131
107,0,blank,0,264.40608,453.78822,273286,273453,167
107,0,blank,0,284.965433333333,403.470133333333,273453,273651,198
107,40,column2,280,295.079,366.5659,273651,273685,34
107,31,column1,227,286.73685,175.96655,273719,273785,66
108,23,column2,178,274.6233,248.272666666667,274496,274692,196
108,0,blank,0,285.630016666667,279.643566666667,274692,274890,198
108,0,blank,0,337.591983333333,272.97995,274890,275085,195
108,0,blank,0,325.450066666667,273.475883333333,275085,275280,195
108,0,blank,0,331.449316666667,279.012916666667,275280,275478,198
108,25,;,197,337.303333333333,283.97665,275478,275675,197
108,25,j,194,307.03902,289.02608,275675,275842,167
108,25,j,194,308.15526,290.49158,275842,276009,167
108,0,blank,0,351.312683333333,295.564666666667,276009,276206,197
108,25,],195,317.12132,284.01124,276206,276374,168
108,0,blank,0,319.832816666667,278.99675,276374,276573,199
108,0,blank,0,315.126366666667,277.463366666667,276573,276772,199
108,25,],195,320.4787,282.44345,276772,276970,198
108,0,blank,0,323.62694,290.19264,276970,277138,168
108,25,],195,318.95066,290.95856,277138,277305,167
108,0,blank,0,322.68418,300.21864,277305,277472,167
108,25,j,194,303.2695,282.34674,277472,277640,168
108,25,],195,314.501516666667,281.004383333333,277640,277839,199
108,0,blank,0,351.39175,294.2382,277839,278035,196
108,0,blank,0,315.860333333333,265.32445,278035,278232,197
108,23,column2,178,308.567466666667,245.365566666667,278232,278431,199
108,0,blank,0,325.17712,236.04754,278431,278598,167
108,0,blank,0,323.632,232.6582,278598,278777,179
108,23,column2,178,294.406,248.4426,278777,278899,122
108,23,column2,178,272.3448,242.15875,278899,279091,192
108,23,column2,178,286.055633333333,243.935016666667,279091,279289,198
108,23,),182,365.0596,250.839716666667,279289,279484,195
108,0,blank,0,381.933116666667,248.713866666667,279484,279680,196
108,23,),182,369.55585,248.53275,279680,279876,196
108,0,blank,0,347.336,196.5941,279876,280070,194
108,20,"EntertheelementsofmatrixB\n",153,354.241333333333,190.645016666667,280070,280266,196
108,0,blank,0,383.835116666667,128.266583333333,280266,280461,195
108,0,blank,0,368.479325,109.024925,280461,280587,126
108,0,blank,0,1010.35816666667,302.648816666667,280684,280879,195
108,0,blank,0,1018.6265,298.6551,280879,281072,193
108,0,blank,0,1021.941,307.380566666667,281072,281168,96
108,0,blank,0,365.281683333333,133.754733333333,281232,281426,194
108,0,blank,0,337.333283333333,140.767233333333,281426,281624,198
109,15,column1,129,289.975383333333,261.453183333333,281983,282177,194
109,0,blank,0,283.219116666667,245.474883333333,282177,282372,195
109,13,row1,115,232.284733333333,230.12465,282372,282565,193
109,0,blank,0,258.98815,211.109183333333,282565,282758,193
109,13,row1,115,225.972616666667,210.553883333333,282758,282950,192
109,12,"EntertheelementsofmatrixA\n",104,214.194833333333,203.601666666667,282950,283141,191
109,11,row2,96,213.627216666667,168.698033333333,283141,283332,191
109,13,row1,115,238.0903,217.31685,283332,283526,194
109,13,row1,115,236.78645,216.89625,283526,283718,192
109,12,"EntertheelementsofmatrixA\n",104,236.690316666667,198.350216666667,283718,283917,199
109,9,column1,83,293.85228,133.1458,283917,284084,167
109,7,row2,62,310.55002,97.61552,284084,284253,169
109,0,blank,0,315.71595,68.8706166666667,284253,284451,198
109,6,10,50,273.7692,57.8424166666667,284451,284650,199
109,0,blank,0,229.29796,53.7455,284650,284817,167
109,6,[,49,206.15946,66.28028,284817,284987,170
109,6,10,50,217.8777,68.3921,284987,285157,170
109,6,],51,241.63694,68.04798,285157,285331,174
109,6,10,50,263.33936,70.3019,285331,285498,167
109,0,blank,0,293.57128,59.14176,285498,285664,166
109,6,10,50,258.89698,69.9862,285664,285832,168
109,0,blank,0,200.48664,96.63268,285832,286003,171
109,7,comma,65,186.32156,90.6814,286003,286176,173
109,0,blank,0,202.14942,83.79466,286176,286348,172
109,0,blank,0,296.75606,74.5779,286348,286515,167
109,0,blank,0,305.15918,78.74142,286515,286684,169
109,0,blank,0,367.03248,75.17762,286684,286858,174
109,7,column2,64,394.35262,82.36014,286858,287027,169
109,7,column2,64,411.3827,81.78805,287027,287225,198
109,0,blank,0,356.5915,77.20476,287225,287392,167
109,7,row2,62,327.37368,84.5685,287392,287560,168
109,7,row2,62,325.2229,89.9799,287560,287727,167
109,0,blank,0,381.38554,73.00244,287727,287897,170
109,0,blank,0,389.20846,77.14948,287897,288066,169
109,7,flag,66,456.87745,79.3556833333333,288066,288265,199
109,0,blank,0,509.455616666667,87.8250666666667,288265,288463,198
109,7,1,68,516.771983333333,84.1021,288463,288659,196
109,8,"EntertheorderofthematrixA\n",72,428.056633333333,104.276366666667,288659,288855,196
109,8,"EntertheorderofthematrixA\n",72,414.581833333333,103.822766666667,288855,288955,100
109,9,row1,80,222.758033333333,129.139716666667,288987,289186,199
109,9,row1,80,220.0941,128.63398,289186,289355,169
109,9,column1,83,282.918283333333,128.13005,289355,289554,199
109,9,column1,83,286.134566666667,131.542366666667,289554,289750,196
109,9,column1,83,320.602883333333,130.148883333333,289750,289946,196
109,9,;,85,356.970783333333,140.029966666667,289946,290145,199
109,0,blank,0,325.982,143.83998,290145,290313,168
109,10,"EntertheorderofthematrixB\n",88,292.276583333333,162.565333333333,290313,290508,195
109,11,&,98,274.49675,167.345283333333,290508,290702,194
109,10,"EntertheorderofthematrixB\n",88,271.1267,163.338616666667,290702,290898,196
109,11,column2,99,275.071133333333,174.33045,290898,291094,196
109,11,&,98,274.113333333333,177.061283333333,291094,291288,194
109,11,column2,99,306.9485,173.33075,291288,291481,193
109,11,column2,99,340.149283333333,180.645316666667,291481,291677,196
109,11,column2,99,335.477933333333,174.461333333333,291677,291876,199
109,11,column2,99,332.42825,171.626633333333,291876,292071,195
109,11,column2,99,296.580966666667,171.560216666667,292071,292268,197
109,11,column2,99,294.983233333333,173.379283333333,292268,292461,193
109,12,"EntertheelementsofmatrixA\n",104,280.526,201.987916666667,292461,292655,194
109,13,row1,115,239.31895,216.455933333333,292655,292848,193
109,13,row1,115,222.30945,224.037733333333,292848,293040,192
109,0,blank,0,260.071683333333,223.3748,293040,293230,190
109,0,blank,0,256.45905,222.80065,293230,293422,192
109,13,row1,115,235.4106,216.8724,293422,293614,192
109,13,++,118,291.229516666667,220.296716666667,293614,293805,191
109,13,++,118,283.409883333333,215.222916666667,293805,293992,187
109,13,i,117,264.506066666667,222.150283333333,293992,294183,191
109,13,++,118,282.62375,228.679066666667,294183,294375,192
109,13,++,118,283.105983333333,230.916033333333,294375,294565,190
109,0,blank,0,286.724183333333,248.806733333333,294565,294757,192
109,0,blank,0,311.649466666667,278.285966666667,294757,294944,187
109,0,blank,0,254.3599,277.79805,294944,295137,193
109,15,column1,129,249.259133333333,271.413183333333,295137,295331,194
109,0,blank,0,219.594125,245.4636,295331,295458,127
109,0,blank,0,385.501066666667,265.259883333333,295489,295680,191
109,0,blank,0,363.652766666667,295.450866666667,295680,295870,190
109,0,blank,0,355.564216666667,299.752616666667,295870,296059,189
109,0,blank,0,393.552166666667,281.53385,296059,296252,193
109,0,blank,0,346.664883333333,301.180816666667,296252,296444,192
109,17,),147,324.593466666667,306.5921,296444,296640,196
109,17,],146,288.904916666667,307.662633333333,296640,296830,190
109,17,a,140,257.1688,314.781616666667,296830,297019,189
109,21,++,167,285.380616666667,405.7872,297019,297209,190
109,0,blank,0,292.788633333333,425.7339,297209,297398,189
109,0,blank,0,270.8356,412.193333333333,297398,297591,193
109,0,blank,0,259.6283,427.586533333333,297591,297788,197
109,0,blank,0,237.242283333333,438.208766666667,297788,297987,199
109,0,blank,0,263.4122,463.934066666667,297987,298184,197
109,25,),196,325.577066666667,490.533516666667,298184,298383,199
109,0,blank,0,348.735383333333,503.7474,298383,298579,196
109,25,j,194,310.242816666667,490.961983333333,298579,298776,197
109,0,blank,0,257.86335,575.789266666667,298776,298975,199
109,0,blank,0,285.26025,587.03765,298975,299107,132
109,0,blank,0,277.1771,600.0544,299107,299210,103
109,0,blank,0,304.31215,570.0394,299210,299403,193
109,29,++,216,288.725283333333,569.643733333333,299403,299601,198
109,31,column1,227,281.0568,616.17065,299601,299798,197
109,0,blank,0,310.853583333333,638.6919,299798,299995,197
109,0,blank,0,269.2238,646.71065,299995,300190,195
109,33,[,241,279.146266666667,651.335433333333,300190,300388,198
109,31,column1,227,276.331483333333,615.740633333333,300388,300587,199
109,31,j,229,336.503133333333,609.059816666667,300587,300784,197
109,29,),217,295.002533333333,576.8285,300784,300976,192
109,28,"MATRIXAis\n",202,251.943566666667,550.55745,300976,301169,193
109,28,"MATRIXAis\n",202,252.756533333333,552.734533333333,301169,301268,99
109,0,blank,0,1009.83833333333,414.139733333333,301334,301531,197
109,0,blank,0,1008.26433333333,348.856666666667,301531,301726,195
109,0,blank,0,1006.0482,316.34816,301726,301892,166
109,0,blank,0,1000.9254,329.3774,301892,302063,171
109,0,blank,0,996.7194,332.54278,302063,302234,171
109,0,blank,0,996.8312,338.58042,302234,302405,171
109,0,blank,0,994.218333333333,335.189066666667,302405,302507,102
109,0,blank,0,320.83136,598.04154,302609,302776,167
109,0,blank,0,326.7561,593.9691,302776,302810,34
110,37,"MATRIXBis\n",255,235.0315,484.69954,303283,303452,169
110,0,blank,0,259.978816666667,457.902566666667,303452,303647,195
110,42,[,294,278.981516666667,599.690283333333,303680,303875,195
110,0,blank,0,258.83704,610.9205,303875,304037,162
111,38,row2,266,223.7471,500.24326,304389,304556,167
111,0,blank,0,916.3438,422.58846,304623,304791,168
111,0,blank,0,987.112666666667,429.241566666667,304791,304989,198
111,0,blank,0,998.835666666666,420.834366666667,304989,305187,198
111,0,blank,0,994.1154,400.54478,305187,305357,170
111,0,blank,0,988.451,419.8966,305357,305524,167
111,0,blank,0,950.1132,456.7632,305524,305692,168
111,0,blank,0,973.1012,430.28446,305692,305860,168
111,0,blank,0,980.668,424.9895,305860,306031,171
111,0,blank,0,971.7556,431.74806,306031,306201,170
111,0,blank,0,997.115,422.3449,306201,306400,199
111,0,blank,0,995.338,433.3381,306400,306597,197
111,0,blank,0,962.592333333333,419.571866666667,306597,306695,98
111,0,blank,0,251.745416666667,469.201633333333,306729,306928,199
111,0,blank,0,258.12824,465.61922,306928,307098,170
111,0,blank,0,247.617,431.7188,307098,307132,34
112,42,],296,300.760233333333,375.6022,307909,308101,192
112,42,],296,300.111266666667,362.814733333333,308101,308292,191
112,42,i,292,292.49335,365.909766666667,308292,308481,189
112,0,blank,0,268.819883333333,387.636333333333,308481,308675,194
112,0,blank,0,249.636916666667,433.122583333333,308675,308869,194
112,46,==,313,332.6549,466.286783333333,308869,309067,198
112,0,blank,0,301.709633333333,471.064283333333,309067,309263,196
112,0,blank,0,266.443316666667,473.88975,309263,309461,198
112,46,column1,312,251.03112,467.18338,309461,309630,169
112,46,&&,311,221.11956,457.7684,309630,309797,167
112,46,row2,310,193.413766666667,459.069133333333,309797,309895,98
112,46,),315,424.511916666667,452.44545,309928,310126,198
112,0,blank,0,347.526666666667,469.245116666667,310126,310322,196
112,0,blank,0,296.92785,469.272616666667,310322,310519,197
112,0,blank,0,256.438266666667,483.2039,310519,310716,197
112,0,blank,0,228.48026,472.29144,310716,310884,168
112,46,row2,310,194.425766666667,458.94915,310884,311079,195
112,46,column1,312,262.056066666667,466.89095,311079,311276,197
112,46,column1,312,302.627,468.325033333333,311276,311472,196
112,46,==,313,328.433016666667,464.744383333333,311472,311667,195
112,46,column2,314,354.004533333333,468.825033333333,311667,311862,195
112,46,column2,314,419.668283333333,463.261283333333,311862,312056,194
112,46,column2,314,412.475533333333,463.152183333333,312056,312251,195
112,46,column2,314,355.173533333333,466.89635,312251,312443,192
112,46,column2,314,355.094483333333,467.768533333333,312443,312640,197
112,49,i,332,308.622616666667,517.893683333333,312640,312837,197
112,49,i,332,308.34112,524.08128,312837,313001,164
112,0,blank,0,1018.00083333333,522.446466666667,313066,313260,194
112,0,blank,0,996.954333333333,523.138633333333,313260,313457,197
112,0,blank,0,997.457333333333,514.673033333333,313457,313655,198
112,0,blank,0,1000.21416666667,501.915933333333,313655,313848,193
112,0,blank,0,996.899166666667,508.466183333333,313848,314044,196
112,0,blank,0,993.488333333333,504.176966666667,314044,314140,96
113,51,column2,344,300.526,344.8787,314803,314836,33
113,0,blank,0,324.835466666667,509.895233333333,314869,315067,198
113,0,blank,0,321.381,505.381416666667,315067,315262,195
113,0,blank,0,367.93645,586.438083333333,315262,315459,197
113,63,"Cannotbecompared\n",383,315.6606,611.202666666667,315459,315654,195
113,0,blank,0,291.251183333333,615.289183333333,315654,315852,198
113,0,blank,0,342.66346,668.60182,315852,316019,167
113,67,"Twomatricesareequal\n",400,383.572966666667,687.710616666667,316019,316217,198
113,67,"Twomatricesareequal\n",400,401.991525,690.541925,316217,316349,132
113,67,"Twomatricesareequal\n",400,266.504766666667,699.583083333333,316382,316575,193
113,67,"Twomatricesareequal\n",400,232.78885,688.240583333333,316575,316769,194
113,0,blank,0,238.4987,678.119333333333,316769,316865,96
113,0,blank,0,982.407,585.11458,316929,317098,169
113,0,blank,0,988.1528,582.9419,317098,317265,167
113,0,blank,0,986.276833333333,586.271716666667,317265,317462,197
113,0,blank,0,997.439,577.732366666667,317462,317660,198
113,0,blank,0,988.288,578.94682,317660,317827,167
113,0,blank,0,338.381933333333,673.0768,317895,318093,198
113,0,blank,0,345.0452,647.7592,318093,318127,34
114,69,"But,twomatricesarenotequal\n",406,362.79354,681.29354,318195,318362,167
114,0,blank,0,348.672366666667,687.036833333333,318362,318462,100
114,0,blank,0,175.82994,648.01848,318495,318662,167
114,0,blank,0,203.1954,644.756383333333,318662,318861,199
114,0,blank,0,201.73785,614.880333333333,318861,319060,199
114,0,blank,0,193.2364,594.498983333333,319060,319257,197
114,0,blank,0,205.69368,579.44836,319257,319448,191
114,0,blank,0,195.3726,567.2608,319448,319574,126
114,63,"Cannotbecompared\n",383,255.9025,537.4404,319574,319699,125
114,63,"Cannotbecompared\n",383,248.85575,535.37645,319699,319821,122
114,0,blank,0,832.3765,-5.30246666666667,319916,320109,193
114,0,blank,0,840.321833333333,-52.0527333333333,320109,320300,191
114,0,blank,0,818.024666666667,-38.5691833333333,320300,320495,195
114,0,blank,0,787.2138,-24.0556,320495,320654,159
114,0,blank,0,570.6771,-7.6778,320686,320815,129
114,0,blank,0,-350,-105,320880,321060,180
114,0,blank,0,-350,-105,321060,321190,130
114,0,blank,0,295.1684,-10.6444833333333,321222,321421,199
114,0,blank,0,169.5124,-5.64304,321454,321621,167
114,0,blank,0,198.00275,-15.62295,321621,321818,197
114,0,blank,0,207.838383333333,-17.6921333333333,321818,322012,194
114,0,blank,0,241.299433333333,-16.2105333333333,322012,322208,196
114,0,blank,0,291.17426,-22.87296,322208,322377,169
114,0,blank,0,267.222016666667,66.5658333333333,322377,322576,199
114,0,blank,0,257.87005,106.7162,322576,322643,67
114,0,blank,0,98.89502,-35.42096,322677,322843,166
114,0,blank,0,100.60308,-33.1639,322843,323014,171
114,0,blank,0,97.0899,-38.6153,323014,323188,174
114,0,blank,0,100.1086,-33.0452,323188,323359,171
114,0,blank,0,99.3405666666667,-24.9334,323359,323558,199
114,0,blank,0,80.8425,-43.7999,323558,323592,34
114,48,"Matricescanbecompared\n",319,393.5926,219.7976,323625,323692,67
