Frameno_fix,lineno_fix,Tokenname_fix,tokens_id,gaze_X_fix,gaze_Y_fix,timestamp_fix_start,timestamp_fix_end,time_duration
100,0,blank,0,141.98885,-100.573533333333,3265,3455,190
100,0,blank,0,157.690716666667,-59.6263833333333,3455,3646,191
100,1,accept,6,200.0701,19.3934,3646,3809,163
100,0,blank,0,-350,-105,3841,4002,161
100,0,blank,0,425.35625,-35.7834,4109,4166,57
100,0,blank,0,562.65315,-25.60155,4197,4390,193
100,0,blank,0,640.53832,-32.68,4390,4548,158
100,0,blank,0,-350,-105,4579,4733,154
100,0,blank,0,222.940116666667,-44.15775,4890,5082,192
100,0,blank,0,186.907733333333,-37.5329,5082,5275,193
100,0,blank,0,294.103916666667,-44.96425,5275,5469,194
100,0,blank,0,365.1556,-42.5223666666667,5469,5660,191
100,0,blank,0,449.120116666667,-47.6630833333333,5660,5854,194
100,0,blank,0,467.659,-51.5970166666667,5854,6047,193
100,0,blank,0,538.8186,-43.2829166666667,6047,6245,198
100,0,blank,0,538.46815,-54.858,6245,6311,66
100,0,blank,0,-350,-105,6345,6499,154
100,0,blank,0,127.149616666667,-59.6329166666667,6640,6827,187
100,0,blank,0,122.7587,-52.12332,6827,6994,167
100,0,blank,0,118.592583333333,-33.9207666666667,6994,7192,198
100,0,blank,0,105.24242,-37.71172,7192,7356,164
100,0,blank,0,206.754316666667,-30.6073,7388,7581,193
100,0,blank,0,226.1615,-22.40722,7581,7753,172
100,0,blank,0,298.8356,-33.278,7753,7824,71
100,0,blank,0,-350,-105,8042,8230,188
100,0,blank,0,-350,-105,8230,8317,87
100,0,blank,0,-350,-105,8317,8496,179
100,0,blank,0,-350,-105,8496,8599,103
100,0,blank,0,-350,-105,8808,8962,154
100,0,blank,0,-350,-105,8962,9009,47
100,0,blank,0,429.088816666667,-46.16805,9041,9223,182
100,0,blank,0,485.427566666667,-28.6534666666667,9223,9419,196
100,0,blank,0,536.2427,-28.5759,9419,9609,190
100,0,blank,0,601.034183333333,-14.65055,9609,9796,187
100,0,blank,0,574.868116666667,-20.7365166666667,9796,9980,184
100,0,blank,0,550.238466666667,-45.9723,9980,10074,94
100,0,blank,0,-350,-105,10105,10291,186
100,0,blank,0,-350,-105,10291,10487,196
100,0,blank,0,171.6436,-47.5718,10518,10690,172
100,0,blank,0,242.766466666667,-33.0512333333333,10690,10878,188
100,0,blank,0,283.617283333333,-39.10425,10878,11062,184
100,0,blank,0,304.579625,-38.664425,11062,11183,121
100,0,blank,0,-350,-105,11213,11402,189
100,0,blank,0,336.6454,-27.736,11544,11562,18
100,0,blank,0,467.37485,-48.2007833333333,11594,11777,183
100,0,blank,0,486.446066666667,-67.2020833333333,11777,11957,180
100,0,blank,0,536.65825,-67.3049666666667,11957,12142,185
100,0,blank,0,550.916366666667,-44.7559333333333,12142,12331,189
100,0,blank,0,603.081516666667,-38.8506833333333,12331,12516,185
100,0,blank,0,565.2625,-37.79615,12516,12707,191
100,0,blank,0,502.063966666667,-32.13805,12707,12897,190
100,0,blank,0,458.216016666667,-29.6609333333333,12897,13087,190
100,0,blank,0,452.87554,-32.20086,13087,13243,156
100,1,to,5,149.166316666667,21.5299,13274,13460,186
100,0,blank,0,131.8771,45.6265333333333,13460,13651,191
100,0,blank,0,120.96556,42.16856,13651,13808,157
100,0,blank,0,601.340533333333,-34.19565,13840,14027,187
100,0,blank,0,645.736266666667,-11.6448,14027,14219,192
100,0,blank,0,574.826683333333,-18.6649,14219,14406,187
100,0,blank,0,453.9305,-3.1006,14406,14438,32
100,3,stdlib,27,111.3776,48.63815,14471,14664,193
100,2,stdio,20,108.82175,41.5121,14664,14754,90
100,2,stdio,20,108.8526,36.68005,14754,14946,192
100,0,blank,0,-350,-105,15065,15254,189
100,0,blank,0,-350,-105,15254,15446,192
100,0,blank,0,-350,-105,15446,15473,27
100,1,Program,4,107.143485714286,17.5728142857143,15532,15728,196
100,2,stdio,20,123.764316666667,30.7823,15728,15912,184
100,2,stdio,20,122.76455,32.7953,15912,16100,188
100,1,Program,4,116.130283333333,11.8153833333333,16100,16296,196
100,1,Program,4,121.166475,10.420725,16296,16430,134
100,0,blank,0,-350,-105,16498,16677,179
100,0,blank,0,-350,-105,16677,16852,175
100,0,blank,0,-350,-105,16852,17033,181
100,0,blank,0,-350,-105,17033,17209,176
100,0,blank,0,-350,-105,17209,17385,176
100,0,blank,0,-350,-105,17385,17582,197
100,0,blank,0,-350,-105,17582,17761,179
100,0,blank,0,-350,-105,17761,17956,195
100,0,blank,0,-350,-105,17956,18134,178
100,0,blank,0,-350,-105,18134,18285,151
100,0,blank,0,-350,-105,18285,18448,163
100,0,blank,0,-350,-105,18448,18523,75
100,0,blank,0,-350,-105,18523,18674,151
100,0,blank,0,-350,-105,18674,18853,179
100,0,blank,0,-350,-105,18853,19043,190
100,0,blank,0,-350,-105,19043,19236,193
100,0,blank,0,-350,-105,19236,19406,170
100,0,blank,0,-350,-105,19406,19502,96
100,0,blank,0,199.3589,104.761683333333,19524,19695,171
100,0,blank,0,199.8663,98.908,19695,19755,60
100,0,blank,0,292.523633333333,101.69175,19815,19990,175
100,0,blank,0,354.945966666667,106.148383333333,19990,20171,181
100,0,blank,0,360.947,85.0783666666667,20171,20259,88
100,0,blank,0,117.77115,112.002583333333,20289,20470,181
100,6,a,37,84.6031333333333,118.878333333333,20470,20652,182
100,0,blank,0,112.7351,149.1937,20652,20683,31
100,0,blank,0,-350,-105,20713,20899,186
100,0,blank,0,-350,-105,20899,21053,154
100,0,blank,0,-350,-105,21053,21183,130
100,0,blank,0,265.52995,43.6534,21212,21260,48
100,0,blank,0,509.108033333333,87.30415,21290,21475,185
100,0,blank,0,517.074966666667,85.8846333333333,21475,21655,180
100,0,blank,0,530.1702,66.4536,21655,21836,181
100,0,blank,0,549.026833333333,92.9385666666667,21836,22018,182
100,0,blank,0,556.8907,104.4379,22018,22048,30
100,0,blank,0,-350,-105,22078,22260,182
100,0,blank,0,492.3207,72.3212,22396,22544,148
100,0,blank,0,340.085266666667,64.7019166666667,22575,22758,183
100,0,blank,0,317.247933333333,90.3099333333333,22758,22940,182
100,0,blank,0,269.982066666667,76.1159666666667,22940,23118,178
100,0,blank,0,205.771233333333,80.3531,23118,23296,178
100,0,blank,0,165.834183333333,93.0848666666667,23296,23473,177
100,0,blank,0,191.079,68.14515,23473,23532,59
100,0,blank,0,-350,-105,23562,23748,186
100,0,blank,0,-350,-105,23748,23902,154
100,0,blank,0,-350,-105,23902,24048,146
100,0,blank,0,-350,-105,24048,24103,55
100,0,blank,0,203.0733,104.065783333333,24128,24300,172
100,0,blank,0,218.753433333333,99.8331666666667,24300,24477,177
100,0,blank,0,222.59635,110.5601,24477,24652,175
100,0,blank,0,219.319,92.1497833333333,24652,24829,177
100,0,blank,0,216.24605,95.4456,24829,25007,178
100,0,blank,0,209.5894,92.1956,25007,25066,59
100,0,blank,0,208.7394,111.2372,25066,25433,367
100,0,blank,0,213.528183333333,105.0705,25433,25611,178
100,6,10,50,232.28855,118.450716666667,25611,25796,185
100,6,10,50,225.740266666667,114.850466666667,25796,25981,185
100,6,b,45,203.5098,127.8427,25981,26043,62
100,0,blank,0,-350,-105,26074,26261,187
100,0,blank,0,-350,-105,26261,26415,154
100,0,blank,0,221.187366666667,72.5789333333333,26441,26521,80
100,0,blank,0,331.300216666667,107.705633333333,26552,26735,183
100,0,blank,0,353.943633333333,107.13215,26735,26918,183
100,6,;,52,286.570366666667,116.433566666667,26918,27102,184
100,0,blank,0,287.78595,97.62475,27102,27164,62
100,6,10,50,156.032166666667,121.383583333333,27195,27377,182
100,6,[,49,140.405916666667,121.369366666667,27377,27558,181
100,0,blank,0,133.844633333333,139.592266666667,27558,27646,88
100,0,blank,0,-350,-105,27677,27840,163
100,0,blank,0,133.0007,103.25545,27985,28040,55
100,0,blank,0,243.59065,126.261333333333,28076,28261,185
100,0,blank,0,207.7003,113.347833333333,28261,28442,181
100,0,blank,0,194.963266666667,101.459133333333,28442,28625,183
100,0,blank,0,205.081483333333,68.5827833333333,28625,28808,183
100,0,blank,0,269.238016666667,-21.49175,28808,28990,182
100,0,blank,0,384.274266666667,-31.1617,28990,29170,180
100,0,blank,0,400.877,-26.6357,29170,29200,30
100,0,blank,0,156.819483333333,-30.5318833333333,29231,29415,184
100,0,blank,0,152.64185,-22.4775,29415,29539,124
100,0,blank,0,431.426016666667,-33.0827666666667,29571,29763,192
100,0,blank,0,535.92045,-19.79775,29795,29991,196
100,0,blank,0,519.441,-25.02484,29991,30178,187
100,0,blank,0,460.655583333333,-23.0184666666667,30178,30374,196
100,0,blank,0,456.41385,-16.72705,30374,30572,198
100,0,blank,0,-350,-105,30664,30853,189
100,0,blank,0,209.129633333333,37.70505,30998,31179,181
100,0,blank,0,-350,-105,31245,31436,191
100,0,blank,0,-350,-105,31436,31624,188
100,0,blank,0,-350,-105,31624,31803,179
100,0,blank,0,-350,-105,31803,31836,33
100,8,"EntertheorderofthematrixA\n",72,154.07245,162.9098,31952,32012,60
100,0,blank,0,-350,-105,32045,32218,173
100,0,blank,0,-350,-105,32218,32409,191
100,0,blank,0,154.463733333333,101.26765,32454,32637,183
100,6,[,49,137.99748,117.43078,32637,32805,168
100,0,blank,0,206.851516666667,111.573633333333,32805,32996,191
100,0,blank,0,265.8896,112.4316,32996,33191,195
100,6,;,52,288.188233333333,117.453133333333,33191,33382,191
100,6,10,50,214.79975,114.044466666667,33382,33577,195
100,6,10,50,150.441966666667,126.927416666667,33577,33762,185
100,6,10,50,155.09532,131.14878,33762,33940,178
100,6,b,45,196.64005,128.604183333333,33940,34123,183
100,6,],51,281.540616666667,130.600383333333,34123,34312,189
100,6,10,50,224.114116666667,127.436733333333,34312,34502,190
100,0,blank,0,195.925633333333,113.8312,34502,34596,94
100,0,blank,0,-350,-105,34628,34825,197
100,0,blank,0,-350,-105,34825,35003,178
100,0,blank,0,377.4667,104.6022,35090,35176,86
100,7,row2,62,325.2255,136.2271,35176,35294,118
100,0,blank,0,318.8789,122.07585,35294,35473,179
100,7,column1,60,251.53862,137.31248,35473,35643,170
100,7,row1,58,146.318816666667,142.631033333333,35643,35828,185
100,7,row1,58,155.078416666667,152.522216666667,35828,36011,183
100,7,column1,60,210.59015,152.259283333333,36011,36195,184
100,0,blank,0,263.727933333333,156.200133333333,36195,36379,184
100,9,column1,83,285.9711,181.1942,36379,36411,32
100,0,blank,0,-350,-105,36472,36621,149
100,0,blank,0,-350,-105,36621,36675,54
100,0,blank,0,183.173833333333,231.621066666667,36867,37045,178
100,12,"EntertheelementsofmatrixA\n",104,136.34675,256.876766666667,37045,37234,189
100,13,i,117,171.312633333333,276.020433333333,37234,37421,187
100,12,"EntertheelementsofmatrixA\n",104,178.8047,250.0941,37421,37608,187
100,12,"EntertheelementsofmatrixA\n",104,178.959333333333,253.926166666667,37608,37701,93
100,11,column2,99,284.8948,231.627316666667,37733,37918,185
100,10,"EntertheorderofthematrixB\n",88,268.1481,212.0821,37918,37949,31
100,0,blank,0,187.234316666667,309.584716666667,37980,38165,185
100,0,blank,0,220.227233333333,309.081333333333,38165,38351,186
100,0,blank,0,241.8167,295.495,38351,38382,31
100,0,blank,0,-350,-105,38412,38601,189
100,0,blank,0,-350,-105,38601,38754,153
100,0,blank,0,-350,-105,38754,38925,171
100,0,blank,0,284.738916666667,413.666266666667,38958,39129,171
100,0,blank,0,401.573516666667,410.472133333333,39129,39310,181
100,0,blank,0,438.384983333333,380.27285,39310,39492,182
100,0,blank,0,447.8496,383.610133333333,39492,39582,90
100,21,),168,298.831866666667,456.391866666667,39612,39789,177
100,20,"EntertheelementsofmatrixB\n",153,277.28455,429.048283333333,39789,39965,176
100,0,blank,0,277.603833333333,419.085183333333,39965,40143,178
100,0,blank,0,237.824616666667,573.41665,40143,40326,183
100,29,row1,213,216.47875,632.61745,40326,40507,181
100,0,blank,0,263.4275,630.634883333333,40507,40689,182
100,29,;,214,250.5442,628.540216666667,40689,40872,183
100,29,;,214,246.332316666667,633.084966666667,40872,41054,182
100,0,blank,0,263.16765,632.22375,41054,41116,62
100,0,blank,0,-350,-105,41146,41329,183
100,7,column1,60,250.6088,154.6442,41379,41427,48
100,0,blank,0,251.022116666667,24.4103666666667,41498,41675,177
100,0,blank,0,257.504466666667,-30.2046166666667,41675,41860,185
100,0,blank,0,301.098366666667,-28.5692166666667,41860,42043,183
100,0,blank,0,333.202216666667,-15.1193666666667,42043,42225,182
100,0,blank,0,447.324683333333,-24.95525,42225,42409,184
100,0,blank,0,460.50665,-25.349375,42409,42532,123
100,0,blank,0,-350,-105,42562,42746,184
100,0,blank,0,-350,-105,42746,42922,176
100,0,blank,0,-350,-105,42922,42989,67
100,0,blank,0,552.542433333333,-21.3192333333333,43019,43190,171
100,0,blank,0,545.90815,-27.28925,43190,43252,62
100,6,10,50,261.87772,121.9714,43282,43437,155
100,0,blank,0,-350,-105,43468,43647,179
100,0,blank,0,-350,-105,43738,43847,109
100,0,blank,0,265.355066666667,86.2574,43950,44034,84
100,0,blank,0,371.15075,103.3486,44065,44246,181
100,0,blank,0,374.45245,89.3505,44246,44306,60
100,0,blank,0,209.714616666667,95.1085666666667,44337,44518,181
100,0,blank,0,179.934133333333,98.2642833333334,44518,44699,181
100,0,blank,0,238.568016666667,106.4137,44699,44881,182
100,0,blank,0,304.654616666667,109.16575,44881,45063,182
100,0,blank,0,348.958,105.521133333333,45063,45247,184
100,0,blank,0,381.331983333333,106.011166666667,45247,45433,186
100,0,blank,0,390.34245,98.7356,45433,45495,62
100,0,blank,0,289.355266666667,153.528033333333,45526,45712,186
100,7,comma,65,275.919366666667,147.514866666667,45712,45901,189
100,0,blank,0,-350,-105,45931,46104,173
100,0,blank,0,-350,-105,46104,46251,147
100,7,column1,60,245.714216666667,144.8617,46282,46466,184
100,0,blank,0,282.0991,150.26065,46466,46657,191
100,6,;,52,286.676166666667,133.8739,46657,46848,191
100,0,blank,0,287.641766666667,141.502883333333,46848,47031,183
100,0,blank,0,324.974833333333,109.482383333333,47031,47214,183
100,0,blank,0,406.513783333333,120.185033333333,47214,47398,184
100,0,blank,0,410.093016666667,123.8394,47398,47579,181
100,0,blank,0,416.778666666667,130.333866666667,47579,47763,184
100,0,blank,0,431.808466666667,124.27275,47763,47946,183
100,0,blank,0,984.927666666667,227.96115,48008,48200,192
100,0,blank,0,971.490666666667,242.924216666667,48200,48381,181
100,0,blank,0,968.7385,254.976516666667,48381,48565,184
100,0,blank,0,968.082666666667,262.851566666667,48565,48658,93
100,0,blank,0,-350,-105,48718,48826,108
100,0,blank,0,367.790116666667,117.442933333333,48929,49109,180
100,0,blank,0,374.8993,121.793016666667,49109,49295,186
100,6,[,49,138.2389,128.642283333333,49323,49507,184
100,0,blank,0,123.3548,143.686616666667,49507,49688,181
100,7,column1,60,207.163333333333,137.726366666667,49688,49870,182
100,6,10,50,214.245,125.4,49870,49900,30
100,0,blank,0,-350,-105,49961,50139,178
100,0,blank,0,-350,-105,50139,50327,188
100,0,blank,0,-350,-105,50327,50369,42
100,7,row1,58,153.2018,141.61025,50399,50509,110
100,7,column1,60,251.34996,140.90642,50540,50694,154
100,6,10,50,147.243916666667,127.830583333333,50725,50911,186
100,6,10,50,144.654233333333,130.844716666667,50911,51094,183
100,0,blank,0,191.250166666667,119.926583333333,51094,51279,185
100,6,[,49,205.097783333333,128.326883333333,51279,51466,187
100,6,b,45,201.372933333333,126.23615,51466,51654,188
100,7,column1,60,229.663333333333,142.845016666667,51654,51841,187
100,7,comma,65,279.33575,146.770666666667,51841,52028,187
100,7,row2,62,333.552416666667,136.3683,52028,52215,187
100,0,blank,0,370.64286,132.77454,52215,52368,153
100,0,blank,0,-350,-105,52399,52582,183
100,0,blank,0,-350,-105,52582,52778,196
100,0,blank,0,-350,-105,52778,52819,41
100,8,"EntertheorderofthematrixA\n",72,150.101533333333,174.3239,52867,53055,188
100,8,"EntertheorderofthematrixA\n",72,118.53665,161.94555,53055,53242,187
100,8,"EntertheorderofthematrixA\n",72,195.461916666667,170.614366666667,53242,53427,185
100,8,"EntertheorderofthematrixA\n",72,190.17385,166.368383333333,53427,53609,182
100,7,column1,60,250.872833333333,151.101283333333,53609,53790,181
100,7,column1,60,254.7029,150.157133333333,53790,53971,181
100,7,column1,60,244.135616666667,151.126833333333,53971,54155,184
100,8,"EntertheorderofthematrixA\n",72,241.524725,157.634675,54155,54275,120
100,0,blank,0,-350,-105,54306,54492,186
100,7,comma,65,279.107816666667,154.934933333333,54620,54804,184
100,0,blank,0,211.0178,178.506133333333,54804,54988,184
100,10,"EntertheorderofthematrixB\n",88,207.757566666667,212.613616666667,54988,55170,182
100,10,"EntertheorderofthematrixB\n",88,209.415866666667,216.713366666667,55170,55352,182
100,0,blank,0,222.49774,222.48314,55352,55506,154
100,9,column1,83,297.01935,192.49915,55506,55678,172
100,0,blank,0,-350,-105,55754,55948,194
100,8,"EntertheorderofthematrixA\n",72,207.487766666667,169.305383333333,55981,56168,187
100,8,"EntertheorderofthematrixA\n",72,184.185383333333,162.537033333333,56168,56351,183
100,7,comma,65,191.489616666667,155.552433333333,56351,56535,184
100,9,&,82,198.2428,199.801566666667,56535,56721,186
100,10,"EntertheorderofthematrixB\n",88,200.30475,210.343283333333,56721,56904,183
100,10,"EntertheorderofthematrixB\n",88,202.545066666667,216.273133333333,56904,57087,183
100,10,"EntertheorderofthematrixB\n",88,200.4549,217.037483333333,57087,57268,181
100,0,blank,0,205.382766666667,222.097283333333,57268,57452,184
100,9,&,82,202.241616666667,193.292033333333,57452,57636,184
100,9,&,82,200.17915,185.220325,57636,57761,125
100,0,blank,0,-350,-105,57790,57947,157
100,0,blank,0,-350,-105,57947,58003,56
100,9,comma,81,250.65574,179.90014,58141,58288,147
100,0,blank,0,-350,-105,58350,58531,181
100,0,blank,0,-350,-105,58531,58712,181
100,0,blank,0,-350,-105,58712,58896,184
100,0,blank,0,-350,-105,58896,59076,180
100,0,blank,0,-350,-105,59076,59257,181
100,0,blank,0,-350,-105,59257,59439,182
100,0,blank,0,-350,-105,59439,59611,172
100,0,blank,0,-350,-105,59611,59794,183
100,0,blank,0,-350,-105,59794,59980,186
100,0,blank,0,-350,-105,59980,60171,191
100,0,blank,0,-350,-105,60171,60350,179
100,0,blank,0,-350,-105,60350,60522,172
100,0,blank,0,-350,-105,60522,60706,184
100,0,blank,0,-350,-105,60706,60871,165
100,0,blank,0,-350,-105,60871,61037,166
100,0,blank,0,-350,-105,61037,61186,149
100,0,blank,0,-350,-105,61186,61360,174
100,0,blank,0,-350,-105,61360,61522,162
100,0,blank,0,-350,-105,61522,61705,183
100,0,blank,0,-350,-105,61705,61881,176
100,0,blank,0,-350,-105,61881,62028,147
100,0,blank,0,-350,-105,62028,62218,190
100,0,blank,0,-350,-105,62218,62391,173
100,0,blank,0,-350,-105,62391,62568,177
100,0,blank,0,-350,-105,62568,62746,178
100,0,blank,0,-350,-105,62746,62925,179
100,0,blank,0,-350,-105,62925,63111,186
100,0,blank,0,-350,-105,63111,63293,182
100,0,blank,0,-350,-105,63293,63473,180
100,0,blank,0,-350,-105,63473,63653,180
100,0,blank,0,-350,-105,63653,63827,174
100,0,blank,0,-350,-105,63827,64001,174
100,0,blank,0,-350,-105,64001,64186,185
100,0,blank,0,-350,-105,64186,64326,140
100,0,blank,0,267.58115,301.2198,64360,64451,91
100,0,blank,0,225.146725,292.919025,64496,64691,195
100,0,blank,0,161.44605,290.2932,64691,64767,76
100,0,blank,0,162.98385,381.0013,64809,64971,162
100,12,"EntertheelementsofmatrixA\n",104,272.833575,261.48175,65014,65209,195
100,11,column2,99,287.288033333333,231.427333333333,65209,65386,177
100,0,blank,0,233.336083333333,293.771,65386,65566,180
100,13,++,118,280.836183333333,275.8087,65566,65745,179
100,0,blank,0,336.025533333333,281.9137,65745,65923,178
100,15,j,131,342.348733333333,330.6618,65923,66108,185
100,0,blank,0,289.31155,308.457875,66108,66229,121
100,0,blank,0,-350,-105,66260,66416,156
100,0,blank,0,-350,-105,66416,66467,51
100,15,column1,129,251.717366666667,314.98545,66607,66779,172
100,15,j,131,211.593966666667,325.58275,66779,66962,183
100,0,blank,0,216.510316666667,318.550966666667,66962,67142,180
100,0,blank,0,242.8301,404.568883333333,67142,67320,178
100,0,blank,0,254.848516666667,344.880133333333,67320,67497,177
100,0,blank,0,189.146733333333,352.942166666667,67497,67677,180
100,17,"%d",137,221.4568,372.604666666667,67677,67854,177
100,0,blank,0,305.786866666667,387.728583333333,67854,68031,177
100,0,blank,0,401.9798,401.366083333333,68031,68209,178
100,0,blank,0,436.836875,398.0471,68209,68326,117
100,20,"EntertheelementsofmatrixB\n",153,270.31776,425.98154,68355,68501,146
100,0,blank,0,-350,-105,68531,68712,181
100,0,blank,0,-350,-105,68712,68875,163
100,0,blank,0,-350,-105,68875,68964,89
100,21,++,167,281.022542857143,454.180685714286,68993,69187,194
100,0,blank,0,319.422966666667,471.988883333333,69187,69363,176
100,23,j,180,336.683933333333,488.682766666667,69363,69539,176
100,0,blank,0,326.652316666667,520.06735,69539,69717,178
100,25,),196,324.18265,542.463066666667,69717,69894,177
100,0,blank,0,320.404216666667,530.7626,69894,70071,177
100,0,blank,0,322.11732,529.03128,70071,70218,147
100,0,blank,0,335.7571,350.80395,70249,70426,177
100,15,j,131,342.325166666667,325.992766666667,70426,70605,179
100,0,blank,0,325.03175,379.57735,70605,70666,61
100,25,],195,318.341966666667,531.5232,70696,70871,175
100,0,blank,0,347.996275,528.491625,70871,70988,117
100,0,blank,0,1005.039,277.198966666667,71047,71229,182
100,0,blank,0,1001.8055,273.4806,71229,71288,59
100,0,blank,0,-350,-105,71318,71499,181
100,0,blank,0,-350,-105,71499,71534,35
100,0,blank,0,279.0909,482.49496,71812,72000,188
100,0,blank,0,293.4284,531.318675,72000,72165,165
100,25,[,193,295.943625,534.0052,72165,72335,170
100,0,blank,0,275.3521,527.8805,72335,72379,44
100,29,;,214,250.075875,635.863825,72422,72586,164
100,0,blank,0,177.61526,642.23676,72586,72771,185
100,29,;,214,148.790816666667,636.298666666667,72771,72948,177
100,0,blank,0,146.8623,664.310275,72948,73066,118
100,0,blank,0,253.588066666667,720.769216666667,73095,73273,178
100,31,=,222,160.3555,681.07745,73273,73450,177
100,0,blank,0,149.1307,693.072733333333,73450,73538,88
100,0,blank,0,81.2227666666667,625.12385,73568,73747,179
100,29,for,205,51.44595,632.041083333333,73747,73925,178
100,0,blank,0,-350,-105,73984,74162,178
100,0,blank,0,-350,-105,74162,74302,140
100,28,"MATRIXAis\n",202,139.9822,597.6207,74658,74692,34
100,21,;,165,145.3843,444.0701,74723,74753,30
100,0,blank,0,130.60315,564.148425,74788,74917,129
100,0,blank,0,154.1641,560.1848,75012,75043,31
100,0,blank,0,151.1679,484.2136,75074,75136,62
100,25,"%d",186,196.05675,542.07385,75200,75261,61
100,0,blank,0,209.4015,590.2427,75291,75476,185
100,0,blank,0,221.4133,655.8807,75476,75506,30
100,0,blank,0,146.798866666667,95.7702666666667,75567,75748,181
100,0,blank,0,109.29692,80.46626,75748,75903,155
100,3,include,25,57.34935,50.47995,75903,76060,157
100,0,blank,0,55.5213,46.0138,76060,76120,60
100,0,blank,0,-350,-105,76244,76331,87
100,0,blank,0,114.230833333333,1.5418,76465,76542,77
100,0,blank,0,900.2338,152.68426,76633,76786,153
100,0,blank,0,968.852166666667,248.041766666667,76816,76997,181
100,0,blank,0,966.331666666667,254.049016666667,76997,77176,179
100,0,blank,0,967.1135,255.6106,77176,77236,60
101,0,blank,0,172.9989,26.9845666666667,84290,84470,180
101,0,blank,0,201.0384,-22.5791,84470,84500,30
101,0,blank,0,-350,-105,84530,84662,132
101,0,blank,0,82.0619333333333,27.7441833333333,84800,84973,173
101,0,blank,0,70.2328,32.63885,84973,85155,182
101,0,blank,0,113.30415,38.9183666666667,85155,85338,183
101,0,blank,0,149.4488,31.4301333333333,85338,85518,180
101,0,blank,0,151.09265,30.8612666666667,85518,85703,185
101,0,blank,0,153.0556,32.9396833333333,85703,85886,183
101,0,blank,0,153.224566666667,23.0232833333333,85886,86072,186
101,0,blank,0,166.394166666667,42.4514833333333,86072,86254,182
101,0,blank,0,178.689733333333,32.52675,86254,86440,186
101,0,blank,0,170.0303,45.968,86440,86471,31
101,0,blank,0,278.77942,480.29976,86533,86688,155
101,0,blank,0,319.298016666667,-103.901866666667,86749,86935,186
101,0,blank,0,323.197275,-103.898375,86935,87060,125
101,0,blank,0,-350,-105,87121,87196,75
101,0,blank,0,131.0407,102.6566,87235,87292,57
101,28,"MATRIXAis\n",202,126.94005,67.7548,87363,87536,173
101,0,blank,0,124.6869,20.2222,87536,87566,30
101,0,blank,0,-350,-105,87627,87786,159
101,0,blank,0,145.6836,-0.977599999999995,87825,87877,52
101,0,blank,0,168.774566666667,20.168,87938,88110,172
101,0,blank,0,179.87145,26.13,88110,88291,181
101,0,blank,0,191.078333333333,29.2366333333333,88291,88474,183
101,0,blank,0,192.4009,23.68145,88474,88657,183
101,0,blank,0,160.186733333333,40.9643833333333,88657,88840,183
101,0,blank,0,190.167966666667,48.3606333333333,88840,89024,184
101,0,blank,0,163.429666666667,99.26035,89024,89206,182
101,0,blank,0,151.26845,131.211283333333,89206,89392,186
101,31,<,226,230.6516,127.638283333333,89392,89574,182
101,31,j,229,210.259416666667,125.43385,89574,89754,180
101,0,blank,0,197.56015,131.98975,89754,89814,60
101,0,blank,0,-350,-105,89845,90028,183
101,0,blank,0,221.156083333333,128.689333333333,90177,90354,177
101,0,blank,0,267.261833333333,141.246483333333,90354,90539,185
101,29,),217,299.79765,88.32905,90539,90601,62
101,0,blank,0,-350,-105,90631,90737,106
101,0,blank,0,-350,-105,90880,91040,160
101,0,blank,0,186.1789,158.1586,91097,91157,60
101,33,"%3d",235,196.493316666667,163.5912,91217,91392,175
101,0,blank,0,200.986083333333,147.417516666667,91392,91576,184
101,0,blank,0,201.488116666667,149.3252,91576,91762,186
101,0,blank,0,197.75075,147.4711,91762,91946,184
101,0,blank,0,200.055633333333,137.754516666667,91946,92131,185
101,0,blank,0,190.355116666667,142.747733333333,92131,92315,184
101,0,blank,0,198.677616666667,151.644966666667,92315,92497,182
101,0,blank,0,195.874683333333,140.5464,92497,92681,184
101,31,column1,227,250.080883333333,137.041966666667,92681,92864,183
101,31,column1,227,265.653966666667,133.651233333333,92864,93049,185
101,31,column1,227,276.0522,134.5078,93049,93080,31
101,0,blank,0,-350,-105,93140,93321,181
101,0,blank,0,-350,-105,93321,93484,163
101,31,column1,227,250.14615,131.20075,93513,93687,174
101,31,j,229,206.7328,135.620483333333,93687,93872,185
101,0,blank,0,190.96255,139.545516666667,93872,94054,182
101,0,blank,0,191.204733333333,145.1618,94054,94236,182
101,0,blank,0,206.4971,143.229933333333,94236,94417,181
101,0,blank,0,236.789883333333,136.386183333333,94417,94597,180
101,0,blank,0,202.8205,153.634383333333,94597,94778,181
101,0,blank,0,199.6088,152.135733333333,94778,94960,182
101,0,blank,0,207.1691,150.7233,94960,94991,31
101,0,blank,0,-350,-105,95022,95179,157
101,0,blank,0,-350,-105,95179,95235,56
101,31,;,228,190.930383333333,132.285383333333,95370,95540,170
101,31,j,229,204.1294,128.378683333333,95540,95726,186
101,31,j,229,203.3315,118.830183333333,95726,95912,186
101,0,blank,0,195.292633333333,90.2072,95912,96094,182
101,28,"MATRIXAis\n",202,184.706416666667,57.5850666666667,96094,96279,185
101,28,"MATRIXAis\n",202,180.03475,58.6642,96279,96377,98
101,0,blank,0,134.0641,49.886,96377,96494,117
101,28,"MATRIXAis\n",202,132.9956,52.0379,96494,96686,192
101,0,blank,0,104.439866666667,84.8811,96686,96878,192
101,28,printf,200,78.7272666666667,70.2802166666667,96878,97061,183
101,28,printf,200,86.872425,58.60425,97061,97183,122
101,0,blank,0,-350,-105,97214,97345,131
101,0,blank,0,997.167,334.1161,97371,97397,26
101,0,blank,0,949.925833333333,419.24345,97482,97674,192
101,0,blank,0,957.304166666667,387.107883333333,97674,97861,187
101,0,blank,0,959.128166666667,381.217366666667,97861,98044,183
101,0,blank,0,971.4395,370.678966666667,98044,98226,182
101,0,blank,0,970.218166666667,366.920916666667,98226,98409,183
101,0,blank,0,962.983,366.75665,98409,98470,61
101,0,blank,0,-350,-105,98531,98664,133
101,0,blank,0,145.30984,154.1911,98763,98905,142
101,0,blank,0,151.605833333333,29.1711666666667,98934,99117,183
101,0,blank,0,161.5194,46.6023,99117,99147,30
102,0,blank,0,-350,-105,101483,101513,30
102,0,blank,0,962.958,66.478125,101635,101749,114
102,0,blank,0,81.8522833333333,116.124933333333,101841,102027,186
102,0,blank,0,77.8022166666667,90.16565,102027,102212,185
102,0,blank,0,75.3633666666666,87.4547333333333,102212,102394,182
102,0,blank,0,69.8001833333333,85.8948666666667,102394,102575,181
102,0,blank,0,62.8778333333333,84.4408666666667,102575,102756,181
102,0,blank,0,57.9761833333333,85.3487666666667,102756,102936,180
102,0,blank,0,73.0896166666667,80.4735333333334,102936,103117,181
102,0,blank,0,75.62445,90.2639166666667,103117,103301,184
102,0,blank,0,73.62635,84.4917,103301,103481,180
102,0,blank,0,72.1686,80.3801333333333,103481,103573,92
102,0,blank,0,-350,-105,103604,103774,170
102,0,blank,0,66.8542166666667,86.7400166666667,103899,104071,172
102,0,blank,0,76.3841,89.4461166666667,104071,104252,181
102,0,blank,0,74.1095166666667,83.9261333333333,104252,104431,179
102,0,blank,0,110.425133333333,78.6415166666667,104431,104611,180
102,0,blank,0,161.9099,81.1355666666667,104611,104792,181
102,0,blank,0,184.94545,74.8176333333333,104792,104975,183
102,0,blank,0,171.4423,69.5831666666667,104975,105156,181
102,0,blank,0,108.4917,78.8689333333333,105156,105337,181
102,0,blank,0,68.943325,86.144025,105337,105460,123
102,0,blank,0,-350,-105,105490,105621,131
102,0,blank,0,178.42575,81.0331,105714,105886,172
102,0,blank,0,175.0227,82.4710666666667,105886,105977,91
102,0,blank,0,51.11245,99.9785666666667,106007,106187,180
102,0,blank,0,66.4549666666667,93.7643833333333,106187,106367,180
102,6,10,50,116.602266666667,107.6578,106367,106547,180
102,6,[,49,102.0974,103.2241,106547,106579,32
102,8,"EntertheorderofthematrixA\n",72,217.8166,144.826916666667,106609,106788,179
102,9,&,82,201.873416666667,179.7378,106788,106969,181
102,10,"EntertheorderofthematrixB\n",88,180.5591,204.29585,106969,107029,60
102,0,blank,0,-350,-105,107089,107269,180
102,0,blank,0,-350,-105,107269,107364,95
102,0,blank,0,234.989514285714,336.311928571429,107398,107596,198
102,0,blank,0,213.303783333333,367.338,107596,107776,180
102,23,0,174,178.861433333333,483.750633333333,107776,107957,181
102,25,scanf,184,166.981716666667,524.68475,107957,108138,181
102,0,blank,0,185.38155,556.246275,108138,108261,123
102,0,blank,0,986.6925,221.98215,108352,108539,187
102,0,blank,0,967.354666666667,207.752933333333,108539,108722,183
102,0,blank,0,962.7976,209.81794,108722,108873,151
102,0,blank,0,-350,-105,108904,109091,187
102,0,blank,0,-350,-105,109091,109252,161
103,0,blank,0,-350,-105,111805,111866,61
103,0,blank,0,162.908766666667,201.553983333333,111992,112170,178
103,0,blank,0,166.410183333333,176.844066666667,112170,112360,190
103,0,blank,0,179.353533333333,163.006983333333,112360,112544,184
103,0,blank,0,192.028833333333,161.250783333333,112544,112727,183
103,0,blank,0,193.521366666667,167.092833333333,112727,112911,184
103,31,column1,227,246.329766666667,155.324116666667,112911,113095,184
103,31,column1,227,270.813483333333,155.417916666667,113095,113277,182
103,31,column1,227,266.57045,154.4656,113277,113338,61
103,0,blank,0,-350,-105,113369,113552,183
103,0,blank,0,-350,-105,113552,113629,77
103,0,blank,0,171.447683333333,168.07555,113664,113833,169
103,31,=,222,157.5024,148.581133333333,113833,114015,182
103,31,0,223,178.324716666667,155.217616666667,114015,114195,180
103,0,blank,0,182.4851,168.05745,114195,114373,178
103,0,blank,0,194.434633333333,157.760066666667,114373,114554,181
103,0,blank,0,237.711,148.981333333333,114554,114738,184
103,31,column1,227,261.770433333333,140.024616666667,114738,114927,189
103,0,blank,0,262.120316666667,165.278266666667,114927,115112,185
103,0,blank,0,229.1661,159.4946,115112,115296,184
103,0,blank,0,198.993875,162.955175,115296,115417,121
103,0,blank,0,-350,-105,115448,115616,168
103,0,blank,0,197.5581,140.2563,115663,115702,39
103,31,=,222,159.4574,142.916716666667,115768,115945,177
103,33,printf,233,137.0114,194.164183333333,115945,116136,191
103,0,blank,0,116.366583333333,151.6629,116136,116322,186
103,34,},246,88.5837833333333,205.015966666667,116322,116505,183
103,35,printf,247,91.44255,241.021416666667,116505,116688,183
103,28,(,201,105.287,90.48325,116743,116930,187
103,28,"MATRIXAis\n",202,144.7203,75.9035333333333,116930,117126,196
103,0,blank,0,182.17296,66.94308,117126,117277,151
103,0,blank,0,-350,-105,117308,117490,182
103,0,blank,0,-350,-105,117490,117652,162
103,0,blank,0,175.843133333333,110.960616666667,117681,117853,172
103,31,j,229,139.105016666667,137.105583333333,117853,118038,185
103,31,j,229,134.721816666667,156.120866666667,118038,118224,186
103,31,0,223,174.148116666667,145.393666666667,118224,118411,187
103,0,blank,0,192.66085,129.668983333333,118411,118597,186
103,0,blank,0,174.99095,135.4318,118597,118783,186
103,0,blank,0,152.787633333333,124.750166666667,118783,118966,183
103,29,row1,213,222.826866666667,112.878,118966,119150,184
103,0,blank,0,238.797366666667,113.0898,119150,119334,184
103,0,blank,0,203.63565,113.941483333333,119334,119517,183
103,0,blank,0,209.617666666667,116.2481,119517,119703,186
103,0,blank,0,167.845883333333,113.213716666667,119703,119887,184
103,0,blank,0,150.10735,126.686025,119887,120007,120
103,0,blank,0,-350,-105,120038,120220,182
103,0,blank,0,-350,-105,120220,120313,93
103,28,"MATRIXAis\n",202,212.577216666667,83.86525,120340,120516,176
103,29,row1,213,234.333116666667,111.499666666667,120516,120702,186
103,0,blank,0,253.01755,116.714883333333,120702,120886,184
103,28,"MATRIXAis\n",202,188.329966666667,77.7793333333333,120886,121070,184
103,28,"MATRIXAis\n",202,168.7266,77.039,121070,121251,181
103,28,"MATRIXAis\n",202,138.476366666667,74.7236833333333,121251,121434,183
103,28,"MATRIXAis\n",202,121.055816666667,71.1107,121434,121617,183
103,28,"MATRIXAis\n",202,125.5742,73.7004166666667,121617,121800,183
103,28,(,201,107.0952,79.1413,121800,121830,30
103,0,blank,0,-350,-105,121860,122017,157
103,0,blank,0,183.36945,66.1806833333333,122157,122339,182
103,28,"MATRIXAis\n",202,193.170866666667,70.0935666666667,122339,122522,183
103,28,"MATRIXAis\n",202,171.968216666667,77.2536333333333,122522,122703,181
103,28,"MATRIXAis\n",202,152.577533333333,78.3391666666667,122703,122886,183
103,28,"MATRIXAis\n",202,155.950716666667,72.0497166666667,122886,123069,183
103,29,row1,213,206.94865,97.2624833333333,123069,123251,182
103,29,row1,213,213.426766666667,102.108666666667,123251,123432,181
103,28,"MATRIXAis\n",202,133.955433333333,76.54385,123432,123613,181
103,28,"MATRIXAis\n",202,120.18705,77.5485833333333,123613,123794,181
103,29,row1,213,224.68825,102.19595,123794,123977,183
103,0,blank,0,233.733416666667,117.3026,123977,124164,187
103,0,blank,0,194.559066666667,139.44515,124164,124350,186
103,0,blank,0,174.1107,170.83875,124350,124411,61
103,0,blank,0,-350,-105,124442,124626,184
103,0,blank,0,-350,-105,124626,124717,91
103,0,blank,0,200.60305,168.290933333333,124752,124924,172
103,33,printf,233,154.079483333333,200.97265,124924,125106,182
103,0,blank,0,138.739,220.433766666667,125106,125288,182
103,0,blank,0,112.07305,248.358766666667,125288,125472,184
103,35,printf,247,97.2895333333333,230.704433333333,125472,125660,188
103,0,blank,0,-350,-105,125690,125852,162
103,0,blank,0,123.5818,206.6061,125906,125966,60
103,0,blank,0,190.762766666667,170.016316666667,126033,126208,175
103,0,blank,0,183.99195,162.00135,126208,126394,186
103,0,blank,0,-350,-105,126425,126611,186
103,0,blank,0,-350,-105,126611,126795,184
103,0,blank,0,125.618266666667,258.56745,126825,126994,169
103,37,"MATRIXBis\n",255,142.534983333333,270.2497,126994,127178,184
103,0,blank,0,176.985466666667,267.461133333333,127178,127361,183
103,38,i,268,173.166216666667,309.147783333333,127361,127543,182
103,0,blank,0,168.610283333333,349.932216666667,127543,127724,181
103,0,blank,0,182.332233333333,377.357766666667,127724,127907,183
103,42,"%3d",288,209.8345,387.90495,127907,128092,185
103,0,blank,0,225.503016666667,401.349266666667,128092,128277,185
103,44,"\n",302,154.589933333333,436.323316666667,128277,128460,183
103,44,printf,300,137.90595,442.219966666667,128460,128644,184
103,0,blank,0,101.8311,448.196283333333,128644,128826,182
103,44,printf,300,105.334166666667,435.721866666667,128826,128920,94
103,0,blank,0,-350,-105,128951,129135,184
103,0,blank,0,-350,-105,129135,129317,182
103,0,blank,0,-350,-105,129317,129511,194
103,0,blank,0,-350,-105,129511,129705,194
103,0,blank,0,-350,-105,129705,129886,181
103,0,blank,0,-350,-105,129886,130065,179
103,0,blank,0,-350,-105,130065,130246,181
103,0,blank,0,-350,-105,130246,130337,91
103,0,blank,0,-350,-105,130337,130542,205
103,0,blank,0,-350,-105,130542,130751,209
103,0,blank,0,-350,-105,130751,131102,351
103,0,blank,0,-350,-105,131102,131327,225
103,0,blank,0,-350,-105,131327,131525,198
103,0,blank,0,-350,-105,131525,131694,169
103,0,blank,0,-350,-105,131694,131879,185
103,0,blank,0,-350,-105,131879,132074,195
103,0,blank,0,-350,-105,132074,132250,176
103,0,blank,0,-350,-105,132250,132447,197
103,0,blank,0,-350,-105,132447,132476,29
103,0,blank,0,-350,-105,132476,132735,259
103,0,blank,0,-350,-105,132735,132999,264
103,0,blank,0,-350,-105,132999,133412,413
103,0,blank,0,-350,-105,133412,133592,180
103,0,blank,0,-350,-105,133592,133768,176
103,0,blank,0,-350,-105,133768,133946,178
103,0,blank,0,-350,-105,133946,134083,137
103,0,blank,0,-350,-105,134083,134215,132
103,0,blank,0,284.4562,445.2282,134759,134785,26
103,0,blank,0,-350,-105,134850,135038,188
103,0,blank,0,-350,-105,135038,135216,178
103,0,blank,0,-350,-105,135216,135381,165
103,0,blank,0,-350,-105,135381,135571,190
103,0,blank,0,-350,-105,135571,135715,144
103,42,"%3d",288,217.3425,381.6927,135781,135864,83
103,0,blank,0,232.47096,372.4811,135928,136107,179
103,0,blank,0,171.112633333333,447.823266666667,136107,136271,164
103,46,Comparing,308,147.098175,470.210625,136271,136433,162
103,0,blank,0,243.307766666667,423.182366666667,136433,136631,198
103,0,blank,0,250.05545,436.42415,136631,136689,58
103,0,blank,0,351.473383333333,449.755783333333,136718,136893,175
103,0,blank,0,358.121883333333,431.897633333333,136893,137067,174
103,0,blank,0,341.6279,448.261,137067,137120,53
104,40,column2,280,247.3216,102.377466666667,143505,143592,87
104,0,blank,0,-350,-105,143621,143776,155
104,0,blank,0,95.1754833333333,146.547883333333,143886,144056,170
104,0,blank,0,89.9728166666667,154.9188,144056,144234,178
104,41,{,285,91.8743,126.447083333333,144234,144415,181
104,37,(,254,106.533916666667,47.7106666666667,144415,144594,179
104,0,blank,0,122.91605,6.92393333333334,144594,144777,183
104,0,blank,0,183.121416666667,13.2241666666667,144777,144956,179
104,0,blank,0,194.99315,26.16435,144956,145138,182
104,0,blank,0,247.543433333333,88.5399833333333,145138,145322,184
104,40,column2,280,254.681666666667,107.36095,145322,145505,183
104,40,column2,280,244.27935,101.825666666667,145505,145686,181
104,0,blank,0,239.456833333333,109.726466666667,145686,145865,179
104,40,<,279,232.587425,110.4945,145865,145985,120
104,0,blank,0,-350,-105,146016,146197,181
104,0,blank,0,242.423166666667,95.78705,146294,146464,170
104,40,column2,280,245.7158,108.900116666667,146464,146646,182
104,0,blank,0,207.77355,127.944383333333,146646,146826,180
104,42,printf,286,159.20915,150.389783333333,146826,147010,184
104,0,blank,0,215.824833333333,117.1321,147010,147194,184
104,0,blank,0,239.25772,116.0883,147194,147351,157
104,42,printf,286,147.574933333333,155.6163,147385,147568,183
104,0,blank,0,233.453333333333,105.708083333333,147568,147748,180
104,0,blank,0,242.83125,116.138783333333,147748,147930,182
104,0,blank,0,202.4745,108.753416666667,147930,148112,182
104,0,blank,0,192.47476,117.96148,148112,148267,155
104,0,blank,0,-350,-105,148298,148471,173
104,40,(,273,132.185183333333,107.575866666667,148599,148773,174
104,0,blank,0,124.683116666667,113.91535,148773,148959,186
104,38,i,268,94.5070333333333,60.36815,148959,149144,185
104,37,printf,253,73.6020666666667,39.0524333333333,149144,149238,94
104,40,column2,280,245.04385,94.6458,149268,149452,184
104,40,column2,280,257.21875,108.035516666667,149452,149636,184
104,0,blank,0,233.998466666667,94.0433666666667,149636,149822,186
104,0,blank,0,196.9815,104.436916666667,149822,150006,184
104,40,0,276,181.0563,99.9934,150006,150037,31
104,0,blank,0,-350,-105,150098,150282,184
104,0,blank,0,-350,-105,150282,150467,185
104,0,blank,0,-350,-105,150467,150513,46
104,46,Comparing,308,108.130616666667,231.975633333333,150545,150720,175
104,0,blank,0,158.070583333333,223.42575,150720,150905,185
104,0,blank,0,116.203366666667,222.8801,150905,151090,185
104,0,blank,0,248.37665,216.442616666667,151090,151274,184
104,0,blank,0,246.717083333333,207.435116666667,151274,151457,183
104,0,blank,0,228.2072,217.071383333333,151457,151639,182
104,0,blank,0,175.52675,218.02905,151639,151825,186
104,46,two,309,195.27755,230.46135,151825,152008,183
104,0,blank,0,195.509166666667,223.431266666667,152008,152195,187
104,0,blank,0,200.8593,220.0472,152195,152226,31
104,0,blank,0,-350,-105,152257,152452,195
104,0,blank,0,202.0367,210.419533333333,152588,152770,182
104,0,blank,0,236.331683333333,204.02505,152770,152961,191
104,0,blank,0,271.548833333333,217.3411,152961,153147,186
104,0,blank,0,258.793983333333,214.991183333333,153147,153333,186
104,0,blank,0,259.066933333333,208.901466666667,153333,153518,185
104,0,blank,0,328.200933333333,207.80245,153518,153702,184
104,0,blank,0,340.6339,193.77345,153702,153762,60
104,0,blank,0,-350,-105,153822,154008,186
104,0,blank,0,-350,-105,154008,154152,144
104,0,blank,0,258.041185714286,209.167671428571,154184,154381,197
104,0,blank,0,221.604733333333,195.3068,154381,154568,187
104,0,blank,0,-350,-105,154598,154756,158
104,0,blank,0,81.7786666666667,263.915,154892,155068,176
104,0,blank,0,132.849383333333,253.083516666667,155068,155257,189
104,0,blank,0,210.999016666667,251.090433333333,155257,155447,190
104,0,blank,0,291.609116666667,248.539083333333,155447,155629,182
104,0,blank,0,238.324283333333,249.961733333333,155629,155811,182
104,0,blank,0,201.468325,249.341925,155811,155933,122
104,0,blank,0,-350,-105,155964,156122,158
104,0,blank,0,-350,-105,156122,156172,50
104,46,matrices,310,244.246066666667,240.3885,156202,156375,173
104,0,blank,0,197.57115,257.715766666667,156375,156562,187
104,0,blank,0,143.591483333333,259.068433333333,156562,156749,187
104,49,printf,326,101.10736,283.07534,156749,156905,156
104,0,blank,0,272.310733333333,253.864766666667,156936,157124,188
104,0,blank,0,271.744533333333,251.200833333333,157124,157309,185
104,0,blank,0,322.1711,241.61314,157309,157464,155
104,46,for,311,334.409,240.1389,157464,157515,51
104,0,blank,0,157.2254,260.3839,157606,157703,97
104,0,blank,0,147.2161,303.0038,157703,157815,112
104,0,blank,0,-350,-105,157874,158053,179
104,0,blank,0,165.2962,319.810783333333,158191,158363,172
104,50,i,341,160.324666666667,293.6488,158363,158453,90
104,0,blank,0,97.88145,465.2273,158484,158664,180
104,0,blank,0,72.6118333333333,540.121283333333,158664,158844,180
104,0,blank,0,66.9688,539.94,158844,158874,30
104,0,blank,0,178.3104,452.623966666667,158904,159086,182
104,0,blank,0,188.215316666667,442.387383333333,159086,159264,178
104,0,blank,0,192.71975,426.668416666667,159264,159443,179
104,0,blank,0,181.374083333333,378.076116666667,159443,159627,184
104,0,blank,0,198.626866666667,375.751533333333,159627,159809,182
104,0,blank,0,244.80565,372.726833333333,159809,159989,180
104,0,blank,0,288.330283333333,370.301733333333,159989,160166,177
104,0,blank,0,219.869633333333,419.563816666667,160166,160349,183
104,55,{,377,210.484175,432.24495,160349,160470,121
104,0,blank,0,-350,-105,160501,160651,150
104,0,blank,0,-350,-105,160651,160740,89
104,55,{,377,206.028233333333,430.784716666667,160770,160948,178
104,0,blank,0,211.630783333333,404.7251,160948,161129,181
104,0,blank,0,205.7242,405.183366666667,161129,161312,183
104,0,blank,0,196.900333333333,414.421033333333,161312,161492,180
104,0,blank,0,208.435116666667,417.349066666667,161492,161682,190
104,56,flag,378,217.273416666667,427.562583333333,161682,161862,180
104,0,blank,0,234.398866666667,372.045516666667,161862,162040,178
104,0,blank,0,237.719866666667,374.28125,162040,162218,178
104,0,blank,0,177.9934,319.5432,162218,162400,182
104,0,blank,0,165.780616666667,297.222816666667,162400,162583,183
104,49,printf,326,142.2939,289.059,162583,162763,180
104,0,blank,0,118.63114,263.38422,162763,162915,152
104,0,blank,0,-350,-105,162944,163050,106
104,44,printf,300,86.1884666666667,200.925016666667,163141,163312,171
104,0,blank,0,179.718083333333,434.518383333333,163343,163524,181
104,55,{,377,203.715966666667,431.671,163524,163705,181
104,54,if,359,197.222016666667,392.381266666667,163705,163887,182
104,0,blank,0,197.360866666667,377.367633333333,163887,164068,181
104,54,[,373,224.644633333333,380.225516666667,164068,164248,180
104,0,blank,0,278.040425,376.307125,164248,164370,122
104,0,blank,0,-350,-105,164401,164584,183
104,0,blank,0,-350,-105,164584,164780,196
104,52,j,355,196.60125,339.2968,164808,164857,49
104,0,blank,0,219.023933333333,378.680783333333,164887,165070,183
104,54,[,373,262.462633333333,385.64535,165070,165252,182
104,0,blank,0,200.065133333333,372.202666666667,165252,165433,181
104,0,blank,0,186.937183333333,374.04045,165433,165617,184
104,0,blank,0,209.3041,369.077383333333,165617,165798,181
104,0,blank,0,218.9596,331.7177,165798,165858,60
104,0,blank,0,-350,-105,165887,166070,183
104,0,blank,0,-350,-105,166070,166227,157
104,0,blank,0,-350,-105,166227,166272,45
104,52,j,355,267.467728571429,344.626057142857,166300,166498,198
104,0,blank,0,284.8452,371.2013,166498,166684,186
104,54,j,374,265.219916666667,379.295133333333,166684,166867,183
104,54,[,373,232.216116666667,388.35075,166867,167049,182
104,0,blank,0,204.03495,421.376216666667,167049,167229,180
104,0,blank,0,193.987233333333,412.096,167229,167407,178
104,0,blank,0,191.31104,414.99228,167407,167558,151
104,0,blank,0,63.2398,542.159916666667,167588,167770,182
104,0,blank,0,35.46496,577.6641,167770,167922,152
104,57,;,383,170.34782,469.73604,167952,168113,161
104,0,blank,0,-350,-105,168143,168302,159
104,0,blank,0,-350,-105,168302,168355,53
104,0,blank,0,212.0081,423.6411,168503,168694,191
104,54,if,359,199.93475,381.8039,168694,168888,194
104,0,blank,0,194.553316666667,328.909366666667,168888,169074,186
104,0,blank,0,232.497516666667,323.81675,169074,169255,181
104,0,blank,0,236.8843,334.63065,169255,169437,182
104,0,blank,0,150.743733333333,364.012833333333,169437,169618,181
104,0,blank,0,148.80925,378.35075,169618,169678,60
104,0,blank,0,-350,-105,169708,169890,182
104,0,blank,0,-350,-105,169890,169996,106
104,0,blank,0,185.11955,319.246925,170022,170132,110
104,54,if,359,177.345883333333,388.45415,170163,170346,183
104,54,(,360,208.984916666667,395.008516666667,170346,170526,180
104,0,blank,0,260.628066666667,369.025433333333,170526,170708,182
104,0,blank,0,286.559583333333,367.260433333333,170708,170887,179
104,0,blank,0,147.90395,377.727083333333,170917,171098,181
104,52,),357,142.334316666667,371.087533333333,171098,171280,182
104,0,blank,0,141.13215,408.00365,171280,171461,181
104,0,blank,0,142.892383333333,439.911833333333,171461,171642,181
104,0,blank,0,148.87095,423.977366666667,171642,171823,181
104,0,blank,0,150.287483333333,404.952266666667,171823,172007,184
104,0,blank,0,118.239066666667,474.76605,172007,172191,184
104,0,blank,0,108.124766666667,487.373783333333,172191,172379,188
104,0,blank,0,110.787566666667,369.98555,172410,172595,185
104,0,blank,0,124.451483333333,362.090583333333,172595,172779,184
104,52,for,345,167.976016666667,350.909016666667,172779,172963,184
104,0,blank,0,148.97665,308.34755,172963,173149,186
104,50,(,332,140.13805,309.567425,173149,173271,122
104,0,blank,0,-350,-105,173303,173410,107
104,49,"Matricescanbecompared\n",328,230.4755,281.9055,173457,173517,60
104,50,row1,339,261.34635,304.661,173591,173771,180
104,0,blank,0,268.706783333333,318.427416666667,173771,173956,185
104,52,<,352,288.01705,335.304866666667,173956,174141,185
104,52,0,349,227.509466666667,341.7284,174141,174327,186
104,52,j,355,200.01015,335.9891,174327,174508,181
104,0,blank,0,183.731466666667,339.556483333333,174508,174690,182
104,52,(,346,179.1821,341.2767,174690,174720,30
104,0,blank,0,-350,-105,174780,174964,184
104,0,blank,0,-350,-105,174964,175118,154
104,0,blank,0,-350,-105,175118,175165,47
104,49,"Matricescanbecompared\n",328,221.22175,270.090283333333,175194,175366,172
104,49,"Matricescanbecompared\n",328,209.5098,283.472466666667,175366,175549,183
104,49,"Matricescanbecompared\n",328,238.8541,282.028,175549,175729,180
104,49,"Matricescanbecompared\n",328,212.321766666667,285.194516666667,175729,175912,183
104,0,blank,0,148.05875,297.6972,175912,176096,184
104,50,i,341,161.622983333333,296.527933333333,176096,176280,184
104,49,"Matricescanbecompared\n",328,188.0804,280.71265,176280,176464,184
104,49,"Matricescanbecompared\n",328,181.77165,270.9222,176464,176646,182
104,0,blank,0,163.835416666667,217.59125,176646,176830,184
104,0,blank,0,159.766516666667,221.17445,176830,177013,183
104,0,blank,0,127.983883333333,224.3042,177013,177196,183
104,46,Comparing,308,110.3752,233.068966666667,177196,177381,185
104,0,blank,0,205.115716666667,268.827783333333,177381,177566,185
104,49,"Matricescanbecompared\n",328,225.495233333333,282.1126,177566,177749,183
104,0,blank,0,-350,-105,177810,177998,188
104,0,blank,0,-350,-105,177998,178047,49
104,0,blank,0,-350,-105,178047,178286,239
104,0,blank,0,-350,-105,178286,178479,193
104,0,blank,0,-350,-105,178479,178667,188
104,50,row1,339,281.038528571429,293.594557142857,178695,178890,195
104,0,blank,0,379.1091,296.43195,178890,179073,183
104,0,blank,0,378.368483333333,294.630583333333,179073,179255,182
104,0,blank,0,386.6401,299.2619,179255,179375,120
104,0,blank,0,-350,-105,179434,179617,183
104,0,blank,0,-350,-105,179617,179815,198
104,0,blank,0,-350,-105,179815,179863,48
104,0,blank,0,316.542985714286,330.119485714286,179892,180084,192
104,0,blank,0,298.709933333333,313.163566666667,180084,180262,178
104,50,;,340,312.9379,300.438483333333,180262,180441,179
104,50,;,340,308.80145,302.110133333333,180441,180622,181
104,0,blank,0,350.717366666667,297.688683333333,180622,180801,179
104,0,blank,0,345.534333333333,297.708433333333,180801,180983,182
104,50,row1,339,275.242466666667,305.559133333333,180983,181166,183
104,50,row1,339,259.0801,303.224883333333,181166,181352,186
104,50,<,338,244.34356,307.21826,181352,181508,156
104,0,blank,0,-350,-105,181540,181722,182
104,0,blank,0,241.001,266.8687,181850,182022,172
104,0,blank,0,244.256075,251.737075,182022,182145,123
104,0,blank,0,-350,-105,182176,182358,182
104,0,blank,0,-350,-105,182358,182538,180
104,0,blank,0,-350,-105,182538,182711,173
104,0,blank,0,-350,-105,182711,182897,186
104,0,blank,0,-350,-105,182897,183072,175
104,0,blank,0,-350,-105,183072,183269,197
104,0,blank,0,-350,-105,183269,183390,121
104,0,blank,0,-350,-105,183390,183581,191
104,0,blank,0,-350,-105,183581,183606,25
104,0,blank,0,-350,-105,183606,183903,297
104,0,blank,0,-350,-105,183903,184191,288
104,0,blank,0,-350,-105,184191,184376,185
104,0,blank,0,-350,-105,184376,184523,147
104,0,blank,0,-350,-105,184523,184676,153
104,0,blank,0,-350,-105,184676,184952,276
104,0,blank,0,-350,-105,184952,185124,172
104,0,blank,0,-350,-105,185124,185216,92
104,0,blank,0,-350,-105,185216,185361,145
104,0,blank,0,-350,-105,185361,185554,193
104,0,blank,0,-350,-105,185554,185831,277
104,0,blank,0,-350,-105,185831,186010,179
104,0,blank,0,-350,-105,186010,186197,187
104,0,blank,0,-350,-105,186197,186415,218
104,0,blank,0,-350,-105,186415,186626,211
104,0,blank,0,-350,-105,186626,186817,191
104,0,blank,0,-350,-105,186817,186988,171
104,0,blank,0,-350,-105,186988,187145,157
104,0,blank,0,-350,-105,187145,187502,357
104,0,blank,0,-350,-105,187502,187699,197
104,0,blank,0,-350,-105,187699,187726,27
104,0,blank,0,-350,-105,187726,187904,178
104,0,blank,0,-350,-105,187904,187930,26
104,0,blank,0,-350,-105,187930,188159,229
104,0,blank,0,-350,-105,188159,188235,76
104,0,blank,0,-350,-105,188235,188866,631
104,0,blank,0,-350,-105,188866,189062,196
104,0,blank,0,-350,-105,189062,189196,134
104,0,blank,0,-350,-105,189196,189595,399
104,0,blank,0,-350,-105,189595,189630,35
104,0,blank,0,-350,-105,189630,190131,501
104,0,blank,0,-350,-105,190131,190631,500
104,0,blank,0,-350,-105,190631,190821,190
104,0,blank,0,299.294775,264.2309,190852,191003,151
104,0,blank,0,-350,-105,191037,191225,188
104,0,blank,0,-350,-105,191225,191397,172
104,0,blank,0,-350,-105,191397,191596,199
104,0,blank,0,-350,-105,191596,191775,179
104,0,blank,0,-350,-105,191775,191931,156
104,0,blank,0,244.60678,324.9127,191958,192143,185
104,52,;,354,250.6901,341.6911,192143,192175,32
104,0,blank,0,-350,-105,192579,192747,168
104,0,blank,0,-350,-105,192747,192932,185
104,0,blank,0,-350,-105,192932,193130,198
104,0,blank,0,-350,-105,193130,193297,167
104,0,blank,0,-350,-105,193297,193460,163
104,0,blank,0,-350,-105,193460,193536,76
104,0,blank,0,-350,-105,193536,193723,187
104,0,blank,0,-350,-105,193723,193776,53
104,0,blank,0,-350,-105,193919,194056,137
104,0,blank,0,-350,-105,194056,195064,1008
104,0,blank,0,-350,-105,195064,195228,164
104,0,blank,0,-350,-105,195228,195379,151
104,0,blank,0,-350,-105,195379,195567,188
104,0,blank,0,-350,-105,195567,195747,180
104,0,blank,0,-350,-105,195747,195939,192
104,0,blank,0,-350,-105,195939,196127,188
104,0,blank,0,-350,-105,196127,196325,198
104,0,blank,0,-350,-105,196325,196394,69
104,0,blank,0,-350,-105,196394,196605,211
104,0,blank,0,-350,-105,196605,197657,1052
104,0,blank,0,-350,-105,197657,197847,190
104,0,blank,0,-350,-105,197847,198036,189
104,0,blank,0,-350,-105,198036,198232,196
104,52,column2,353,360.07955,352.3383,198271,198453,182
104,0,blank,0,383.6937,415.2778,198453,198503,50
104,0,blank,0,362.8235,372.2765,198503,198759,256
104,54,j,374,381.6111,387.99522,198759,198931,172
104,0,blank,0,363.803175,361.415325,198931,199043,112
104,0,blank,0,352.8315,361.8021,199043,199327,284
104,0,blank,0,367.03035,366.317,199327,199510,183
104,0,blank,0,391.055475,377.3039,199510,199632,122
104,0,blank,0,-350,-105,199661,199854,193
104,52,column2,353,316.7646,355.0807,199884,200081,197
104,0,blank,0,349.56555,359.400933333333,200081,200267,186
104,52,;,354,374.59165,351.779333333333,200267,200444,177
104,0,blank,0,376.131466666667,374.45005,200444,200620,176
104,0,blank,0,372.348783333333,368.525083333333,200620,200798,178
104,0,blank,0,376.274716666667,364.207383333333,200798,200979,181
104,0,blank,0,382.37495,369.824966666667,200979,201161,182
104,0,blank,0,380.52195,357.31815,201161,201220,59
104,0,blank,0,-350,-105,201250,201433,183
104,0,blank,0,-350,-105,201433,201613,180
104,0,blank,0,-350,-105,201613,201792,179
104,0,blank,0,-350,-105,201792,201970,178
104,0,blank,0,-350,-105,201970,202146,176
104,0,blank,0,-350,-105,202146,202323,177
104,0,blank,0,-350,-105,202323,202519,196
104,0,blank,0,-350,-105,202519,202693,174
104,0,blank,0,-350,-105,202693,202884,191
104,0,blank,0,-350,-105,202884,203065,181
104,0,blank,0,-350,-105,203065,203245,180
104,0,blank,0,-350,-105,203245,203330,85
104,0,blank,0,-350,-105,203330,203557,227
104,0,blank,0,-350,-105,203557,203793,236
104,0,blank,0,-350,-105,203793,204071,278
104,0,blank,0,-350,-105,204071,204251,180
104,0,blank,0,-350,-105,204251,204450,199
104,0,blank,0,-350,-105,204450,204471,21
104,0,blank,0,229.4623,368.1562,204511,204538,27
104,0,blank,0,-350,-105,204632,205106,474
104,0,blank,0,-350,-105,205106,205241,135
104,0,blank,0,276.79166,339.63822,205362,205549,187
104,0,blank,0,-350,-105,205822,205975,153
104,46,matrices,310,262.003666666667,236.199866666667,205999,206085,86
104,0,blank,0,-350,-105,206257,206335,78
104,0,blank,0,361.99125,309.76035,206504,206568,64
104,0,blank,0,-350,-105,206654,206833,179
104,0,blank,0,-350,-105,206833,207009,176
104,0,blank,0,-350,-105,207009,207198,189
104,0,blank,0,-350,-105,207198,207302,104
104,46,matrices,310,251.73186,237.6215,207337,207495,158
104,0,blank,0,-350,-105,207526,207611,85
104,0,blank,0,329.815,202.24636,207778,207926,148
104,0,blank,0,-350,-105,207957,207989,32
104,0,blank,0,384.9213,297.5424,208036,208070,34
104,0,blank,0,354.891,363.0138,208201,208243,42
104,49,"Matricescanbecompared\n",328,303.6971,278.8043,208456,208497,41
104,0,blank,0,-350,-105,208627,208801,174
104,0,blank,0,-350,-105,208801,208979,178
104,0,blank,0,-350,-105,208979,209155,176
104,0,blank,0,-350,-105,209155,209327,172
104,52,;,354,252.536033333333,346.0139,209436,209601,165
104,0,blank,0,250.9242,364.8654,209601,209670,69
104,0,blank,0,-350,-105,209949,210129,180
104,0,blank,0,-350,-105,210129,210252,123
104,0,blank,0,-350,-105,210252,210342,90
104,46,Comparing,308,176.3662,239.95552,210946,211143,197
104,46,two,309,193.3075,244.798433333333,211143,211321,178
104,0,blank,0,195.6914,222.4797,211321,211362,41
104,0,blank,0,-350,-105,211406,211599,193
104,0,blank,0,-350,-105,211599,211778,179
104,0,blank,0,-350,-105,211778,211970,192
104,0,blank,0,-350,-105,211970,212151,181
104,0,blank,0,-350,-105,212151,212308,157
104,0,blank,0,-350,-105,212308,212463,155
104,0,blank,0,-350,-105,212463,212556,93
104,0,blank,0,-350,-105,212556,212734,178
104,50,row1,339,261.414533333333,310.191333333333,212774,212916,142
104,0,blank,0,297.031433333333,320.4083,212916,213093,177
104,0,blank,0,324.92455,290.95475,213093,213277,184
104,50,i,341,323.9122,297.7509,213277,213339,62
104,0,blank,0,-350,-105,213402,213596,194
104,0,blank,0,-350,-105,213596,213775,179
104,0,blank,0,-350,-105,213775,213968,193
104,0,blank,0,-350,-105,213968,214017,49
104,0,blank,0,280.6366,316.762916666667,214043,214216,173
104,0,blank,0,276.311566666667,312.507183333333,214216,214395,179
104,0,blank,0,263.226566666667,314.74095,214395,214577,182
104,50,<,338,252.125733333333,305.477666666667,214577,214756,179
104,50,i,341,224.846333333333,305.5238,214756,214936,180
104,0,blank,0,225.249666666667,319.608033333333,214936,215027,91
104,0,blank,0,-350,-105,215057,215213,156
104,0,blank,0,-350,-105,215213,215260,47
104,0,blank,0,262.4151,315.531766666667,215406,215576,170
104,50,row1,339,262.178966666667,311.39825,215576,215758,182
104,0,blank,0,261.52775,322.584016666667,215758,215941,183
104,0,blank,0,258.705633333333,323.979083333333,215941,216126,185
104,0,blank,0,276.262883333333,322.0283,216126,216310,184
104,52,j,355,193.926933333333,337.4042,216310,216494,184
104,0,blank,0,184.537916666667,334.500933333333,216494,216676,182
104,0,blank,0,185.250133333333,329.201333333333,216676,216770,94
104,0,blank,0,-350,-105,216832,216972,140
104,0,blank,0,269.486716666667,334.7687,217101,217278,177
104,52,j,355,266.7255,336.4516,217278,217465,187
104,0,blank,0,277.118816666667,328.980533333333,217465,217649,184
104,0,blank,0,290.617066666667,334.3938,217649,217833,184
104,0,blank,0,266.432233333333,327.559366666667,217833,218018,185
104,0,blank,0,238.996,312.673016666667,218018,218208,190
104,0,blank,0,233.726125,303.9008,218208,218335,127
104,0,blank,0,-350,-105,218397,218580,183
104,0,blank,0,-350,-105,218580,218709,129
104,0,blank,0,-350,-105,218709,218813,104
104,0,blank,0,-350,-105,218813,218952,139
104,0,blank,0,-350,-105,218952,219069,117
104,0,blank,0,285.106175,322.371125,219132,219258,126
104,0,blank,0,-350,-105,219321,219502,181
104,0,blank,0,-350,-105,219502,219683,181
104,0,blank,0,-350,-105,219683,219866,183
104,0,blank,0,-350,-105,219866,220052,186
104,0,blank,0,-350,-105,220052,220233,181
104,0,blank,0,-350,-105,220233,220411,178
104,0,blank,0,-350,-105,220411,220592,181
104,0,blank,0,-350,-105,220592,220775,183
104,0,blank,0,-350,-105,220775,220958,183
104,0,blank,0,-350,-105,220958,221140,182
104,0,blank,0,-350,-105,221140,221292,152
104,0,blank,0,-350,-105,221292,221508,216
104,0,blank,0,-350,-105,221508,221768,260
104,0,blank,0,-350,-105,221768,222156,388
104,0,blank,0,-350,-105,222156,222335,179
104,0,blank,0,-350,-105,222335,222511,176
104,0,blank,0,-350,-105,222511,222562,51
104,0,blank,0,-350,-105,222562,222804,242
104,0,blank,0,-350,-105,222804,223055,251
104,0,blank,0,-350,-105,223055,223245,190
104,0,blank,0,-350,-105,223245,223264,19
104,0,blank,0,-350,-105,223264,223458,194
104,0,blank,0,-350,-105,223458,223648,190
104,0,blank,0,-350,-105,223648,223810,162
104,0,blank,0,-350,-105,223810,224079,269
104,0,blank,0,-350,-105,224079,224323,244
104,0,blank,0,-350,-105,224323,224911,588
104,0,blank,0,-350,-105,224911,225091,180
104,0,blank,0,-350,-105,225091,225272,181
104,0,blank,0,-350,-105,225272,225454,182
104,0,blank,0,-350,-105,225454,225637,183
104,0,blank,0,-350,-105,225637,225818,181
104,0,blank,0,-350,-105,225818,225972,154
104,0,blank,0,-350,-105,225972,226142,170
104,0,blank,0,-350,-105,226142,226197,55
104,0,blank,0,-350,-105,226197,226465,268
104,0,blank,0,-350,-105,226465,226644,179
104,0,blank,0,-350,-105,226644,226822,178
104,0,blank,0,-350,-105,226822,227008,186
104,0,blank,0,-350,-105,227008,227187,179
104,0,blank,0,-350,-105,227187,227366,179
104,0,blank,0,-350,-105,227366,227549,183
104,0,blank,0,-350,-105,227549,227606,57
104,0,blank,0,-350,-105,227606,227792,186
104,0,blank,0,-350,-105,227792,227981,189
104,0,blank,0,-350,-105,227981,228185,204
104,0,blank,0,-350,-105,228185,228415,230
104,0,blank,0,-350,-105,228415,228594,179
104,0,blank,0,-350,-105,228594,228771,177
104,0,blank,0,-350,-105,228771,228946,175
104,0,blank,0,-350,-105,228946,229037,91
104,0,blank,0,-350,-105,229037,229402,365
104,0,blank,0,-350,-105,229402,229836,434
104,0,blank,0,-350,-105,229836,230034,198
104,0,blank,0,-350,-105,230034,230211,177
104,0,blank,0,-350,-105,230211,230389,178
104,0,blank,0,-350,-105,230389,230559,170
104,0,blank,0,-350,-105,230559,230609,50
104,0,blank,0,-350,-105,230609,230868,259
104,0,blank,0,-350,-105,230868,231138,270
104,0,blank,0,-350,-105,231138,231318,180
104,0,blank,0,-350,-105,231318,231497,179
104,0,blank,0,-350,-105,231497,231683,186
104,0,blank,0,-350,-105,231683,231863,180
104,0,blank,0,-350,-105,231863,232045,182
104,0,blank,0,-350,-105,232045,232223,178
104,0,blank,0,-350,-105,232223,232398,175
104,0,blank,0,-350,-105,232398,232488,90
104,0,blank,0,-350,-105,232488,232741,253
104,0,blank,0,-350,-105,232741,233035,294
104,0,blank,0,-350,-105,233035,233499,464
104,0,blank,0,-350,-105,233499,233677,178
104,0,blank,0,-350,-105,233677,233854,177
104,0,blank,0,-350,-105,233854,233908,54
104,0,blank,0,-350,-105,233908,234099,191
104,0,blank,0,-350,-105,234099,234295,196
104,0,blank,0,-350,-105,234295,234570,275
104,0,blank,0,-350,-105,234570,234971,401
104,0,blank,0,-350,-105,234971,235145,174
104,0,blank,0,-350,-105,235145,235177,32
104,0,blank,0,-350,-105,235177,235488,311
104,0,blank,0,-350,-105,235488,235798,310
104,0,blank,0,-350,-105,235798,236270,472
104,0,blank,0,-350,-105,236270,236451,181
104,0,blank,0,-350,-105,236451,236632,181
104,0,blank,0,-350,-105,236632,236784,152
104,0,blank,0,-350,-105,236784,236983,199
104,0,blank,0,-350,-105,236983,237071,88
104,0,blank,0,-350,-105,237071,237302,231
104,0,blank,0,-350,-105,237302,237597,295
104,0,blank,0,-350,-105,237597,237775,178
104,0,blank,0,-350,-105,237775,237952,177
104,0,blank,0,-350,-105,237952,238126,174
104,0,blank,0,-350,-105,238126,238215,89
104,0,blank,0,-350,-105,238215,238428,213
104,0,blank,0,-350,-105,238428,238643,215
104,0,blank,0,-350,-105,238643,238956,313
104,0,blank,0,-350,-105,238956,239132,176
104,0,blank,0,-350,-105,239132,239324,192
104,0,blank,0,-350,-105,239324,239501,177
104,0,blank,0,-350,-105,239501,239687,186
104,0,blank,0,-350,-105,239687,239884,197
104,0,blank,0,-350,-105,239884,240055,171
104,0,blank,0,-350,-105,240055,240226,171
104,0,blank,0,-350,-105,240226,240417,191
104,0,blank,0,-350,-105,240417,240578,161
104,0,blank,0,-350,-105,240578,240735,157
104,0,blank,0,-350,-105,240735,240909,174
104,0,blank,0,-350,-105,240909,241089,180
104,0,blank,0,-350,-105,241089,241267,178
104,0,blank,0,-350,-105,241267,241437,170
104,0,blank,0,-350,-105,241437,241582,145
104,0,blank,0,-350,-105,241582,241767,185
104,0,blank,0,-350,-105,241767,241962,195
104,0,blank,0,-350,-105,241962,242036,74
104,54,[,373,334.461033333333,383.613133333333,242282,242477,195
104,0,blank,0,351.698375,403.172325,242477,242640,163
104,52,++,356,408.5192,341.6508,242640,242687,47
104,49,"Matricescanbecompared\n",328,304.129766666667,273.62505,242729,242905,176
104,49,"Matricescanbecompared\n",328,305.7301,276.668216666667,242905,243089,184
104,0,blank,0,302.1565,313.42615,243089,243150,61
104,0,blank,0,-350,-105,243181,243366,185
104,0,blank,0,296.20795,360.095866666667,243492,243665,173
104,0,blank,0,283.130283333333,332.0282,243665,243857,192
104,50,row1,339,262.86408,294.88196,243857,244031,174
104,49,"Matricescanbecompared\n",328,291.45104,269.25328,244031,244197,166
104,49,"Matricescanbecompared\n",328,312.314033333333,278.826183333333,244197,244385,188
104,0,blank,0,360.644683333333,301.172783333333,244385,244584,199
104,0,blank,0,344.623716666667,308.052666666667,244584,244767,183
104,0,blank,0,299.733616666667,324.586366666667,244767,244953,186
104,0,blank,0,271.539916666667,319.632816666667,244953,245139,186
104,0,blank,0,273.63742,321.7236,245139,245296,157
104,0,blank,0,-350,-105,245327,245516,189
104,0,blank,0,378.435916666667,313.226616666667,245637,245812,175
104,0,blank,0,375.04948,323.116,245812,245964,152
104,0,blank,0,272.98285,320.3307,245995,246185,190
104,0,blank,0,280.019383333333,325.84335,246185,246368,183
104,0,blank,0,281.238816666667,323.777266666667,246368,246551,183
104,0,blank,0,282.2759,328.689383333333,246551,246736,185
104,0,blank,0,281.470125,316.20565,246736,246858,122
104,0,blank,0,-350,-105,246888,247081,193
104,0,blank,0,284.5005,312.3841,247144,247192,48
104,0,blank,0,345.507233333333,325.595583333333,247255,247439,184
104,0,blank,0,367.2,320.96325,247439,247627,188
104,0,blank,0,357.054616666667,326.308383333333,247627,247812,185
104,0,blank,0,297.97384,327.387,247812,247973,161
104,0,blank,0,284.6259,324.38985,247973,248171,198
104,50,<,338,251.196116666667,303.484383333333,248171,248358,187
104,49,"Matricescanbecompared\n",328,226.1485,277.323733333333,248358,248543,185
104,0,blank,0,225.76005,268.51115,248543,248726,183
104,49,"Matricescanbecompared\n",328,225.8825,275.0108,248726,248818,92
104,0,blank,0,-350,-105,248848,249034,186
104,0,blank,0,-350,-105,249034,249214,180
104,0,blank,0,-350,-105,249214,249390,176
104,0,blank,0,-350,-105,249390,249572,182
104,0,blank,0,-350,-105,249572,249756,184
104,0,blank,0,-350,-105,249756,249895,139
104,0,blank,0,-350,-105,249895,250089,194
104,0,blank,0,-350,-105,250089,250264,175
104,0,blank,0,-350,-105,250264,250436,172
104,0,blank,0,-350,-105,250436,250628,192
104,0,blank,0,-350,-105,250628,250806,178
104,0,blank,0,-350,-105,250806,251005,199
104,0,blank,0,-350,-105,251005,251185,180
104,54,!=,368,302.99145,389.3237,251218,251405,187
104,54,!=,368,305.72325,381.086825,251405,251568,163
104,0,blank,0,-350,-105,251650,251824,174
104,0,blank,0,-350,-105,251824,252001,177
104,0,blank,0,-350,-105,252001,252178,177
104,0,blank,0,-350,-105,252178,252357,179
104,0,blank,0,-350,-105,252357,252533,176
104,0,blank,0,-350,-105,252533,252712,179
104,0,blank,0,-350,-105,252712,252892,180
104,0,blank,0,-350,-105,252892,253071,179
104,0,blank,0,-350,-105,253071,253260,189
104,0,blank,0,-350,-105,253260,253392,132
104,0,blank,0,-350,-105,253392,253561,169
104,0,blank,0,-350,-105,253561,253730,169
104,0,blank,0,-350,-105,253730,253898,168
104,0,blank,0,-350,-105,253898,253998,100
104,52,j,355,271.4397,343.6588,254060,254153,93
104,0,blank,0,287.49275,268.3569,254262,254461,199
104,0,blank,0,295.548133333333,262.9003,254461,254642,181
104,49,"Matricescanbecompared\n",328,329.06755,282.65595,254642,254829,187
104,0,blank,0,342.91345,297.879316666667,254829,255013,184
104,52,;,354,379.218733333333,340.86415,255013,255202,189
104,0,blank,0,328.917866666667,362.469083333333,255202,255400,198
104,0,blank,0,308.931,403.0591,255400,255432,32
104,0,blank,0,-350,-105,255465,255651,186
104,0,blank,0,-350,-105,255651,255848,197
104,52,<,352,284.719716666667,342.254166666667,255880,256054,174
104,0,blank,0,279.56035,392.152766666667,256054,256239,185
104,0,blank,0,282.8365,406.106616666667,256239,256425,186
104,0,blank,0,279.861866666667,401.29025,256425,256614,189
104,0,blank,0,282.066,388.878533333333,256614,256797,183
104,0,blank,0,283.3433,357.508516666667,256797,256984,187
104,0,blank,0,281.5389,362.0135,256984,257167,183
104,0,blank,0,280.70035,350.830216666667,257167,257350,183
104,0,blank,0,281.183933333333,356.93075,257350,257533,183
104,0,blank,0,283.1925,357.64775,257533,257715,182
104,52,j,355,272.79815,355.463033333333,257715,257900,185
104,0,blank,0,277.613666666667,358.795883333333,257900,258081,181
104,0,blank,0,269.5443,365.5396,258081,258112,31
104,0,blank,0,-350,-105,258142,258325,183
104,0,blank,0,-350,-105,258325,258501,176
104,0,blank,0,276.5289,418.9053,258530,258703,173
104,0,blank,0,186.611733333333,477.61715,258703,258886,183
104,0,blank,0,182.9974,484.5524,258886,258917,31
104,0,blank,0,147.561733333333,589.341366666667,258948,259133,185
104,0,blank,0,208.916233333333,593.165916666667,259133,259315,182
104,0,blank,0,300.359016666667,590.442016666667,259315,259499,184
104,0,blank,0,281.055183333333,595.077033333333,259499,259678,179
104,0,blank,0,332.88518,595.6823,259678,259848,170
104,0,blank,0,352.4714,593.5876,259848,259919,71
104,0,blank,0,183.2652,637.96,260025,260212,187
104,0,blank,0,177.573833333333,633.1357,260212,260400,188
104,0,blank,0,175.634116666667,622.814983333333,260400,260584,184
104,0,blank,0,171.854583333333,624.86865,260584,260771,187
104,0,blank,0,180.509666666667,622.971533333333,260771,260864,93
104,64,"Cannotbecompared\n",392,298.218916666667,604.07185,260895,261078,183
104,0,blank,0,-350,-105,261140,261327,187
104,0,blank,0,-350,-105,261327,261450,123
104,0,blank,0,123.5741,560.074933333333,261488,261661,173
104,0,blank,0,119.971375,538.3208,261661,261782,121
104,0,blank,0,138.751083333333,203.960716666667,261813,261995,182
104,0,blank,0,139.243366666667,214.931,261995,262176,181
104,0,blank,0,146.971916666667,212.449366666667,262176,262360,184
104,0,blank,0,143.862466666667,471.74405,262390,262570,180
104,0,blank,0,166.51835,464.086083333333,262570,262753,183
104,0,blank,0,267.912633333333,439.091716666667,262753,262934,181
104,56,0,380,286.87385,429.717325,262934,263054,120
104,0,blank,0,-350,-105,263084,263269,185
104,0,blank,0,-350,-105,263269,263418,149
104,0,blank,0,140.0754,447.3099,263448,263465,17
104,0,blank,0,139.395766666667,550.5368,263505,263696,191
104,0,blank,0,131.5474,539.2419,263696,263728,32
104,64,"Cannotbecompared\n",392,187.932533333333,601.361033333333,263759,263941,182
104,64,"Cannotbecompared\n",392,309.3987,607.768883333333,263970,264154,184
104,64,"Cannotbecompared\n",392,298.2387,601.345166666667,264154,264337,183
104,64,"Cannotbecompared\n",392,258.879783333333,618.028366666667,264337,264522,185
104,64,printf,390,149.375233333333,604.80115,264522,264709,187
104,65,(,396,141.1542,625.3411,264709,264740,31
104,0,blank,0,137.30315,587.71675,264771,264832,61
104,0,blank,0,216.962833333333,205.800716666667,264862,265050,188
104,0,blank,0,213.882466666667,209.433083333333,265050,265241,191
104,0,blank,0,328.379433333333,206.53835,265272,265457,185
104,0,blank,0,365.041333333333,202.775183333333,265457,265641,184
104,0,blank,0,398.672266666667,210.860683333333,265641,265821,180
104,0,blank,0,275.699716666667,203.348816666667,265851,266031,180
104,0,blank,0,281.97015,210.217716666667,266031,266214,183
104,0,blank,0,276.246283333333,207.841833333333,266214,266398,184
104,0,blank,0,185.711466666667,441.80125,266429,266615,186
104,0,blank,0,167.2734,536.4449,266615,266797,182
104,0,blank,0,199.91375,586.64395,266797,266919,122
104,0,blank,0,-350,-105,266979,267136,157
104,0,blank,0,-350,-105,267136,267188,52
104,0,blank,0,186.086933333333,693.1383,267323,267502,179
104,0,blank,0,185.306616666667,700.8549,267502,267691,189
104,0,blank,0,216.436783333333,695.167683333333,267691,267879,188
104,0,blank,0,225.702466666667,693.868866666667,267879,267975,96
104,0,blank,0,342.703033333333,718.45495,268007,268198,191
104,0,blank,0,287.93455,722.1,268198,268391,193
104,0,blank,0,283.5811,712.46116,268391,268551,160
104,0,blank,0,961.155666666667,400.1417,268647,268841,194
104,0,blank,0,961.074,399.643766666667,268841,269032,191
104,0,blank,0,963.758,487.884683333333,269032,269224,192
104,0,blank,0,961.990833333333,529.659316666667,269224,269413,189
104,0,blank,0,983.167,522.362475,269413,269574,161
104,0,blank,0,966.549,512.9041,269574,269624,50
104,0,blank,0,997.294,633.68435,269783,269970,187
104,0,blank,0,968.596,714.5726,269970,270016,46
104,0,blank,0,268.505,627.9797,270158,270194,36
105,0,blank,0,160.299916666667,645.822633333333,270452,270636,184
105,0,blank,0,188.896816666667,652.817566666667,270636,270821,185
105,70,"But,twomatricesarenotequal\n",415,279.117933333333,680.951233333333,270821,271000,179
105,0,blank,0,337.59745,687.81735,271000,271183,183
105,70,"But,twomatricesarenotequal\n",415,203.861933333333,670.155716666667,271183,271364,181
105,70,"But,twomatricesarenotequal\n",415,174.586366666667,665.997466666667,271364,271547,183
105,0,blank,0,186.90555,690.0038,271547,271664,117
105,69,else,412,67.2286666666667,644.261633333333,271694,271872,178
105,69,else,412,72.18445,651.538533333333,271872,272052,180
105,0,blank,0,110.30545,656.443816666667,272052,272230,178
105,70,"But,twomatricesarenotequal\n",415,172.890816666667,666.072266666667,272230,272406,176
105,0,blank,0,223.499833333333,687.988633333333,272406,272584,178
105,70,"But,twomatricesarenotequal\n",415,229.08045,675.79385,272584,272644,60
105,0,blank,0,340.936383333333,686.574033333333,272674,272854,180
105,0,blank,0,353.703016666667,689.708483333333,272854,273038,184
105,0,blank,0,377.326333333333,689.265533333333,273038,273128,90
105,0,blank,0,-350,-105,273189,273366,177
105,0,blank,0,-350,-105,273366,273408,42
105,70,"But,twomatricesarenotequal\n",415,286.819585714286,683.746014285714,273438,273633,195
105,0,blank,0,329.9177,687.636283333333,273633,273809,176
105,0,blank,0,326.026,702.10535,273809,273926,117
105,0,blank,0,251.769075,609.406675,273955,274116,161
105,0,blank,0,218.9404,648.68535,274116,274287,171
105,68,"Twomatricesareequal\n",409,188.198925,634.875175,274287,274453,166
105,67,flag,403,143.4706,615.555975,274453,274623,170
105,68,printf,407,125.48475,624.605975,274623,274798,175
105,68,(,408,157.06606,628.86262,274798,274975,177
105,68,"Twomatricesareequal\n",409,163.255966666667,632.576866666667,274975,275155,180
105,68,"Twomatricesareequal\n",409,162.08785,639.48865,275155,275215,60
105,0,blank,0,-350,-105,275245,275428,183
105,0,blank,0,-350,-105,275428,275567,139
105,68,"Twomatricesareequal\n",409,216.795716666667,621.765616666667,275619,275808,189
105,68,"Twomatricesareequal\n",409,289.1029,639.417166666667,275808,275989,181
105,68,"Twomatricesareequal\n",409,361.77195,641.6181,275989,276167,178
105,70,"But,twomatricesarenotequal\n",415,320.31915,667.533483333333,276167,276348,181
105,0,blank,0,259.42888,689.5448,276348,276526,178
105,0,blank,0,250.54475,691.96835,276526,276614,88
105,70,"But,twomatricesarenotequal\n",415,294.035216666667,684.378466666667,276644,276827,183
105,70,"But,twomatricesarenotequal\n",415,341.003266666667,679.8164,276827,276918,91
105,46,matrices,310,284.9851,175.403016666667,276978,277163,185
105,0,blank,0,268.31065,184.581366666667,277163,277347,184
105,0,blank,0,319.293833333333,188.31395,277347,277526,179
105,0,blank,0,348.266016666667,194.441083333333,277526,277706,180
105,0,blank,0,381.141583333333,187.0842,277706,277887,181
105,0,blank,0,421.440733333333,192.303816666667,277887,278067,180
105,0,blank,0,421.6386,196.11805,278067,278187,120
105,0,blank,0,-350,-105,278217,278400,183
105,0,blank,0,-350,-105,278400,278566,166
105,0,blank,0,292.927,476.8574,278594,278682,88
105,0,blank,0,252.76564,697.94844,278746,278894,148
105,0,blank,0,698.5946,743.47506,278924,279079,155
105,70,"But,twomatricesarenotequal\n",415,427.112066666667,669.856283333333,279109,279295,186
105,0,blank,0,520.82925,692.5972,279325,279505,180
105,0,blank,0,517.5275,689.807833333333,279505,279597,92
105,0,blank,0,285.687733333333,586.369483333333,279627,279812,185
105,0,blank,0,279.686483333333,574.152633333333,279812,279993,181
105,0,blank,0,279.67885,559.835983333333,279993,280176,183
105,0,blank,0,272.32035,576.1971,280176,280267,91
105,0,blank,0,273.3643,559.8368,280267,280449,182
105,64,"Cannotbecompared\n",392,281.3435,543.653966666667,280449,280647,198
105,64,"Cannotbecompared\n",392,275.8251,544.1712,280647,280678,31
105,0,blank,0,-350,-105,280738,280848,110
105,0,blank,0,965.212,444.106766666667,280949,281129,180
105,0,blank,0,965.504666666667,419.295066666667,281129,281313,184
105,0,blank,0,965.264833333334,419.539966666667,281313,281493,180
105,0,blank,0,912.734,383.9339,281493,281523,30
105,0,blank,0,560.411,252.2172,281553,281613,60
106,0,blank,0,430.758633333333,66.7744,283256,283445,189
106,0,blank,0,444.224975,60.868425,283445,283571,126
106,0,blank,0,-350,-105,283603,283682,79
106,0,blank,0,441.2565,65.0693,283708,283747,39
106,0,blank,0,440.863116666667,59.96865,283817,283994,177
106,0,blank,0,439.773716666667,59.816,283994,284178,184
106,0,blank,0,443.46825,61.811625,284178,284303,125
106,0,blank,0,901.2405,179.881066666667,284334,284523,189
106,0,blank,0,929.474833333333,183.65495,284523,284709,186
106,0,blank,0,960.912166666667,199.87685,284709,284897,188
106,0,blank,0,966.067166666667,226.2684,284897,285090,193
106,0,blank,0,974.274833333333,298.156383333333,285090,285285,195
106,0,blank,0,964.178833333333,306.392533333333,285285,285479,194
106,0,blank,0,981.74525,318.860675,285479,285639,160
106,0,blank,0,984.311,325.162025,285639,285816,177
106,0,blank,0,982.8705,334.0835,285816,286008,192
106,0,blank,0,-350,-105,286054,286208,154
106,0,blank,0,966.7415,348.5606,286247,286348,101
107,0,blank,0,-350,-105,289406,289490,84
107,0,blank,0,108.4127,25.2499,289516,289542,26
107,37,printf,253,94.5615,36.19285,289607,289783,176
107,37,printf,253,60.413,50.97845,289783,289972,189
107,37,printf,253,64.759025,47.8719,289972,290104,132
107,46,Comparing,308,127.987583333333,243.487666666667,290136,290327,191
107,46,Comparing,308,159.044233333333,248.0677,290327,290513,186
107,0,blank,0,173.794233333333,252.165383333333,290513,290698,185
107,49,"Matricescanbecompared\n",328,188.65125,274.936516666667,290698,290884,186
107,49,"Matricescanbecompared\n",328,201.113966666667,277.006983333333,290884,291079,195
107,49,"Matricescanbecompared\n",328,236.038033333333,284.428016666667,291079,291271,192
107,0,blank,0,-350,-105,291302,291491,189
107,0,blank,0,-350,-105,291491,291635,144
107,49,"Matricescanbecompared\n",328,175.371533333333,288.537233333333,291668,291848,180
107,50,0,335,190.970233333333,297.067133333333,291848,292047,199
107,49,"Matricescanbecompared\n",328,224.7649,287.157416666667,292047,292236,189
107,50,i,341,223.1893,297.3686,292236,292362,126
107,0,blank,0,-350,-105,292424,292559,135
107,0,blank,0,185.349766666667,334.0514,292652,292824,172
107,0,blank,0,203.67285,336.111916666667,292824,293011,187
107,0,blank,0,245.923133333333,336.291483333333,293011,293198,187
107,0,blank,0,279.80265,331.008966666667,293198,293386,188
107,0,blank,0,278.604233333333,335.405833333333,293386,293583,197
107,0,blank,0,271.3963,332.6122,293583,293681,98
107,0,blank,0,-350,-105,293713,293905,192
107,0,blank,0,288.7003,375.957916666667,294059,294231,172
107,54,a,361,215.122316666667,386.18535,294231,294419,188
107,0,blank,0,212.342,371.4978,294419,294617,198
107,54,if,359,175.911825,383.04685,294617,294751,134
107,0,blank,0,-350,-105,294815,295013,198
107,0,blank,0,-350,-105,295013,295194,181
107,0,blank,0,-350,-105,295194,295381,187
107,0,blank,0,-350,-105,295381,295531,150
107,0,blank,0,-350,-105,295531,295718,187
107,0,blank,0,-350,-105,295718,295902,184
107,0,blank,0,-350,-105,295902,296095,193
107,0,blank,0,-350,-105,296095,296266,171
107,0,blank,0,-350,-105,296266,296446,180
107,0,blank,0,-350,-105,296446,296483,37
107,0,blank,0,233.923083333333,378.852616666667,296582,296760,178
107,0,blank,0,258.349833333333,370.110466666667,296760,296941,181
107,0,blank,0,247.83805,368.4109,296941,297122,181
107,54,if,359,191.288683333333,389.390533333333,297122,297303,181
107,0,blank,0,-350,-105,297363,297527,164
107,0,blank,0,-350,-105,297527,297682,155
107,55,{,377,213.681866666667,436.695283333333,297715,297887,172
107,56,;,381,209.903866666667,449.898666666667,297887,298074,187
107,56,;,381,211.071383333333,450.063516666667,298074,298257,183
107,0,blank,0,209.529033333333,695.756766666667,298287,298481,194
107,0,blank,0,268.2868,745.737816666667,298481,298666,185
107,0,blank,0,283.1279,752.0369,298666,298696,30
107,0,blank,0,205.380566666667,652.54025,298727,298915,188
107,0,blank,0,191.2553,627.5702,298915,299010,95
107,0,blank,0,-350,-105,299073,299268,195
107,0,blank,0,954.786166666667,480.039433333333,299306,299489,183
107,0,blank,0,959.523166666667,480.2881,299489,299679,190
107,0,blank,0,959.114333333333,486.171766666667,299679,299865,186
107,0,blank,0,945.955,487.0416,299865,299897,32
107,0,blank,0,292.813216666667,656.266683333333,299960,300153,193
107,0,blank,0,297.1252,670.6787,300153,300185,32
107,0,blank,0,219.306316666667,745.401816666667,300216,300402,186
107,0,blank,0,173.2865,699.393316666667,300402,300601,199
107,0,blank,0,190.67415,722.1852,300601,300784,183
107,0,blank,0,198.14595,751.0555,300784,300982,198
107,0,blank,0,205.5892,743.14065,300982,301056,74
107,0,blank,0,-350,-105,301119,301224,105
107,0,blank,0,966.272833333333,480.671733333333,301371,301556,185
107,0,blank,0,966.0355,496.536583333333,301556,301747,191
107,0,blank,0,963.1815,510.749816666667,301747,301936,189
107,0,blank,0,966.743833333333,515.52365,301936,302127,191
107,0,blank,0,970.9365,523.293983333333,302127,302316,189
108,0,blank,0,241.00795,689.1967,302477,302667,190
108,0,blank,0,183.887966666667,691.6011,302667,302853,186
108,0,blank,0,178.923233333333,703.530933333333,302853,303040,187
108,0,blank,0,311.513233333333,723.33965,303040,303225,185
108,0,blank,0,358.081683333333,703.977916666667,303225,303415,190
108,0,blank,0,-350,-105,303445,303629,184
108,0,blank,0,-350,-105,303629,303789,160
108,0,blank,0,-350,-105,303789,303838,49
108,70,"But,twomatricesarenotequal\n",415,330.99792,674.89976,303870,304015,145
108,0,blank,0,193.7827,702.79825,304052,304239,187
108,0,blank,0,177.913616666667,705.45035,304239,304425,186
108,70,"But,twomatricesarenotequal\n",415,160.699775,683.3723,304425,304547,122
108,0,blank,0,286.45535,704.640033333333,304579,304766,187
108,0,blank,0,342.430866666667,693.738716666667,304766,304954,188
108,0,blank,0,336.40105,716.83245,304954,305016,62
108,70,"But,twomatricesarenotequal\n",415,215.821983333333,683.602066666667,305047,305232,185
108,0,blank,0,189.1039,660.228916666667,305232,305417,185
108,70,"But,twomatricesarenotequal\n",415,220.025466666667,679.731466666667,305417,305603,186
108,0,blank,0,245.51914,699.42814,305603,305761,158
108,0,blank,0,356.48575,708.998583333333,305792,305984,192
108,70,"But,twomatricesarenotequal\n",415,229.138583333333,681.0659,305984,306178,194
108,70,"But,twomatricesarenotequal\n",415,238.78635,667.680475,306178,306306,128
108,0,blank,0,-350,-105,306338,306527,189
108,0,blank,0,-350,-105,306527,306682,155
108,0,blank,0,-350,-105,306682,306845,163
108,0,blank,0,-350,-105,306845,307027,182
108,0,blank,0,-350,-105,307027,307215,188
108,0,blank,0,-350,-105,307215,307359,144
108,0,blank,0,-350,-105,307359,307472,113
108,0,blank,0,315.942933333333,-103.9671,307554,307640,86
