Frameno_fix,lineno_fix,Tokenname_fix,tokens_id,gaze_X_fix,gaze_Y_fix,timestamp_fix_start,timestamp_fix_end,time_duration
100,0,blank,0,453.41744,1.32338,4571,4748,177
100,0,blank,0,472.7693,152.131333333333,4835,5006,171
100,0,blank,0,453.5417,103.91655,5006,5069,63
100,0,blank,0,434.069433333333,40.0616,5099,5190,91
100,0,blank,0,-350,-105,5221,5377,156
100,0,blank,0,299.081683333333,24.6307166666667,5407,5600,193
100,0,blank,0,476.437066666667,3.42273333333334,5600,5707,107
100,0,blank,0,477.68105,1.0727,5754,5921,167
100,1,Anagrams,11,477.487575,5.080075,5921,6096,175
100,1,Anagrams,11,473.51255,13.299325,6096,6264,168
100,1,are,10,428.56235,9.942725,6264,6435,171
100,0,blank,0,438.7817,39.30085,6435,6521,86
100,1,are,10,438.8471,17.751,6552,6582,30
100,1,are,10,437.5867,4.16551666666666,6614,6808,194
100,0,blank,0,436.4257,0.897400000000005,6808,6841,33
100,1,are,10,421.893983333333,7.5556,6872,7066,194
100,1,are,10,421.262783333333,7.91393333333334,7066,7259,193
100,11,array1,64,268.20105,233.728816666667,7292,7491,199
100,0,blank,0,211.30936,265.9751,7526,7694,168
100,13,"%sand%sareanagrams.\n",77,210.72685,271.2316,7694,7763,69
100,0,blank,0,-16.967375,114.299675,7837,8033,196
100,0,blank,0,-350,-105,8033,8216,183
100,0,blank,0,-350,-105,8216,8394,178
100,0,blank,0,-350,-105,8394,8575,181
100,0,blank,0,-350,-105,8575,8714,139
100,0,blank,0,260.2298,266.757325,8748,8907,159
100,13,"%sand%sareanagrams.\n",77,317.3474,281.87732,8938,9094,156
100,13,"%sand%sareanagrams.\n",77,353.23498,270.41506,9125,9282,157
100,13,array1,79,503.1921,278.700033333333,9314,9408,94
100,0,blank,0,514.8523,277.765266666667,9439,9532,93
100,0,blank,0,513.187666666667,298.356616666667,9563,9749,186
100,7,"Enterthestring\n",42,283.039133333333,153.040233333333,9785,9915,130
100,0,blank,0,273.255066666667,162.713666666667,9945,10037,92
100,0,blank,0,220.95216,123.40436,10067,10255,188
100,7,"Enterthestring\n",42,206.0689,154.26165,10286,10350,64
100,0,blank,0,206.681066666667,167.982066666667,10384,10486,102
100,9,"Enteranotherstring\n",52,276.2153,186.9887,10516,10547,31
100,9,"Enteranotherstring\n",52,264.459366666667,184.820633333333,10578,10673,95
100,0,blank,0,329.5336,177.08915,10704,10767,63
100,9,"Enteranotherstring\n",52,328.1798,180.6273,10799,10862,63
100,9,"Enteranotherstring\n",52,251.8035,182.8909,10893,10925,32
100,0,blank,0,247.63545,175.012,10956,11020,64
100,0,blank,0,222.01355,171.623383333333,11051,11236,185
100,9,"Enteranotherstring\n",52,226.2891,186.3507,11236,11267,31
100,0,blank,0,-350,-105,11298,11482,184
100,0,blank,0,-350,-105,11482,11610,128
100,0,blank,0,291.39876,46.96406,11639,11790,151
100,0,blank,0,259.457525,68.836675,11821,11941,120
100,0,blank,0,198.2642,88.4261666666667,11941,12126,185
100,0,blank,0,104.563033333333,0.345533333333336,12126,12229,103
100,0,blank,0,999.5,120.169,12229,12755,526
100,0,blank,0,1002.035,124.7879,12755,12788,33
100,0,blank,0,996.653,127.227,13145,13333,188
100,0,blank,0,994.7244,128.34082,13333,13491,158
100,0,blank,0,993.4835,119.14115,13522,13584,62
100,0,blank,0,991.8065,125.74425,13616,13740,124
100,0,blank,0,-350,-105,13771,13960,189
100,0,blank,0,729.0956,72.50802,13991,14160,169
100,0,blank,0,993.113666666667,132.278066666667,14160,14350,190
100,0,blank,0,991.877333333333,132.372583333333,14382,14575,193
100,0,blank,0,996.410833333333,132.998733333333,14575,14768,193
100,0,blank,0,990.8,121.0372,14768,14801,33
100,0,blank,0,991.063,142.6453,14833,14896,63
100,0,blank,0,-350,-105,14960,15042,82
100,0,blank,0,-2.09695000000001,-29.552025,15071,15244,173
100,0,blank,0,106.55134,25.9799,15244,15407,163
100,1,Check,6,159.15546,18.03444,15440,15599,159
100,0,blank,0,344.658925,200.722225,15720,15905,185
100,0,blank,0,125.1788,42.2977,15905,15935,30
100,0,blank,0,-283.9125,-83.7651285714286,15979,16173,194
100,0,blank,0,-350,-105,16173,16345,172
100,5,100,34,184.3104,105.1697,16376,16396,20
100,5,array1,27,149.379366666667,92.2559666666667,16426,16518,92
100,0,blank,0,186.2329,85.0179666666667,16549,16741,192
100,0,blank,0,199.726233333333,89.0974,16741,16838,97
100,0,blank,0,203.49786,100.51864,16870,17027,157
100,5,],35,195.87405,99.8172,17059,17120,61
100,5,100,34,302.205016666667,100.19225,17152,17338,186
100,5,],35,325.312783333333,110.001716666667,17369,17553,184
100,0,blank,0,208.72165,116.59335,17553,17676,123
100,0,blank,0,171.06785,126.643125,17706,17836,130
100,7,"Enterthestring\n",42,177.2592,151.2216,17869,17902,33
100,0,blank,0,221.0773,209.040733333333,17934,18029,95
100,7,"Enterthestring\n",42,149.599483333333,136.39255,18061,18250,189
100,7,"Enterthestring\n",42,155.059925,137.237575,18282,18406,124
100,7,"Enterthestring\n",42,257.84375,141.6217,18437,18499,62
100,7,"Enterthestring\n",42,262.03095,135.50275,18530,18592,62
100,7,"Enterthestring\n",42,295.3441,143.921866666667,18622,18716,94
100,0,blank,0,-59.081,18.3158333333333,18747,18930,183
100,0,blank,0,-350,-105,18930,19057,127
100,0,blank,0,12.3882,43.9249666666667,19088,19193,105
100,0,blank,0,253.22385,131.5624,19226,19351,125
100,7,"Enterthestring\n",42,198.239216666667,150.016666666667,19383,19575,192
100,0,blank,0,172.26265,163.81695,19575,19640,65
100,8,;,49,164.83504,171.04832,19671,19831,160
100,8,array1,47,150.11635,161.7672,19863,19926,63
100,2,stdio,17,119.791775,26.98165,19956,20108,152
100,0,blank,0,115.76254,25.18704,20134,20292,158
100,9,"Enteranotherstring\n",52,184.748433333333,199.836966666667,20323,20508,185
100,0,blank,0,207.6555,204.8992,20539,20571,32
100,9,"Enteranotherstring\n",52,221.341233333333,196.922966666667,20602,20787,185
100,0,blank,0,261.6929,173.5739,20787,20818,31
100,9,"Enteranotherstring\n",52,297.058066666667,182.5909,20849,21029,180
100,9,"Enteranotherstring\n",52,274.111816666667,191.213533333333,21029,21221,192
100,9,"Enteranotherstring\n",52,248.003166666667,199.9925,21221,21319,98
100,0,blank,0,-350,-105,21349,21513,164
100,0,blank,0,192.1698,161.2622,21588,21772,184
100,0,blank,0,193.7611,161.4357,21803,21834,31
100,0,blank,0,203.23015,206.9351,21865,21928,63
100,0,blank,0,194.109833333333,203.570116666667,21960,22150,190
100,0,blank,0,191.895525,205.21245,22150,22276,126
100,10,),58,154.9019,212.390133333333,22307,22400,93
100,10,array2,57,152.756775,216.4967,22432,22554,122
100,10,array2,57,150.5763,214.11605,22588,22718,130
100,10,array2,57,152.831566666667,202.46395,22750,22938,188
100,8,array1,47,153.09675,164.60835,22938,23003,65
100,9,"Enteranotherstring\n",52,195.23195,186.8311,23038,23105,67
100,0,blank,0,243.10385,161.405225,23136,23263,127
100,0,blank,0,226.2756,125.17522,23324,23475,151
100,7,"Enterthestring\n",42,220.70884,149.87098,23568,23756,188
100,0,blank,0,-110.44476,-4.628,23756,23947,191
100,0,blank,0,-350,-105,23947,24077,130
100,5,[,33,288.619133333333,106.810933333333,24125,24298,173
100,0,blank,0,302.33925,121.10465,24330,24394,64
100,0,blank,0,198.5718,156.970066666667,24426,24524,98
100,0,blank,0,363.0522,555.5493,24524,24711,187
100,0,blank,0,322.5367,449.0933,24711,24778,67
100,0,blank,0,389.1789,648.1683,24778,24965,187
100,0,blank,0,157.622525,297.364275,24965,25141,176
100,9,"Enteranotherstring\n",52,115.017633333333,187.230933333333,25141,25277,136
100,9,(,51,106.8511,190.9097,25277,25363,86
100,0,blank,0,184.994433333333,173.630166666667,25412,25550,138
100,0,blank,0,-350,-105,25593,25790,197
100,0,blank,0,-350,-105,25790,25968,178
100,0,blank,0,-350,-105,25968,26161,193
100,0,blank,0,-350,-105,26161,26266,105
100,0,blank,0,-39.1354666666667,132.869033333333,26285,26469,184
100,12,flag,71,95.7626666666667,246.265066666667,26469,26622,153
100,10,array2,57,111.101925,204.725625,26622,26811,189
100,9,"Enteranotherstring\n",52,121.6364,195.027733333333,26811,26905,94
100,10,array2,57,118.0514,210.3853,26934,26964,30
100,9,"Enteranotherstring\n",52,125.2611,197.916825,26995,27116,121
100,0,blank,0,226.003666666667,208.156366666667,27146,27237,91
100,0,blank,0,254.245716666667,203.71985,27267,27449,182
100,0,blank,0,256.6198,209.9341,27480,27510,30
100,0,blank,0,335.010925,213.09305,27540,27661,121
100,0,blank,0,333.96746,209.52226,27692,27844,152
100,0,blank,0,220.9165,206.10775,27874,27995,121
100,0,blank,0,-350,-105,28026,28159,133
100,6,int,37,55.9794,127.48825,28204,28349,145
100,0,blank,0,286.64836,203.79236,28379,28531,152
100,0,blank,0,318.957275,207.2226,28561,28684,123
100,9,"Enteranotherstring\n",52,159.02915,199.3197,28714,28775,61
100,10,),58,161.20635,203.67905,28814,28879,65
100,11,find_anagram,62,167.923933333333,236.207266666667,28910,29011,101
100,11,find_anagram,62,163.989,231.0173,29050,29112,62
100,11,find_anagram,62,209.8252,239.08775,29143,29205,62
100,11,find_anagram,62,209.8737,237.581175,29236,29355,119
100,0,blank,0,183.45035,254.821675,29385,29509,124
100,0,blank,0,182.9258,265.3038,29539,29570,31
100,0,blank,0,301.7621,259.6212,29601,29632,31
100,0,blank,0,307.6378,251.23325,29663,29723,60
100,0,blank,0,414.9678,255.77165,29754,29816,62
100,0,blank,0,411.2366,236.448,29848,29879,31
100,0,blank,0,524.3867,260.81905,29913,30102,189
100,0,blank,0,526.17945,254.499475,30102,30227,125
100,0,blank,0,536.4987,241.6447,30259,30291,32
100,13,array2,81,579.3845,268.7082,30324,30355,31
100,11,array2,66,372.015066666667,240.1076,30388,30484,96
100,11,array2,66,374.874866666667,241.502333333333,30515,30611,96
100,0,blank,0,307.9666,250.7729,30643,30675,32
100,11,array1,64,310.4686,239.6979,30707,30738,31
100,0,blank,0,316.0889,239.324366666667,30770,30861,91
100,11,array2,66,337.01,227.3948,30892,30923,31
100,0,blank,0,-350,-105,30953,31092,139
100,8,array1,47,105.1178,161.50345,31117,31243,126
100,13,"%sand%sareanagrams.\n",77,292.630433333333,283.919916666667,31273,31455,182
100,13,"%sand%sareanagrams.\n",77,358.0658,283.031425,31455,31580,125
100,0,blank,0,230.13485,292.557416666667,31609,31808,199
100,13,"%sand%sareanagrams.\n",77,176.4068,281.6192,31808,31841,33
100,0,blank,0,138.998216666667,289.733266666667,31871,32059,188
100,0,blank,0,177.23655,332.383675,32095,32219,124
100,15,(,86,148.603466666667,327.0201,32251,32348,97
100,0,blank,0,152.263,333.1733,32381,32412,31
100,0,blank,0,149.06344,354.73976,32443,32604,161
100,0,blank,0,135.4723,360.35155,32636,32701,65
100,18,char,106,205.6104,386.88205,32736,32801,65
100,18,char,106,204.45908,378.54094,32834,33001,167
100,0,blank,0,176.8749,376.5382,33034,33066,32
100,0,blank,0,179.701566666667,365.356566666667,33099,33196,97
100,0,blank,0,310.526575,364.33235,33228,33357,129
100,0,blank,0,310.54435,375.4361,33389,33451,62
100,0,blank,0,265.6652,354.251133333333,33483,33577,94
100,0,blank,0,431.84998,368.5114,33609,33767,158
100,0,blank,0,883.07466,217.7389,33798,33962,164
100,0,blank,0,919.566,183.53795,33962,34093,131
100,0,blank,0,947.97875,164.89275,34124,34248,124
100,0,blank,0,945.258333333334,171.22,34279,34466,187
100,0,blank,0,-350,-105,34496,34670,174
100,0,blank,0,182.65435,349.769783333333,34718,34897,179
100,0,blank,0,164.382083333333,360.2745,34897,35085,188
100,0,blank,0,175.0826,351.6947,35085,35117,32
100,0,blank,0,157.6221,341.086,35148,35179,31
100,0,blank,0,168.5711,337.35715,35212,35272,60
100,0,blank,0,178.4384,333.5661,35304,35335,31
100,0,blank,0,177.05745,292.84385,35366,35429,63
100,23,array1,147,177.28755,491.773925,35460,35585,125
100,0,blank,0,507.928083333333,709.601533333333,35616,35809,193
100,0,blank,0,517.5242,718.8947,35809,35840,31
100,0,blank,0,510.64,700.3982,35871,35902,31
101,0,blank,0,136.67725,221.422,36366,36428,62
102,0,blank,0,45.6857,236.304,37071,37248,177
102,0,blank,0,43.9427,237.4718,37248,37343,95
102,0,blank,0,94.03642,244.08054,37376,37535,159
102,0,blank,0,101.7933,233.2722,37566,37597,31
102,18,find_anagram,99,100.3147,247.2609,37629,37661,32
102,0,blank,0,96.5009,244.37775,37692,37755,63
102,0,blank,0,162.68,230.8647,37787,37819,32
102,0,blank,0,170.544125,240.54795,37851,37977,126
102,0,blank,0,168.192866666667,230.470966666667,38010,38103,93
102,0,blank,0,-350,-105,38134,38324,190
102,0,blank,0,-350,-105,38324,38350,26
102,0,blank,0,151.8918,226.4969,38401,38462,61
102,0,blank,0,212.962116666667,224.944716666667,38503,38679,176
102,0,blank,0,336.19365,229.18665,38710,38898,188
102,18,char,106,215.6608,262.34615,38929,38991,62
102,18,char,106,215.4538,261.415066666667,39022,39116,94
102,0,blank,0,117.0901,271.315625,39146,39274,128
102,0,blank,0,28.23875,632.640483333333,39305,39489,184
102,0,blank,0,20.5293666666667,689.670833333333,39520,39613,93
102,0,blank,0,33.979,682.0897,39643,39674,31
102,0,blank,0,28.7827,681.10475,39706,39766,60
102,38,},222,5.22989999999999,701.572366666667,39797,39888,91
102,0,blank,0,754.525575,309.685825,39919,40075,156
102,0,blank,0,887.237,256.304,40107,40141,34
102,0,blank,0,905.875,254.3454,40173,40205,32
102,0,blank,0,938.491666666667,203.411033333333,40237,40333,96
102,0,blank,0,940.49325,204.030925,40364,40491,127
102,0,blank,0,943.019,213.82785,40522,40586,64
102,0,blank,0,940.093,213.876166666667,40619,40716,97
102,0,blank,0,945.591,219.2726,40748,40812,64
102,0,blank,0,947.67,453.480075,40844,40974,130
102,0,blank,0,945.022,676.11365,41007,41073,66
102,0,blank,0,947.963,723.90065,41105,41170,65
102,0,blank,0,939.6085,739.0362,41204,41397,193
102,0,blank,0,191.35655,662.156566666667,41429,41625,196
102,0,blank,0,82.6993666666667,686.285833333333,41659,41855,196
102,0,blank,0,71.8285166666667,268.317733333333,41889,42083,194
102,18,find_anagram,99,54.46055,257.0354,42114,42178,64
102,0,blank,0,-350,-105,42211,42400,189
102,0,blank,0,-57.5682666666667,138.447166666667,42435,42536,101
102,0,blank,0,94.18462,272.26186,42571,42726,155
102,0,blank,0,190.935725,287.06965,42758,42896,138
102,0,blank,0,181.8951,284.8271,42927,42958,31
102,0,blank,0,193.8464,278.1478,42990,43022,32
102,0,blank,0,257.157666666667,276.2688,43053,43148,95
102,0,blank,0,259.191425,284.068175,43180,43324,144
102,0,blank,0,235.8406,277.764,43357,43389,32
102,0,blank,0,246.467733333333,287.311033333333,43421,43517,96
102,0,blank,0,242.11535,295.7766,43549,43614,65
102,0,blank,0,246.3317,268.3665,43646,43678,32
102,0,blank,0,242.830133333333,285.03815,43711,43901,190
102,18,array1,102,240.859866666667,247.7631,43933,44027,94
102,0,blank,0,240.7128,236.503525,44059,44184,125
102,0,blank,0,347.93865,231.06695,44215,44277,62
102,0,blank,0,238.6887,178.974516666667,44308,44496,188
102,0,blank,0,-350,-105,44496,44629,133
102,0,blank,0,74.8434333333333,126.170533333333,44656,44757,101
102,0,blank,0,181.507,235.8594,44790,44854,64
102,0,blank,0,181.5321,246.1453,44886,44918,32
102,0,blank,0,174.9459,237.96965,44950,45118,168
102,0,blank,0,-350,-105,45118,45326,208
102,0,blank,0,-350,-105,45326,45502,176
102,0,blank,0,-350,-105,45502,45698,196
102,0,blank,0,-350,-105,45698,45877,179
102,0,blank,0,-350,-105,45877,45936,59
102,18,char,106,195.5853,252.4775,45954,45981,27
102,0,blank,0,201.9742,226.4049,46022,46053,31
102,0,blank,0,199.907,229.698233333333,46085,46182,97
102,0,blank,0,162.8244,233.080425,46213,46347,134
102,0,blank,0,206.5857,224.178,46379,46410,31
102,0,blank,0,210.46205,226.4809,46444,46640,196
102,0,blank,0,199.3737,234.421,46640,46674,34
102,0,blank,0,175.75185,237.704166666667,46706,46903,197
102,0,blank,0,162.00035,246.48795,46936,47001,65
102,0,blank,0,169.7769,246.1533,47035,47133,98
102,0,blank,0,220.8985,231.1339,47166,47199,33
102,0,blank,0,220.706525,244.861025,47231,47361,130
102,0,blank,0,-350,-105,47394,47573,179
102,0,blank,0,220.746,232.5457,47629,47663,34
102,0,blank,0,226.47495,241.3144,47701,47764,63
102,0,blank,0,215.61415,235.259033333333,47797,47993,196
102,18,char,106,205.429175,252.116925,47993,48125,132
102,18,char,106,213.7461,249.696,48159,48192,33
102,18,find_anagram,99,164.8626,250.080825,48225,48360,135
102,0,blank,0,173.651,236.694,48392,48459,67
102,0,blank,0,213.039525,242.254125,48491,48620,129
102,0,blank,0,-350,-105,48653,48848,195
102,0,blank,0,-350,-105,48848,48898,50
102,0,blank,0,161.32148,174.94844,48955,49125,170
102,18,char,106,353.001733333333,249.506833333333,49125,49224,99
102,0,blank,0,379.10388,236.79142,49256,49418,162
102,0,blank,0,384.5841,233.0272,49450,49482,32
102,0,blank,0,87.3512333333333,163.361666666667,49515,49611,96
102,0,blank,0,84.048025,164.692825,49644,49776,132
102,0,blank,0,340.430366666667,240.1685,49808,49907,99
102,0,blank,0,-350,-105,49940,50130,190
102,0,blank,0,-350,-105,50130,50308,178
102,0,blank,0,-350,-105,50308,50506,198
102,0,blank,0,-350,-105,50506,50685,179
102,0,blank,0,-350,-105,50685,50863,178
102,0,blank,0,-350,-105,50863,50980,117
102,0,blank,0,-350,-105,50980,51083,103
102,0,blank,0,-350,-105,51083,51257,174
102,0,blank,0,-350,-105,51257,51426,169
102,8,(,46,88.2893,41.3628,51571,52084,513
102,0,blank,0,81.7659,48.0753,52084,52117,33
102,7,printf,40,88.9622666666667,25.4127333333333,52142,52239,97
102,10,),58,157.489333333333,75.1004666666667,52272,52467,195
102,10,),58,155.5806,71.3284,52467,52531,64
102,0,blank,0,236.453633333333,83.23155,52563,52758,195
102,0,blank,0,241.70725,86.6296,52758,52830,72
102,0,blank,0,-350,-105,52863,52971,108
102,0,blank,0,78.75595,2.2886,53017,53171,154
102,0,blank,0,247.44836,70.03876,53206,53385,179
102,0,blank,0,241.9878,73.8782,53385,53417,32
102,9,"Enteranotherstring\n",52,119.64704,53.65258,53449,53626,177
102,9,printf,50,99.3405,51.36115,53666,53736,70
102,9,(,51,105.1803,59.3692,53768,53831,63
102,0,blank,0,113.17485,4.613375,53863,53996,133
102,0,blank,0,-350,-105,54029,54170,141
102,7,(,41,112.0377,12.4075,54212,54364,152
102,7,"Enterthestring\n",42,144.433025,19.468825,54364,54551,187
102,7,"Enterthestring\n",42,164.72985,22.4534,54551,54733,182
102,7,"Enterthestring\n",42,156.6705,9.961825,54733,54909,176
102,0,blank,0,309.032,124.860633333333,54909,55090,181
102,0,blank,0,297.983,122.7344,55090,55134,44
102,11,array2,66,334.94014,96.69318,55178,55349,171
102,11,array2,66,343.5359,106.1246,55349,55380,31
102,0,blank,0,328.8531,87.942,55411,55443,32
102,0,blank,0,-350,-105,55478,55617,139
102,9,"Enteranotherstring\n",52,205.661983333333,59.2517,55642,55822,180
102,0,blank,0,317.645333333333,80.1389333333333,55822,55916,94
102,11,array1,64,291.67682,100.94862,55947,56107,160
102,0,blank,0,236.5842,91.169775,56141,56266,125
102,18,char,106,336.144066666667,248.9605,56298,56392,94
102,18,char,106,335.34395,253.0022,56424,56486,62
102,0,blank,0,-350,-105,56517,56692,175
102,0,blank,0,229.68825,243.2372,56866,57034,168
102,18,char,106,231.46455,264.4163,57034,57208,174
102,0,blank,0,242.039525,233.6295,57208,57383,175
102,0,blank,0,250.1277,241.761075,57383,57558,175
102,18,char,106,220.7651,250.207233333333,57558,57691,133
102,0,blank,0,-249.42045,-48.93415,57734,57923,189
102,0,blank,0,-350,-105,57923,57949,26
102,0,blank,0,276.5297,238.9535,57997,58058,61
102,0,blank,0,308.377866666667,238.653666666667,58102,58184,82
102,18,],109,307.877833333333,247.072733333333,58215,58311,96
102,0,blank,0,299.13665,229.9512,58342,58405,63
102,0,blank,0,311.52905,234.58355,58437,58498,61
102,0,blank,0,305.52055,242.09455,58530,58592,62
102,0,blank,0,415.910083333333,244.945033333333,58623,58812,189
102,0,blank,0,418.07605,233.94415,58844,58906,62
102,0,blank,0,153.966333333333,283.912616666667,58938,59125,187
102,0,blank,0,125.47055,278.6984,59156,59219,63
102,0,blank,0,-350,-105,59251,59416,165
102,18,find_anagram,99,95.8623,258.64175,59442,59605,163
102,0,blank,0,83.994,271.4295,59605,59642,37
102,0,blank,0,82.2653,286.8804,59695,59738,43
102,0,blank,0,126.7094,291.072433333333,59784,59920,136
102,0,blank,0,-249.97664,-7.45782,59966,60150,184
102,0,blank,0,-350,-105,60150,60331,181
102,0,blank,0,-350,-105,60331,60510,179
102,0,blank,0,-350,-105,60510,60690,180
102,0,blank,0,-350,-105,60690,60762,72
102,0,blank,0,-134.4208,95.75595,60809,60933,124
102,0,blank,0,-350,-105,60933,61143,210
102,0,blank,0,-350,-105,61143,61178,35
102,0,blank,0,-350,-105,61178,61766,588
102,0,blank,0,-350,-105,61766,61933,167
102,0,blank,0,-350,-105,61933,62053,120
102,0,blank,0,148.7836,678.1013,62093,62522,429
102,13,(,76,145.560466666667,151.4344,62522,62688,166
102,0,blank,0,-248.30632,-26.28084,62717,62904,187
102,0,blank,0,-350,-105,62904,63082,178
102,0,blank,0,-350,-105,63082,63270,188
102,0,blank,0,-350,-105,63270,63447,177
102,0,blank,0,-350,-105,63447,63504,57
102,0,blank,0,-350,-105,63504,63688,184
102,0,blank,0,-350,-105,63688,63919,231
102,0,blank,0,-350,-105,63919,63950,31
102,0,blank,0,-350,-105,63950,64182,232
102,0,blank,0,-350,-105,64182,64411,229
102,0,blank,0,-350,-105,64411,64588,177
102,0,blank,0,-350,-105,64588,64780,192
102,20,=,132,175.5836,303.2839,64934,65111,177
102,20,],125,157.99765,311.08355,65111,65282,171
102,0,blank,0,163.9204,301.4467,65282,65350,68
102,0,blank,0,206.6561,312.9549,65452,65632,180
102,20,[,123,289.656833333333,303.199833333333,65747,65946,199
102,21,0,142,278.33325,314.7251,65946,66031,85
102,20,num2,122,275.69425,307.860025,66075,66249,174
102,0,blank,0,242.8877,309.75594,66292,66474,182
102,0,blank,0,242.322,314.926666666667,66474,66565,91
102,0,blank,0,215.878683333333,314.4318,66596,66782,186
102,20,0,133,207.3618,311.3209,66782,66813,31
102,0,blank,0,-350,-105,66876,67020,144
102,0,blank,0,239.4756,310.3736,67068,67106,38
102,20,comma,130,225.09265,305.28295,67138,67192,54
102,20,},129,219.26795,306.904916666667,67220,67407,187
102,21,0,142,255.4521,314.6165,67439,67626,187
102,0,blank,0,310.830516666667,315.03145,67658,67845,187
102,0,blank,0,308.14385,317.0808,67845,67907,62
102,20,26,124,303.24405,311.57185,67937,68000,63
102,0,blank,0,318.855933333333,312.305533333333,68031,68125,94
102,0,blank,0,319.1711,319.455566666667,68156,68251,95
102,0,blank,0,272.9209,352.11745,68283,68407,124
102,23,-,151,235.11735,362.1441,68438,68562,124
102,0,blank,0,-350,-105,68593,68757,164
102,0,blank,0,-350,-105,68757,68794,37
102,0,blank,0,108.132783333333,281.843783333333,68844,69030,186
102,23,array1,147,187.61088,362.83784,69030,69188,158
102,23,array1,147,187.8436,365.062225,69220,69343,123
102,0,blank,0,335.89125,361.3659,69374,69498,124
102,0,blank,0,335.678,363.131866666667,69529,69621,92
102,0,blank,0,281.80055,361.113783333333,69651,69837,186
102,23,],153,284.7943,362.19475,69869,69932,63
102,0,blank,0,257.6952,351.562133333333,69962,70055,93
102,0,blank,0,253.8576,351.9198,70086,70147,61
102,0,blank,0,257.901566666667,355.549133333333,70177,70270,93
102,0,blank,0,311.312166666667,357.353333333333,70301,70394,93
102,0,blank,0,324.731725,365.832625,70426,70552,126
102,0,blank,0,325.9131,359.8732,70584,70616,32
102,0,blank,0,-350,-105,70647,70805,158
102,0,blank,0,201.8482,275.3794,70833,71026,193
102,23,;,155,316.6948,361.0567,71026,71056,30
102,0,blank,0,302.8528,351.0018,71087,71119,32
102,23,;,155,321.181183333333,362.3407,71150,71337,187
102,23,;,155,319.075425,364.426225,71337,71464,127
102,23,a,152,268.61665,362.157133333333,71496,71686,190
102,23,a,152,270.16396,361.34962,71686,71843,157
102,0,blank,0,239.6581,356.809833333333,71874,72060,186
102,23,-,151,240.007433333333,362.3815,72060,72246,186
102,0,blank,0,243.8699,365.086366666667,72246,72340,94
102,23,a,152,267.213775,362.42215,72371,72496,125
102,0,blank,0,-350,-105,72558,72740,182
102,0,blank,0,-350,-105,72795,72968,173
102,0,blank,0,144.825083333333,278.514,73003,73198,195
102,23,a,152,268.676566666667,363.46035,73230,73417,187
102,23,a,152,275.571933333333,370.396333333333,73417,73509,92
102,23,-,151,239.7481,361.28265,73540,73725,185
102,0,blank,0,245.8877,366.5077,73725,73788,63
102,0,blank,0,247.6506,359.1248,73818,73848,30
102,0,blank,0,264.6074,353.51135,73879,73940,61
102,23,a,152,265.753666666667,358.235966666667,73971,74061,90
102,23,a,152,274.0078,358.5781,74092,74122,30
102,23,;,155,317.81906,363.68008,74153,74306,153
102,23,++,154,311.6691,359.8598,74337,74458,121
102,0,blank,0,-350,-105,74489,74684,195
102,0,blank,0,-350,-105,74684,74847,163
102,0,blank,0,-350,-105,74847,74896,49
102,21,array1,137,154.998575,319.4733,74932,75119,187
102,0,blank,0,317.609833333333,387.297016666667,75119,75308,189
102,0,blank,0,319.1519,354.13945,75308,75375,67
102,20,{,127,359.12575,303.9202,75407,75533,126
102,20,{,127,362.59855,307.56585,75565,75629,64
102,0,blank,0,329.3259,368.236733333333,75660,75755,95
102,0,blank,0,353.89655,423.327725,75878,76060,182
102,0,blank,0,335.25445,453.318925,76060,76205,145
102,0,blank,0,183.54006,345.2464,76205,76394,189
102,0,blank,0,332.8371,482.9247,76460,76487,27
102,29,;,184,309.15678,491.04472,76520,76712,192
102,0,blank,0,335.27695,575.8296,76712,76768,56
102,0,blank,0,-113.861166666667,88.8714333333333,76799,76980,181
102,0,blank,0,-350,-105,76980,77162,182
102,0,blank,0,-350,-105,77162,77316,154
102,0,blank,0,241.5455,404.2782,77346,77452,106
102,0,blank,0,211.79595,356.06165,77452,77598,146
102,0,blank,0,391.6386,558.9335,77691,77806,115
102,23,[,148,199.26065,374.0023,77806,78005,199
102,0,blank,0,319.6556,436.5759,78005,78209,204
102,0,blank,0,-135.3495,55.2867,78209,78406,197
102,0,blank,0,-350,-105,78406,78584,178
102,0,blank,0,-350,-105,78584,78773,189
102,23,array1,147,176.782133333333,363.833533333333,78834,79028,194
102,0,blank,0,-81.29095,124.535875,79028,79206,178
102,0,blank,0,-350,-105,79206,79381,175
102,0,blank,0,-350,-105,79381,79562,181
102,0,blank,0,-350,-105,79562,79742,180
102,0,blank,0,-350,-105,79742,79934,192
102,0,blank,0,-350,-105,79934,80078,144
102,0,blank,0,-350,-105,80078,80195,117
102,0,blank,0,-350,-105,80195,80373,178
102,0,blank,0,-350,-105,80373,80410,37
102,0,blank,0,136.0204,356.29505,80427,80533,106
102,0,blank,0,173.3345,286.2829,80575,80616,41
102,0,blank,0,183.765225,281.869625,80660,80834,174
102,0,blank,0,225.618925,289.95305,80834,81008,174
102,20,comma,130,225.284883333333,295.069016666667,81042,81226,184
102,0,blank,0,248.79504,361.0779,81258,81412,154
102,0,blank,0,-350,-105,81443,81601,158
102,0,blank,0,146.094583333333,274.87225,81626,81796,170
102,0,blank,0,245.8558,356.6621,81796,81827,31
102,23,a,152,263.75648,360.7415,81859,82016,157
102,0,blank,0,237.2879,355.84,82047,82169,122
102,0,blank,0,231.734833333333,356.006183333333,82199,82383,184
102,23,-,151,238.2175,360.6418,82383,82413,30
102,0,blank,0,272.2103,335.458366666667,82443,82535,92
102,0,blank,0,300.63182,277.6031,82565,82718,153
102,0,blank,0,321.40306,256.47568,82748,82899,151
102,0,blank,0,316.910733333333,253.605666666667,82930,83022,92
102,0,blank,0,227.4622,78.789,83052,83114,62
102,11,find_anagram,62,236.7841,103.5002,83144,83174,30
102,0,blank,0,239.43275,91.65135,83205,83266,61
102,0,blank,0,230.72032,80.19664,83296,83451,155
102,0,blank,0,205.0415,34.53445,83482,83544,62
102,0,blank,0,265.45,38.0904333333333,83575,83669,94
102,0,blank,0,294.21005,41.0307,83700,83761,61
102,0,blank,0,327.33345,34.74825,83791,83852,61
102,7,;,44,324.278,24.7607,83882,83912,30
102,7,"Enterthestring\n",42,154.473233333333,18.4658666666667,83942,84123,181
102,8,),48,156.2126,27.4689,84123,84151,28
102,23,a,152,265.942433333333,376.976333333333,84184,84358,174
102,0,blank,0,-32.973075,79.210875,84387,84534,147
102,0,blank,0,-350,-105,84534,84631,97
102,0,blank,0,662.95,-103.878,84662,84708,46
102,0,blank,0,-350,-105,84741,84924,183
102,0,blank,0,-350,-105,84924,85106,182
102,0,blank,0,-350,-105,85106,85300,194
102,0,blank,0,-350,-105,85300,85340,40
102,0,blank,0,-350,-105,85340,85651,311
102,0,blank,0,-350,-105,85651,85906,255
102,0,blank,0,-350,-105,85906,86161,255
102,0,blank,0,-350,-105,86161,86340,179
102,0,blank,0,160.949733333333,-13.3458666666667,86359,86518,159
102,0,blank,0,149.2027,-3.6858,86518,86717,199
102,0,blank,0,154.144375,-2.982675,86717,86875,158
102,0,blank,0,20.546725,-24.204,86875,87049,174
102,0,blank,0,-350,-105,87049,87248,199
102,0,blank,0,-350,-105,87248,87426,178
102,0,blank,0,-350,-105,87426,87619,193
102,0,blank,0,-350,-105,87619,87724,105
102,0,blank,0,186.89745,-21.0443,87740,87913,173
102,7,"Enterthestring\n",42,189.699133333333,21.7022333333333,87969,88142,173
102,0,blank,0,192.88175,34.13885,88142,88324,182
102,7,"Enterthestring\n",42,289.540925,25.494125,88355,88478,123
102,7,"Enterthestring\n",42,292.4277,16.3174,88510,88541,31
102,7,;,44,328.1679,22.3723,88572,88635,63
102,0,blank,0,330.329425,27.47055,88665,88788,123
102,0,blank,0,261.842233333333,27.3716,88818,89003,185
102,0,blank,0,180.55505,44.2931166666667,89033,89218,185
102,9,"Enteranotherstring\n",52,174.690375,51.5886,89249,89372,123
102,0,blank,0,173.24002,43.3156,89404,89559,155
102,9,"Enteranotherstring\n",52,176.1198,58.07675,89590,89652,62
102,0,blank,0,-350,-105,89686,89876,190
102,0,blank,0,-350,-105,89876,90042,166
102,0,blank,0,-350,-105,90042,90206,164
102,0,blank,0,-350,-105,90206,90376,170
102,0,blank,0,-350,-105,90376,90504,128
102,0,blank,0,-350,-105,90504,90690,186
102,0,blank,0,-350,-105,90690,90874,184
102,0,blank,0,-350,-105,90874,91065,191
102,0,blank,0,-350,-105,91065,91282,217
102,0,blank,0,-350,-105,91282,91466,184
102,0,blank,0,-350,-105,91466,91659,193
102,0,blank,0,-350,-105,91659,91839,180
102,0,blank,0,-350,-105,91839,92036,197
102,0,blank,0,-350,-105,92036,92213,177
102,0,blank,0,-350,-105,92213,92312,99
102,0,blank,0,-350,-105,92312,92418,106
102,0,blank,0,-350,-105,92418,92639,221
102,0,blank,0,-350,-105,92639,92810,171
102,0,blank,0,-350,-105,92810,92980,170
102,0,blank,0,-350,-105,92980,93157,177
102,0,blank,0,-350,-105,93157,93332,175
102,0,blank,0,-350,-105,93332,93369,37
102,0,blank,0,-350,-105,93400,93485,85
102,0,blank,0,-350,-105,93579,93751,172
102,0,blank,0,-350,-105,93751,93933,182
102,0,blank,0,-350,-105,93933,94102,169
102,0,blank,0,-350,-105,94102,94289,187
102,0,blank,0,-350,-105,94289,94465,176
102,0,blank,0,-350,-105,94465,94641,176
102,0,blank,0,-350,-105,94641,94819,178
102,0,blank,0,-350,-105,94819,94999,180
102,0,blank,0,-350,-105,94999,95176,177
102,0,blank,0,-350,-105,95176,95354,178
102,0,blank,0,-350,-105,95354,95541,187
102,0,blank,0,-350,-105,95541,95728,187
102,0,blank,0,-350,-105,95728,95894,166
102,0,blank,0,-350,-105,95894,96080,186
102,0,blank,0,-350,-105,96080,96264,184
102,0,blank,0,-350,-105,96264,96461,197
102,0,blank,0,-350,-105,96461,96635,174
102,0,blank,0,-350,-105,96635,96791,156
102,0,blank,0,-350,-105,96791,96861,70
102,0,blank,0,-350,-105,96861,97027,166
102,0,blank,0,-350,-105,97027,97217,190
102,0,blank,0,-350,-105,97217,97402,185
102,0,blank,0,-350,-105,97402,97589,187
102,0,blank,0,-350,-105,97589,97772,183
102,0,blank,0,-350,-105,97772,97889,117
102,0,blank,0,-350,-105,97889,98073,184
102,0,blank,0,-350,-105,98073,98282,209
102,0,blank,0,-350,-105,98282,98419,137
102,0,blank,0,-350,-105,98419,98599,180
102,0,blank,0,-350,-105,98599,98794,195
102,0,blank,0,-350,-105,98794,98925,131
102,0,blank,0,-350,-105,98925,99051,126
102,0,blank,0,-350,-105,99051,99155,104
102,0,blank,0,-350,-105,99155,99340,185
102,0,blank,0,-350,-105,99340,99454,114
102,0,blank,0,-350,-105,99454,99581,127
102,0,blank,0,-350,-105,99581,99763,182
102,0,blank,0,-350,-105,99763,99892,129
102,0,blank,0,306.6501,239.0798,99912,100077,165
102,20,26,124,304.61275,292.9508,100077,100215,138
102,20,26,124,311.3748,297.1586,100215,100313,98
102,0,blank,0,-107.464166666667,174.2962,100400,100583,183
102,0,blank,0,-350,-105,100583,100767,184
102,0,blank,0,-350,-105,100767,100943,176
102,0,blank,0,-350,-105,100943,101115,172
102,0,blank,0,-350,-105,101115,101188,73
102,0,blank,0,455.825925,281.513125,101220,101400,180
102,0,blank,0,468.507933333333,271.933433333333,101433,101526,93
102,0,blank,0,476.51308,275.64682,101558,101715,157
102,0,blank,0,-350,-105,101746,101937,191
102,0,blank,0,-350,-105,101937,101990,53
102,18,],109,461.27105,256.56515,102018,102063,45
102,0,blank,0,168.108816666667,282.575516666667,102094,102280,186
102,0,blank,0,159.068,274.2795,102280,102311,31
102,20,26,124,145.759733333333,297.029266666667,102342,102438,96
102,0,blank,0,218.666575,287.828425,102468,102596,128
102,0,blank,0,242.357333333333,285.379766666667,102629,102724,95
102,0,blank,0,234.7893,307.7587,102755,102786,31
102,0,blank,0,232.1875,297.9972,102817,102848,31
102,0,blank,0,208.356116666667,275.412233333333,102879,103066,187
102,18,char,106,204.42695,264.7261,103066,103128,62
102,0,blank,0,182.1648,208.9123,103159,103191,32
102,15,"%sand%sarenotanagrams.\n",87,170.38575,200.18645,103223,103285,62
102,11,find_anagram,62,182.9531,95.99565,103316,103501,185
102,11,find_anagram,62,179.0432,93.4987,103501,103532,31
102,9,"Enteranotherstring\n",52,196.9039,57.16156,103562,103717,155
102,0,blank,0,-350,-105,103748,103831,83
102,7,printf,40,86.4895,15.41,103857,103884,27
102,0,blank,0,92.62155,-0.820999999999998,103920,104095,175
102,0,blank,0,93.7739,-4.83240000000001,104095,104125,30
102,0,blank,0,109.90505,-29.5393333333333,104156,104344,188
102,0,blank,0,114.6399,-30.4519,104344,104406,62
102,0,blank,0,122.037466666667,2.56293333333333,104437,104530,93
102,0,blank,0,119.9965,4.07471666666667,104561,104748,187
102,7,"Enterthestring\n",42,123.1559,5.4479,104748,104779,31
102,0,blank,0,-350,-105,104811,105006,195
102,0,blank,0,-350,-105,105006,105142,136
102,0,blank,0,-350,-105,105142,105243,101
102,0,blank,0,126.22586,-22.75936,105274,105420,146
102,0,blank,0,827.058666666667,112.864333333333,105451,105551,100
102,0,blank,0,889.111,118.4988,105585,105651,66
102,0,blank,0,943.8055,141.736925,105685,105819,134
102,0,blank,0,943.9248,148.48922,105852,106039,187
102,0,blank,0,936.704,154.1974,106039,106154,115
102,0,blank,0,944.921,156.8616,106154,106255,101
102,0,blank,0,939.098333333333,146.653633333333,106255,106444,189
102,0,blank,0,938.008833333333,153.044333333333,106444,106640,196
102,0,blank,0,940.086,150.7241,106640,106671,31
102,0,blank,0,930.637,146.0667,106704,106736,32
102,0,blank,0,945.21175,162.310525,106768,106898,130
102,0,blank,0,931.225,111.4738,106930,106963,33
102,0,blank,0,936.393,100.9359,106996,107159,163
102,0,blank,0,930.844,51.12715,107190,107382,192
102,0,blank,0,934.298166666667,41.67325,107382,107579,197
102,0,blank,0,939.002,40.0789666666667,107579,107678,99
102,0,blank,0,943.078,32.8974,107710,107809,99
103,0,blank,0,100.58195,87.5245,108684,108878,194
103,0,blank,0,-350,-105,108909,109079,170
103,0,blank,0,-21.056325,22.174725,109123,109289,166
103,0,blank,0,86.18925,70.86775,109320,109380,60
103,0,blank,0,194.7982,72.72924,109412,109576,164
103,0,blank,0,222.642366666667,74.0704166666667,109610,109806,196
103,0,blank,0,139.396,81.2304,109839,109871,32
103,0,blank,0,142.24188,73.9355,109903,110069,166
103,0,blank,0,109.181983333333,73.53445,110102,110298,196
103,0,blank,0,-350,-105,110331,110517,186
103,0,blank,0,-350,-105,110517,110704,187
103,0,blank,0,-350,-105,110704,110775,71
103,0,blank,0,149.6985,76.65402,110805,110987,182
103,0,blank,0,251.50872,72.28084,111024,111194,170
103,0,blank,0,227.91264,72.45866,111225,111386,161
103,0,blank,0,65.40992,81.81378,111418,111584,166
103,0,blank,0,-282.16815,-82.3234166666667,111617,111793,176
103,0,blank,0,-350,-105,111793,111844,51
103,0,blank,0,-8.6095,41.02596,111880,112057,177
103,0,blank,0,90.7777833333333,76.7539166666667,112057,112255,198
103,0,blank,0,94.1604,79.3725,112255,112324,69
103,5,char,26,61.5466,97.8974,112357,112523,166
103,5,char,26,70.3366666666667,97.0895833333333,112523,112721,198
103,5,char,26,68.4565,100.0229,112721,112754,33
103,6,int,37,65.0309666666667,111.07215,112787,112982,195
103,6,int,37,66.19564,113.18598,112982,113148,166
103,5,char,26,51.7789666666667,105.030333333333,113180,113280,100
103,0,blank,0,-350,-105,113314,113422,108
103,0,blank,0,-37.5922,52.29826,113468,113664,196
103,0,blank,0,40.0273666666667,93.3310833333333,113664,113859,195
103,0,blank,0,38.58378,92.9722,113859,114028,169
103,0,blank,0,38.489725,94.690075,114028,114168,140
103,0,blank,0,-350,-105,114203,114396,193
103,0,blank,0,-350,-105,114396,114572,176
103,0,blank,0,-350,-105,114572,114769,197
103,0,blank,0,-350,-105,114769,114963,194
103,0,blank,0,-350,-105,114963,115092,129
103,0,blank,0,-350,-105,115092,115269,177
103,0,blank,0,-350,-105,115269,115424,155
103,0,blank,0,-350,-105,115424,115602,178
103,0,blank,0,-350,-105,115602,115718,116
103,0,blank,0,-350,-105,115718,115845,127
103,0,blank,0,-350,-105,115845,116016,171
103,0,blank,0,-350,-105,116016,116203,187
103,0,blank,0,-350,-105,116203,116343,140
103,7,"Enterthestring\n",42,141.82156,140.57708,116359,116535,176
103,7,"Enterthestring\n",42,130.6922,137.268566666667,116567,116756,189
103,0,blank,0,130.9798,152.9883,116756,116820,64
103,0,blank,0,-350,-105,116852,117002,150
103,0,blank,0,155.2818,82.1247833333333,117056,117246,190
103,0,blank,0,262.455875,125.782525,117246,117379,133
103,0,blank,0,202.456933333333,155.0251,117410,117515,105
103,0,blank,0,292.425,167.611,117553,117656,103
103,0,blank,0,305.56085,166.53,117689,117753,64
103,0,blank,0,247.72826,167.32736,117785,117945,160
103,0,blank,0,195.014866666667,162.6406,117977,118174,197
103,0,blank,0,254.07175,167.8189,118207,118272,65
103,0,blank,0,-350,-105,118304,118500,196
103,0,blank,0,-350,-105,118500,118604,104
103,0,blank,0,-350,-105,118604,118963,359
103,0,blank,0,247.03755,167.75355,119091,119207,116
103,0,blank,0,239.8776,170.353633333333,119207,119403,196
103,9,"Enteranotherstring\n",52,292.66585,176.0441,119403,119599,196
103,0,blank,0,276.195266666667,205.754,119647,119786,139
103,0,blank,0,245.6354,161.7813,119786,119972,186
103,0,blank,0,176.916366666667,165.798033333333,119972,120084,112
103,9,printf,50,91.69464,181.0296,120119,120287,168
103,9,printf,50,87.57044,178.37006,120287,120452,165
103,0,blank,0,-350,-105,120483,120626,143
103,0,blank,0,-47.546975,118.974675,120673,120836,163
103,9,printf,50,100.09425,193.720183333333,120836,121034,198
103,10,array2,57,105.325225,200.965525,121034,121163,129
103,10,array2,57,102.262133333333,206.3737,121194,121291,97
103,10,gets,55,50.608675,215.592475,121324,121453,129
103,10,gets,55,52.3778,207.45595,121487,121553,66
103,10,gets,55,48.7388,213.9346,121587,121748,161
103,10,array2,57,150.925966666667,215.758966666667,121781,121879,98
103,10,array2,57,145.848366666667,212.710233333333,121910,122007,97
103,10,array2,57,145.8528,212.7128,122039,122073,34
103,0,blank,0,-350,-105,122139,122325,186
103,0,blank,0,-350,-105,122325,122476,151
103,0,blank,0,30.764725,218.164675,122507,122622,115
103,10,gets,55,47.1973833333333,215.495766666667,122654,122847,193
103,10,array2,57,93.5547166666666,215.240866666667,122879,123076,197
103,0,blank,0,92.6643,219.3501,123076,123109,33
103,10,array2,57,119.965466666667,216.891066666667,123142,123335,193
103,10,;,59,171.728716666667,216.487166666667,123368,123560,192
103,0,blank,0,172.3481,210.6881,123560,123624,64
103,0,blank,0,240.40492,217.21928,123657,123819,162
103,0,blank,0,240.456433333333,213.71125,123851,124046,195
103,11,(,63,245.6341,227.25,124046,124079,33
103,11,find_anagram,62,234.76435,219.3182,124112,124302,190
103,0,blank,0,233.0248,216.2368,124302,124335,33
103,0,blank,0,250.8008,210.529325,124368,124498,130
103,0,blank,0,-350,-105,124532,124706,174
103,0,blank,0,-350,-105,124706,124888,182
103,0,blank,0,-350,-105,124888,125024,136
103,0,blank,0,305.040675,205.838725,125056,125173,117
103,11,find_anagram,62,144.76648,224.78546,125206,125374,168
103,0,blank,0,122.43696,218.4907,125407,125570,163
103,10,array2,57,121.99735,217.664,125603,125735,132
103,10,array2,57,122.092733333333,211.292583333333,125768,125962,194
103,0,blank,0,177.5004,210.7798,125994,126093,99
103,0,blank,0,-350,-105,126157,126295,138
103,0,blank,0,-78.3816,114.385933333333,126334,126481,147
103,10,gets,55,43.325,203.805,126481,126617,136
103,10,gets,55,53.59335,214.6504,126617,126805,188
103,10,gets,55,53.8337666666667,217.662666666667,126805,126909,104
103,0,blank,0,188.5529,208.9783,126949,126981,32
103,0,blank,0,203.092025,207.5405,127013,127143,130
103,10,gets,55,59.9638,202.98645,127175,127240,65
103,10,gets,55,65.4193,210.3116,127272,127305,33
103,10,gets,55,44.7711333333333,214.457466666667,127338,127435,97
103,10,gets,55,45.0563333333333,207.078083333333,127467,127658,191
103,0,blank,0,42.01845,212.1509,127658,127722,64
103,11,=,61,94.65262,229.8312,127756,127925,169
103,11,=,61,101.13968,234.38264,127925,128096,171
103,11,=,61,98.17565,235.3381,128096,128170,74
103,0,blank,0,-350,-105,128210,128320,110
103,0,blank,0,-26.32946,145.48352,128353,128531,178
103,10,gets,55,58.336025,200.40245,128531,128664,133
103,10,gets,55,56.8895833333333,203.8801,128697,128892,195
103,10,gets,55,55.7193666666667,204.482566666667,128892,128992,100
103,10,gets,55,59.97625,213.38735,129025,129094,69
103,10,gets,55,60.99165,212.3669,129127,129193,66
103,10,gets,55,44.5759,214.08256,129225,129393,168
103,10,gets,55,43.7868333333333,213.090483333333,129393,129588,195
103,0,blank,0,42.05305,220.50905,129588,129655,67
103,12,==,72,149.327266666667,256.708183333333,129688,129886,198
103,13,(,76,152.9016,266.384166666667,129886,129984,98
103,0,blank,0,290.47304,259.73202,130019,130191,172
103,0,blank,0,288.2516,249.8352,130191,130261,70
103,0,blank,0,225.24792,260.33638,130294,130464,170
103,0,blank,0,233.540475,257.4376,130464,130602,138
103,13,"%sand%sareanagrams.\n",77,235.3872,263.7936,130634,130698,64
103,13,"%sand%sareanagrams.\n",77,290.512733333333,265.088666666667,130730,130825,95
103,0,blank,0,-350,-105,130857,130992,135
103,8,array1,47,94.9149,155.1623,131018,131117,99
103,0,blank,0,215.39075,292.960325,131162,131291,129
103,0,blank,0,256.6165,294.1151,131324,131423,99
103,0,blank,0,257.919166666667,286.7995,131455,131563,108
103,0,blank,0,234.824533333333,298.7176,131596,131792,196
103,0,blank,0,237.998033333333,292.781633333333,131792,131887,95
103,0,blank,0,157.68905,306.5516,131920,131983,63
103,0,blank,0,159.3179,290.0085,132015,132047,32
103,15,"%sand%sarenotanagrams.\n",87,155.644,316.1525,132079,132112,33
103,0,blank,0,298.186483333333,296.31735,132144,132338,194
103,0,blank,0,302.2299,302.2474,132371,132404,33
103,13,printf,75,88.2946666666667,276.858733333333,132437,132539,102
103,12,(,70,82.7386,260.2072,132572,132605,33
103,0,blank,0,64.104025,306.98885,132638,132771,133
103,0,blank,0,57.9672333333333,324.913,132805,132909,104
103,0,blank,0,53.893325,325.532075,132942,133076,134
103,0,blank,0,-350,-105,133145,133327,182
103,0,blank,0,965.531,200.185266666667,133364,133560,196
103,0,blank,0,950.909333333333,191.091933333333,133594,133691,97
103,0,blank,0,941.1065,175.18455,133724,133789,65
103,0,blank,0,937.573,179.16676,133823,133989,166
103,0,blank,0,936.535,188.8484,133989,134024,35
103,0,blank,0,-350,-105,134057,134177,120
103,0,blank,0,-38.7863333333333,154.184933333333,134203,134297,94
103,0,blank,0,121.47975,297.046675,134326,134455,129
103,0,blank,0,80.270175,317.650075,134488,134618,130
103,0,blank,0,75.5566,279.8036,134651,134683,32
103,0,blank,0,55.6497,306.1475,134715,134747,32
103,0,blank,0,67.3848,281.976225,134779,134908,129
103,0,blank,0,69.7485,248.10805,134940,135004,64
103,13,printf,75,108.4305,276.2287,135035,135069,34
103,13,printf,75,112.5912,265.623475,135100,135230,130
103,13,printf,75,107.4745,264.5016,135262,135293,31
103,13,"%sand%sareanagrams.\n",77,199.447925,282.127,135325,135454,129
104,0,blank,0,-350,-105,135911,136044,133
104,18,find_anagram,99,104.2824,249.0885,136069,136085,16
104,0,blank,0,-350,-105,136177,136281,104
104,20,num1,113,111.0745,301.4623,136355,136380,25
104,0,blank,0,80.9552,287.09195,136412,136606,194
104,0,blank,0,80.3227,275.9705,136639,136673,34
104,20,num1,113,106.919325,301.8757,136706,136834,128
104,20,num1,113,103.16895,309.17485,136866,136931,65
104,0,blank,0,118.66745,283.2448,136965,137100,135
104,0,blank,0,120.053866666667,282.493116666667,137134,137330,196
104,0,blank,0,122.2936,283.94395,137330,137523,193
104,0,blank,0,125.909825,287.667825,137523,137654,131
104,0,blank,0,268.73102,287.47658,137686,137849,163
104,0,blank,0,252.417116666667,288.036433333333,137882,138078,196
104,20,num2,122,247.3071,293.6786,138078,138110,32
104,0,blank,0,319.53485,286.686066666667,138143,138335,192
104,20,=,132,334.022166666667,292.7213,138335,138431,96
104,0,blank,0,326.91085,295.4809,138464,138529,65
104,0,blank,0,-350,-105,138560,138734,174
104,0,blank,0,223.24386,212.73156,138785,138962,177
104,0,blank,0,239.461883333333,286.8149,138995,139194,199
104,0,blank,0,240.24435,284.780516666667,139227,139425,198
104,0,blank,0,254.59864,286.42334,139458,139621,163
104,0,blank,0,233.25455,282.8347,139653,139783,130
104,0,blank,0,236.05935,276.61995,139816,139881,65
104,0,blank,0,-350,-105,139914,140055,141
104,0,blank,0,-0.564420000000007,210.23502,140100,140299,199
104,0,blank,0,67.2342,289.2407,140299,140331,32
104,20,int,112,49.56975,296.040133333333,140364,140563,199
104,0,blank,0,48.1363,290.1059,140563,140630,67
104,20,{,127,201.697666666667,293.538633333333,140665,140762,97
104,0,blank,0,-350,-105,140795,140969,174
104,0,blank,0,49.8782,152.6716,141014,141119,105
104,0,blank,0,310.108966666667,284.795033333333,141152,141251,99
104,0,blank,0,330.7424,282.498183333333,141284,141477,193
104,0,blank,0,330.79025,290.57025,141477,141545,68
104,0,blank,0,327.5332,278.4389,141579,141611,32
104,20,[,123,129.31246,302.30996,141642,141806,164
104,21,(,136,109.59225,327.39245,141840,141905,65
104,20,num1,113,101.7817,311.3403,141939,141971,32
104,20,int,112,55.2869,308.96454,142004,142167,163
104,21,while,135,63.4576,316.5787,142167,142205,38
104,20,num1,113,121.03905,311.2297,142242,142380,138
104,0,blank,0,-350,-105,142416,142609,193
104,0,blank,0,-350,-105,142609,142712,103
104,20,26,124,136.27955,308.8467,142738,142858,120
104,0,blank,0,168.49286,306.75608,142891,143059,168
104,21,array1,137,173.0823,316.8116,143091,143124,33
104,20,0,133,204.04474,307.51326,143157,143325,168
104,20,},129,218.5173,300.9704,143325,143358,33
104,0,blank,0,232.26956,301.56352,143391,143556,165
104,20,comma,130,228.3295,296.8322,143556,143591,35
104,20,{,127,201.2611,295.9036,143624,143656,32
104,0,blank,0,188.995566666667,295.658533333333,143690,143885,195
104,0,blank,0,-350,-105,143917,144106,189
104,0,blank,0,-350,-105,144106,144285,179
104,0,blank,0,-350,-105,144285,144327,42
104,20,comma,130,231.8837,292.5576,144359,144375,16
104,20,num1,113,120.4893,301.9346,144412,144444,32
104,20,num1,113,119.750266666667,310.251466666667,144475,144574,99
104,20,[,123,125.6302,304.8267,144605,144670,65
104,20,},129,221.636775,302.916,144702,144831,129
104,0,blank,0,238.2882,304.010066666667,144863,144959,96
104,0,blank,0,238.18215,300.57435,144991,145183,192
104,20,num2,122,246.2603,309.3275,145183,145215,32
104,0,blank,0,240.8729,303.3278,145246,145278,32
104,20,26,124,142.00855,304.78885,145310,145375,65
104,20,26,124,143.41995,298.2993,145407,145470,63
104,20,num1,113,118.70954,307.05052,145501,145661,160
104,0,blank,0,-350,-105,145694,145830,136
104,0,blank,0,40.05486,213.30444,145858,146038,180
104,20,int,112,66.944925,307.943,146070,146200,130
104,20,int,112,58.429975,309.92705,146233,146364,131
104,20,int,112,54.6326833333333,305.719433333333,146397,146595,198
104,20,int,112,54.6492,304.61545,146595,146664,69
104,20,num1,113,123.419833333333,305.168333333333,146698,146797,99
104,20,[,123,126.7898,301.175,146856,146975,119
104,20,num1,113,121.638,297.0974,146975,147095,120
104,20,num1,113,110.3734,296.5046,147095,147180,85
104,0,blank,0,-350,-105,147228,147393,165
104,0,blank,0,-20.7094833333333,201.91875,147460,147659,199
104,18,find_anagram,99,54.0294,259.456566666667,147659,147755,96
104,20,num1,113,108.563,294.77315,147788,147917,129
104,21,while,135,58.56975,313.54545,147949,148014,65
104,20,int,112,60.0886,303.16095,148047,148112,65
104,0,blank,0,171.96125,307.753366666667,148144,148343,199
104,20,},129,215.712833333333,304.597866666667,148376,148475,99
104,20,comma,130,230.1286,309.2198,148506,148603,97
104,20,},129,222.6942,299.9268,148634,148666,32
104,0,blank,0,232.2047,311.09565,148697,148890,193
104,20,comma,130,225.1669,298.5322,148890,148922,32
104,0,blank,0,234.24505,303.49625,148954,149149,195
104,20,comma,130,231.763375,308.7091,149182,149311,129
104,20,},129,218.443866666667,308.248133333333,149344,149442,98
104,20,0,133,211.495633333333,301.8893,149474,149570,96
104,20,26,124,140.263533333333,308.9235,149602,149701,99
104,20,26,124,138.00936,310.77832,149733,149900,167
104,21,array1,137,127.311566666667,313.529,149900,150098,198
104,20,[,123,125.8344,311.598933333333,150098,150197,99
104,20,num1,113,122.78495,306.513483333333,150230,150423,193
104,20,[,123,127.17748,308.9927,150423,150586,163
104,20,[,123,125.592616666667,306.773433333333,150619,150813,194
104,20,[,123,127.71345,302.11115,150813,150946,133
104,20,[,123,128.59528,304.04398,150979,151139,160
104,20,[,123,127.06525,308.98805,151173,151238,65
104,20,[,123,125.3156,296.902,151270,151303,33
104,0,blank,0,208.8779,312.1184,151334,151366,32
104,20,0,133,211.842266666667,299.210366666667,151399,151493,94
104,0,blank,0,-350,-105,151525,151633,108
104,0,blank,0,128.734066666667,232.47935,151659,151851,192
104,0,blank,0,228.958683333333,285.5836,151851,152050,199
104,0,blank,0,229.90748,278.81268,152050,152214,164
104,0,blank,0,231.093,273.792483333333,152247,152441,194
104,0,blank,0,232.485466666667,278.100033333333,152441,152535,94
104,0,blank,0,215.332033333333,291.046766666667,152567,152663,96
104,20,},129,218.0144,292.178066666667,152696,152793,97
104,20,num1,113,123.19,301.1917,152825,152859,34
104,20,num1,113,118.6447,298.9654,152891,152923,32
104,0,blank,0,-272.560016666667,-37.3235166666667,152955,153136,181
104,0,blank,0,-350,-105,153136,153162,26
104,0,blank,0,2.67072000000001,256.66154,153214,153405,191
104,0,blank,0,124.14762,357.88634,153439,153601,162
104,0,blank,0,84.16815,355.90955,153635,153830,195
104,23,num1,145,86.6387,372.129,153830,153863,33
104,0,blank,0,-350,-105,153896,154082,186
104,0,blank,0,-350,-105,154082,154262,180
104,0,blank,0,-350,-105,154262,154392,130
104,21,],140,200.43392,323.27634,154423,154572,149
104,0,blank,0,210.03455,331.3395,154604,154668,64
104,0,blank,0,310.67435,351.06465,154701,154767,66
104,0,blank,0,313.32895,338.7466,154799,154926,127
104,0,blank,0,316.617425,342.6474,154959,155087,128
104,0,blank,0,320.777333333333,347.4782,155120,155215,95
104,0,blank,0,244.973583333333,337.450666666667,155247,155440,193
104,0,blank,0,215.8835,337.070533333333,155472,155569,97
104,0,blank,0,211.707033333333,338.611666666667,155600,155694,94
104,0,blank,0,311.1479,342.1904,155724,155887,163
104,0,blank,0,321.777366666667,347.699533333333,155919,156016,97
104,0,blank,0,324.47305,339.45795,156050,156113,63
104,0,blank,0,326.929233333333,353.1819,156146,156341,195
104,0,blank,0,322.392383333333,350.6912,156372,156568,196
104,0,blank,0,318.987716666667,345.421433333333,156568,156762,194
104,0,blank,0,322.152533333333,347.9613,156762,156950,188
104,0,blank,0,321.12045,345.443733333333,156950,157140,190
104,0,blank,0,323.690583333333,343.830066666667,157140,157328,188
104,0,blank,0,321.0465,348.6476,157361,157394,33
104,0,blank,0,217.1028,345.7616,157426,157585,159
104,0,blank,0,-350,-105,157618,157778,160
104,18,find_anagram,99,107.91706,253.80166,157821,158004,183
104,0,blank,0,215.27622,338.21066,158004,158163,159
104,0,blank,0,319.02535,345.846466666667,158195,158382,187
104,0,blank,0,317.84898,347.14322,158415,158573,158
104,0,blank,0,320.6645,339.24515,158607,158796,189
104,0,blank,0,318.620975,344.095075,158827,158952,125
104,0,blank,0,321.26392,342.77392,158982,159136,154
104,0,blank,0,-350,-105,159167,159353,186
104,0,blank,0,-350,-105,159353,159405,52
104,0,blank,0,320.98574,344.73682,159441,159595,154
104,0,blank,0,315.83185,345.374275,159627,159760,133
104,0,blank,0,293.0628,343.173733333333,159794,159895,101
104,21,0,142,275.0234,322.8867,159927,159959,32
104,0,blank,0,282.105,332.2395,159990,160022,32
104,0,blank,0,319.11845,342.58145,160055,160247,192
104,0,blank,0,321.65225,344.53475,160247,160312,65
104,0,blank,0,317.4953,333.5589,160345,160409,64
104,0,blank,0,-251.524633333333,-19.00085,160443,160619,176
104,0,blank,0,-350,-105,160619,160656,37
104,18,find_anagram,99,103.31822,247.77414,160701,160900,199
104,0,blank,0,213.6165,337.0471,160932,160964,32
104,0,blank,0,220.7208,344.25225,160997,161061,64
104,0,blank,0,210.8378,345.6018,161094,161127,33
104,0,blank,0,250.06674,347.2035,161159,161319,160
104,0,blank,0,223.174733333333,346.5749,161350,161539,189
104,0,blank,0,226.27615,343.48335,161539,161601,62
104,20,0,133,204.889083333333,306.843883333333,161634,161825,191
104,20,{,127,198.9311,302.160375,161825,161952,127
104,0,blank,0,240.20088,304.50336,161984,162143,159
104,0,blank,0,-251.690916666667,-35.9566666666667,162176,162350,174
104,0,blank,0,-350,-105,162350,162411,61
104,18,find_anagram,99,117.72784,262.96788,162455,162626,171
104,0,blank,0,225.845,363.6429,162658,162691,33
104,0,blank,0,225.44035,350.05995,162723,162787,64
104,0,blank,0,273.391275,349.1255,162819,162950,131
104,0,blank,0,188.35865,346.845116666667,162982,163175,193
104,0,blank,0,184.902,355.46685,163175,163239,64
104,0,blank,0,-274.038285714286,-39.9162571428571,163270,163469,199
104,0,blank,0,-350,-105,163469,163660,191
104,0,blank,0,238.095766666667,333.1739,163690,163777,87
104,0,blank,0,320.4202,347.8645,163811,163842,31
104,0,blank,0,319.66625,346.6183,163874,163937,63
104,0,blank,0,324.874,350.35315,163970,164034,64
104,0,blank,0,-350,-105,164066,164254,188
104,0,blank,0,-350,-105,164254,164324,70
104,0,blank,0,320.538233333333,339.4569,164358,164443,85
104,0,blank,0,-350,-105,164476,164639,163
104,18,find_anagram,99,139.61684,260.43966,164713,164912,199
104,23,a,152,260.8285,365.1895,164912,164943,31
104,0,blank,0,109.29865,344.872716666667,164975,165166,191
104,0,blank,0,81.3784,346.056966666667,165198,165387,189
104,0,blank,0,80.8560333333333,341.359333333333,165387,165484,97
104,0,blank,0,82.1898,354.2767,165515,165578,63
104,0,blank,0,211.8794,332.6172,165611,165643,32
104,0,blank,0,220.69485,345.9581,165675,165739,64
104,0,blank,0,215.942075,347.029375,165770,165898,128
104,0,blank,0,183.331933333333,338.80365,165930,166121,191
104,0,blank,0,-350,-105,166153,166320,167
104,0,blank,0,97.88444,246.32512,166349,166524,175
104,0,blank,0,212.49895,330.94465,166524,166592,68
104,0,blank,0,241.985533333333,345.2148,166625,166728,103
104,0,blank,0,244.1943,344.45925,166762,166898,136
104,0,blank,0,238.59856,348.13712,166933,167100,167
104,0,blank,0,235.813633333333,351.570566666667,167100,167200,100
104,0,blank,0,-350,-105,167267,167461,194
104,0,blank,0,-65.9205,216.323933333333,167529,167689,160
104,0,blank,0,87.0131,382.846,167729,167762,33
104,0,blank,0,74.3177,376.1709,167795,167828,33
104,0,blank,0,80.06835,372.6796,167863,167995,132
104,0,blank,0,69.3028166666667,370.39405,168027,168220,193
104,23,array1,147,182.981625,358.15115,168253,168385,132
104,0,blank,0,217.921566666667,338.120966666667,168417,168513,96
104,0,blank,0,254.995083333333,349.305316666667,168545,168735,190
104,0,blank,0,255.6201,353.197,168735,168766,31
104,0,blank,0,-350,-105,168830,169014,184
104,0,blank,0,-350,-105,169014,169194,180
104,0,blank,0,-350,-105,169194,169307,113
104,0,blank,0,-350,-105,169307,169779,472
104,0,blank,0,-350,-105,169779,169955,176
104,0,blank,0,-350,-105,169955,170116,161
104,0,blank,0,-350,-105,170116,170293,177
104,0,blank,0,-350,-105,170293,170385,92
104,0,blank,0,-350,-105,170385,170641,256
104,0,blank,0,-350,-105,170641,170840,199
104,0,blank,0,-350,-105,170840,171020,180
104,0,blank,0,120.5534,346.1585,171581,171639,58
104,23,[,148,128.0246,359.01375,171665,171725,60
104,0,blank,0,81.58755,366.57645,171756,171819,63
104,0,blank,0,83.6525,379.852733333333,171850,172044,194
104,0,blank,0,79.8836,376.1404,172077,172141,64
104,0,blank,0,-350,-105,172174,172360,186
104,24,;,158,119.895675,398.190525,172435,172606,171
104,26,;,163,97.381975,425.4992,172606,172790,184
104,0,blank,0,96.9641,422.3058,172790,172837,47
104,26,;,163,101.4537,434.3102,172884,172929,45
104,27,array2,166,138.9938,458.8929,172977,173022,45
104,27,array2,166,173.166975,458.0657,173067,173252,185
104,0,blank,0,304.547575,454.55455,173298,173457,159
104,0,blank,0,319.3517,486.86175,173488,173678,190
104,0,blank,0,315.0602,480.9711,173678,173711,33
104,29,i,178,205.863075,504.1692,173741,173867,126
104,0,blank,0,183.357633333333,517.20085,173899,174090,191
104,0,blank,0,186.5813,519.6531,174090,174153,63
104,32,<,196,191.8208,556.9017,174185,174283,98
104,0,blank,0,195.01505,561.90325,174314,174444,130
104,32,++,200,267.03886,567.31028,174476,174637,161
104,34,num2,210,238.11155,599.2991,174668,174796,128
104,34,num2,210,237.5095,602.28235,174829,174893,64
104,0,blank,0,-350,-105,174925,175112,187
104,0,blank,0,-350,-105,175112,175217,105
104,0,blank,0,335.562216666667,600.607816666667,175246,175423,177
104,0,blank,0,330.413883333333,593.623266666667,175455,175645,190
104,34,num2,210,270.00726,602.38438,175677,175833,156
104,34,num2,210,265.3375,609.66305,175863,175925,62
104,0,blank,0,261.395366666667,594.7151,175957,176050,93
104,34,num2,210,265.6266,608.7981,176081,176145,64
104,0,blank,0,-148.38185,133.8781,176177,176355,178
104,0,blank,0,-350,-105,176355,176545,190
104,0,blank,0,-350,-105,176545,176630,85
104,0,blank,0,249.0828,587.2319,176659,176676,17
104,0,blank,0,227.788866666667,602.599466666667,176711,176808,97
104,0,blank,0,224.964433333333,602.4563,176840,176936,96
104,34,i,212,288.5661,617.6943,176969,177002,33
104,34,[,211,278.4478,601.1206,177033,177065,32
104,34,),214,310.749066666667,609.6381,177097,177195,98
104,0,blank,0,323.328483333333,608.813533333333,177227,177418,191
104,0,blank,0,319.8522,597.4781,177418,177449,31
104,0,blank,0,319.012416666667,603.1033,177481,177670,189
104,0,blank,0,322.318266666667,609.425383333333,177701,177890,189
104,0,blank,0,323.1965,616.9765,177890,177923,33
104,34,num2,210,236.3684,603.22955,177954,178017,63
104,34,num2,210,236.400566666667,613.5718,178050,178241,191
104,34,i,212,293.1415,618.882033333333,178275,178371,96
104,0,blank,0,-350,-105,178404,178592,188
104,0,blank,0,186.1003,487.123366666667,178617,178799,182
104,0,blank,0,281.088416666667,583.778383333333,178799,178994,195
104,0,blank,0,283.298,590.2814,178994,179026,32
104,0,blank,0,198.18978,607.59894,179059,179216,157
104,34,],213,190.0305,617.30425,179618,179678,60
104,34,],213,189.3818,606.61746,179710,179871,161
104,0,blank,0,235.8719,564.5278,179903,179966,63
104,0,blank,0,234.72258,564.91866,179998,180160,162
104,0,blank,0,243.8799,439.8969,180193,180291,98
104,0,blank,0,245.8398,438.9423,180324,180356,32
104,0,blank,0,-350,-105,180388,180498,110
104,18,find_anagram,99,135.0974,260.26625,180524,180710,186
104,0,blank,0,238.1708,329.8521,180710,180743,33
104,0,blank,0,248.95938,340.23062,180776,180935,159
104,23,++,154,301.683,374.343416666667,180968,181155,187
104,0,blank,0,327.912883333333,366.009616666667,181155,181338,183
104,0,blank,0,331.2931,354.748366666667,181338,181430,92
104,0,blank,0,-350,-105,181460,181645,185
104,0,blank,0,-350,-105,181645,181728,83
104,20,num2,122,277.7545,299.1852,181805,181983,178
104,20,[,123,287.0971,307.4313,182014,182045,31
104,0,blank,0,281.2384,291.7105,182076,182110,34
104,0,blank,0,334.18584,374.09018,182140,182300,160
104,0,blank,0,116.9646,224.76955,182334,182529,195
104,0,blank,0,-350,-105,182529,182709,180
104,0,blank,0,-350,-105,182709,182791,82
104,0,blank,0,335.6082,358.209266666667,182862,183041,179
104,0,blank,0,328.69155,323.789,183041,183103,62
104,0,blank,0,322.019875,338.709575,183135,183256,121
104,0,blank,0,321.58245,344.154483333333,183287,183471,184
104,0,blank,0,320.7733,330.3688,183471,183502,31
104,0,blank,0,322.0439,343.7709,183532,183564,32
104,0,blank,0,323.9939,381.623633333333,183594,183782,188
104,23,;,155,318.5824,364.538133333333,183782,183966,184
104,0,blank,0,321.4538,355.352066666667,183966,184151,185
104,0,blank,0,320.3001,338.14435,184182,184244,62
104,0,blank,0,-77.13964,79.98018,184274,184456,182
104,0,blank,0,-350,-105,184456,184639,183
104,0,blank,0,-350,-105,184639,184675,36
104,0,blank,0,328.8052,344.97785,184708,184892,184
104,0,blank,0,327.8774,346.614966666667,184892,184986,94
104,0,blank,0,333.7258,344.6077,185019,185115,96
104,23,-,151,240.8281,358.338866666667,185147,185244,97
104,23,-,151,242.5963,368.4925,185277,185310,33
104,23,-,151,238.7158,361.4784,185343,185376,33
104,23,i,149,210.072475,360.383,185408,185539,131
104,23,a,152,258.918883333333,366.6168,185573,185769,196
104,0,blank,0,251.98365,361.8894,185769,185835,66
104,0,blank,0,222.310416666667,433.660766666667,185866,186058,192
104,0,blank,0,210.2773,429.3932,186058,186089,31
104,0,blank,0,250.5401,439.56474,186121,186278,157
104,0,blank,0,-350,-105,186312,186497,185
104,0,blank,0,-350,-105,186497,186658,161
104,0,blank,0,-350,-105,186658,186706,48
104,0,blank,0,245.779383333333,439.36835,186740,186918,178
104,0,blank,0,222.9301,441.7148,186918,186949,31
104,0,blank,0,232.433733333333,441.493966666667,186982,187079,97
104,0,blank,0,312.5268,440.887425,187112,187239,127
104,0,blank,0,311.5861,445.27755,187272,187335,63
104,27,],169,196.33682,448.53704,187369,187538,169
104,27,],169,200.8943,449.8851,187538,187572,34
104,0,blank,0,209.232,489.6577,187607,187674,67
104,29,a,181,259.1805,496.6841,187789,187891,102
104,0,blank,0,316.1396,494.7141,188002,188079,77
104,29,;,184,309.7613,491.93525,188112,188179,67
104,23,++,154,298.19905,371.4879,188213,188282,69
104,23,++,154,297.4393,375.1472,188315,188381,66
104,23,a,152,273.12334,364.67338,188415,188579,164
104,23,-,151,238.65835,363.584783333333,188612,188807,195
104,0,blank,0,-350,-105,188840,189017,177
104,0,blank,0,-350,-105,189017,189068,51
104,18,find_anagram,99,112.74736,249.38432,189111,189282,171
104,21,!=,141,232.813,313.0833,189282,189314,32
104,0,blank,0,237.341133333333,318.673266666667,189347,189445,98
104,0,blank,0,238.724433333333,448.622883333333,189477,189673,196
104,27,==,170,224.1574,453.62396,189673,189835,162
104,27,),172,290.0115,452.005375,189868,189998,130
104,0,blank,0,311.4935,445.58695,190030,190157,127
104,0,blank,0,306.205,333.0075,190189,190221,32
104,0,blank,0,307.563,339.532,190221,190414,193
104,21,0,142,272.75425,331.79485,190445,190510,65
104,0,blank,0,-350,-105,190573,190751,178
104,0,blank,0,-350,-105,190751,190910,159
104,0,blank,0,257.3134,442.5691,190939,191122,183
104,0,blank,0,235.2706,450.12325,191122,191315,193
104,0,blank,0,236.330833333333,456.335633333333,191315,191448,133
104,27,[,167,180.992366666667,456.843266666667,191448,191622,174
104,0,blank,0,165.6843,485.5542,191622,191809,187
104,27,array2,166,160.4725,445.0179,191809,191903,94
104,27,while,164,70.54506,462.66888,191948,192141,193
104,27,while,164,64.4906,460.29995,192141,192206,65
104,27,array2,166,125.762666666667,465.558766666667,192239,192338,99
104,0,blank,0,-350,-105,192371,192567,196
104,0,blank,0,55.5508,334.37174,192594,192768,174
104,0,blank,0,220.332225,444.466275,192768,192900,132
104,27,==,170,233.136983333333,452.56705,192933,193130,197
104,27,==,170,230.5731,452.8116,193130,193227,97
104,27,array2,166,139.3953,452.49595,193260,193324,64
104,27,array2,166,134.286666666667,450.571733333333,193356,193451,95
104,20,],125,154.446216666667,311.102866666667,193484,193676,192
104,0,blank,0,192.577025,304.3343,193707,193835,128
104,20,{,127,195.35155,307.1485,193867,193930,63
104,0,blank,0,-350,-105,193962,194125,163
104,0,blank,0,15.9662,209.5599,194161,194257,96
104,0,blank,0,293.419,325.463,194257,194431,174
104,0,blank,0,-33.0801,109.6569,194431,194507,76
104,0,blank,0,227.45535,437.4849,194507,194677,170
104,0,blank,0,236.093633333333,444.8507,194677,194809,132
104,0,blank,0,198.83175,443.3434,194853,195034,181
104,27,],169,200.713325,448.598425,195034,195211,177
104,27,],169,198.2632,457.9574,195211,195242,31
104,0,blank,0,205.79565,460.35755,195281,195346,65
104,29,array2,176,141.992683333333,490.516666666667,195379,195573,194
104,29,[,177,126.70795,503.31805,195573,195640,67
104,29,num2,174,94.5798,503.65695,195673,195739,66
104,29,num2,174,92.2289,505.6583,195773,195840,67
104,0,blank,0,-350,-105,195874,196034,160
104,0,blank,0,-282.6708,-40.5681857142857,196060,196259,199
104,0,blank,0,-25.8535666666667,229.736966666667,196354,196531,177
104,0,blank,0,134.506433333333,405.077433333333,196531,196621,90
104,0,blank,0,129.689716666667,404.664516666667,196654,196846,192
104,0,blank,0,134.1469,421.20605,196846,196910,64
104,23,-,151,239.539483333333,362.308966666667,196943,197134,191
104,0,blank,0,303.1271,354.449066666667,197165,197262,97
104,0,blank,0,302.4285,404.8793,197295,197391,96
104,0,blank,0,303.0593,455.7832,197426,197527,101
104,27,0,171,256.4729,454.51985,197560,197697,137
104,27,0,171,251.51215,463.0061,197729,197795,66
104,27,0,171,253.244766666667,452.454966666667,197829,197926,97
104,0,blank,0,-350,-105,197958,198139,181
104,0,blank,0,245.550075,437.37375,198197,198386,189
104,27,0,171,268.00835,451.4679,198386,198475,89
104,27,),172,284.003025,451.47805,198521,198703,182
104,27,i,168,185.883533333333,454.1702,198749,198884,135
104,27,i,168,186.55575,458.262,198931,199026,95
104,0,blank,0,242.98276,300.98854,199072,199262,190
104,20,num2,122,277.121266666667,306.98915,199295,199486,191
104,20,num2,122,277.1408,304.30824,199486,199646,160
104,20,],125,315.339525,302.673075,199676,199803,127
104,0,blank,0,-350,-105,199833,199973,140
104,0,blank,0,164.30224,216.62844,199999,200175,176
104,20,},129,220.430516666667,303.55575,200175,200365,190
104,20,{,127,202.172566666667,307.863,200398,200586,188
104,0,blank,0,202.0999,313.1135,200586,200617,31
104,20,{,127,201.77138,304.70016,200650,200808,158
104,0,blank,0,205.8904,312.4164,200808,200870,62
104,0,blank,0,-350,-105,200895,201091,196
104,0,blank,0,-350,-105,201091,201271,180
104,0,blank,0,-350,-105,201271,201448,177
104,0,blank,0,-350,-105,201448,201603,155
104,0,blank,0,-350,-105,201603,201821,218
104,0,blank,0,-350,-105,201821,202038,217
104,0,blank,0,-350,-105,202038,202387,349
104,0,blank,0,-350,-105,202387,202691,304
104,0,blank,0,-350,-105,202691,202863,172
104,0,blank,0,-350,-105,202863,202896,33
104,0,blank,0,-350,-105,202896,203099,203
104,0,blank,0,-350,-105,203099,203281,182
104,0,blank,0,-350,-105,203281,203562,281
104,0,blank,0,-350,-105,203562,203738,176
104,0,blank,0,-350,-105,203738,203936,198
104,0,blank,0,-350,-105,203936,204107,171
104,0,blank,0,-350,-105,204107,204302,195
104,0,blank,0,-350,-105,204302,204500,198
104,0,blank,0,-350,-105,204500,204598,98
104,0,blank,0,-350,-105,204598,204914,316
104,0,blank,0,-350,-105,204914,205068,154
104,0,blank,0,-350,-105,205068,205122,54
104,0,blank,0,-350,-105,205122,205350,228
104,0,blank,0,-350,-105,205350,205493,143
104,0,blank,0,-350,-105,205546,205695,149
104,0,blank,0,-350,-105,205695,205855,160
104,0,blank,0,-350,-105,205855,205896,41
104,0,blank,0,-134.980583333333,36.58415,205927,206109,182
104,0,blank,0,-350,-105,206109,206291,182
104,0,blank,0,-350,-105,206291,206480,189
104,0,blank,0,-350,-105,206480,206657,177
104,0,blank,0,-350,-105,206657,206855,198
104,0,blank,0,-350,-105,206855,207024,169
104,0,blank,0,-350,-105,207024,207222,198
104,0,blank,0,-350,-105,207222,207390,168
104,0,blank,0,-350,-105,207390,207589,199
104,0,blank,0,-350,-105,207589,207776,187
104,0,blank,0,-350,-105,207776,207955,179
104,0,blank,0,-350,-105,207955,208058,103
104,0,blank,0,-350,-105,208058,208294,236
104,0,blank,0,-350,-105,208294,208421,127
104,0,blank,0,-350,-105,208421,208540,119
104,0,blank,0,-350,-105,208540,208703,163
104,0,blank,0,-350,-105,208703,208855,152
104,0,blank,0,-350,-105,208855,209038,183
104,0,blank,0,-350,-105,209038,209217,179
104,0,blank,0,-350,-105,209217,209415,198
104,0,blank,0,-350,-105,209415,209603,188
104,0,blank,0,-350,-105,209603,209794,191
104,0,blank,0,-350,-105,209794,209989,195
104,0,blank,0,-350,-105,209989,210170,181
104,0,blank,0,-350,-105,210170,210363,193
104,0,blank,0,-350,-105,210363,210547,184
104,0,blank,0,-350,-105,210547,210719,172
104,0,blank,0,-350,-105,210719,210914,195
104,0,blank,0,-350,-105,210914,211104,190
104,0,blank,0,-350,-105,211104,211273,169
104,0,blank,0,-350,-105,211273,211418,145
104,0,blank,0,-350,-105,211418,211616,198
104,0,blank,0,-350,-105,211616,211785,169
104,0,blank,0,-350,-105,211785,211943,158
104,0,blank,0,-350,-105,211943,212108,165
104,0,blank,0,-350,-105,212108,212290,182
104,0,blank,0,-350,-105,212290,212445,155
104,0,blank,0,-350,-105,212445,212591,146
104,0,blank,0,-350,-105,212783,212963,180
104,0,blank,0,-350,-105,212963,213060,97
104,0,blank,0,-350,-105,213199,213494,295
104,0,blank,0,-350,-105,213494,213681,187
104,0,blank,0,-350,-105,213681,213867,186
104,0,blank,0,-350,-105,213867,214044,177
104,0,blank,0,-350,-105,214044,214103,59
104,0,blank,0,-350,-105,214103,214265,162
104,0,blank,0,-350,-105,214265,214388,123
104,0,blank,0,-350,-105,214388,214561,173
104,0,blank,0,-350,-105,214561,214674,113
104,0,blank,0,-350,-105,214674,214903,229
104,0,blank,0,-350,-105,214903,215138,235
104,0,blank,0,-350,-105,215138,215320,182
104,0,blank,0,-350,-105,215320,215518,198
104,0,blank,0,-350,-105,215518,215666,148
104,0,blank,0,153.0054,680.6523,216504,216555,51
104,0,blank,0,214.2488,693.666,216595,216683,88
104,0,blank,0,-350,-105,216733,216894,161
104,0,blank,0,-350,-105,216894,217093,199
104,0,blank,0,229.6662,444.196466666667,217248,217381,133
104,0,blank,0,252.11115,443.418516666667,217418,217592,174
104,27,0,171,254.7948,448.0431,217592,217622,30
104,0,blank,0,-350,-105,217881,218077,196
104,23,array1,147,171.12804,362.10028,218139,218332,193
104,27,0,171,263.098033333333,448.100133333333,218362,218551,189
104,27,0,171,263.12005,448.47335,218551,218675,124
104,0,blank,0,300.21475,443.8052,218708,218835,127
104,0,blank,0,304.046975,448.8856,218867,218991,124
104,0,blank,0,319.80085,450.0183,219022,219149,127
104,0,blank,0,-128.182933333333,76.0073833333333,219181,219363,182
104,0,blank,0,-350,-105,219363,219550,187
104,0,blank,0,-350,-105,219550,219661,111
104,27,i,168,192.8591,463.86725,219691,219800,109
104,0,blank,0,227.22525,441.23,219827,219987,160
104,0,blank,0,301.13005,445.0333,220017,220141,124
104,0,blank,0,269.1758,291.417833333333,220259,220434,175
104,20,num2,122,282.4348,307.8088,220520,220548,28
104,0,blank,0,282.1676,314.3494,220634,220773,139
104,20,num2,122,282.81045,308.9152,220773,220892,119
104,27,0,171,261.854,447.5834,220983,221012,29
104,27,0,171,277.6011,460.7891,221105,221135,30
104,0,blank,0,281.1102,462.24795,221197,221260,63
104,0,blank,0,298.761633333333,467.585516666667,221292,221482,190
104,27,),172,291.17602,455.86144,221482,221670,188
104,27,),172,284.498475,449.84625,221670,221825,155
104,0,blank,0,-350,-105,221857,222048,191
104,0,blank,0,-350,-105,222048,222228,180
104,0,blank,0,-350,-105,222228,222424,196
104,0,blank,0,-350,-105,222424,222460,36
104,0,blank,0,138.4,442.6342,222537,222640,103
104,0,blank,0,-178.033433333333,75.3173333333333,222747,222900,153
104,0,blank,0,-350,-105,222900,223088,188
104,0,blank,0,-350,-105,223088,223244,156
104,20,num2,122,250.99005,303.7332,223350,223542,192
104,21,!=,141,232.483,320.0358,223542,223694,152
104,21,!=,141,226.0363,330.4678,223694,223752,58
104,0,blank,0,189.77815,426.14105,223796,223883,87
104,0,blank,0,203.02495,442.9416,223926,224013,87
104,0,blank,0,235.455725,446.11715,224058,224225,167
104,0,blank,0,282.884083333333,453.537166666667,224255,224442,187
104,0,blank,0,294.4626,460.9935,224442,224473,31
104,27,),172,285.644566666667,452.091016666667,224505,224690,185
104,27,),172,284.2158,452.3022,224690,224818,128
104,0,blank,0,321.60405,447.815966666667,224849,225038,189
104,0,blank,0,-350,-105,225069,225229,160
104,0,blank,0,174.72296,342.41908,225258,225413,155
104,0,blank,0,281.9447,441.7937,225446,225542,96
104,0,blank,0,284.64682,444.94772,225574,225729,155
104,27,==,170,225.759716666667,454.49025,225760,225945,185
104,0,blank,0,282.0384,458.935166666667,225976,226068,92
104,27,0,171,280.02505,455.275416666667,226099,226287,188
104,0,blank,0,293.013,458.9813,226318,226380,62
104,0,blank,0,297.9605,457.95185,226410,226471,61
104,0,blank,0,-350,-105,226502,226692,190
104,0,blank,0,-350,-105,226692,226727,35
104,0,blank,0,288.9273,441.81895,226758,226807,49
104,21,),143,291.589533333333,320.04605,226839,227028,189
104,21,),143,291.3349,315.3274,227028,227059,31
104,20,num2,122,280.8359,305.7407,227090,227152,62
104,21,),143,289.3104,313.9082,227183,227213,30
104,0,blank,0,301.2793,451.0168,227243,227305,62
104,0,blank,0,292.8108,451.235816666667,227335,227521,186
104,29,a,181,260.96965,501.795375,227553,227673,120
104,29,a,181,261.9905,504.1088,227702,227732,30
104,29,a,181,270.8792,493.4512,227762,227792,30
104,29,;,184,307.01355,500.198833333333,227822,228003,181
104,29,],182,219.8959,495.33386,228032,228185,153
104,29,array2,176,193.75715,500.8615,228215,228276,61
104,29,[,177,199.368675,507.389075,228306,228494,188
104,0,blank,0,-350,-105,228590,228759,169
104,0,blank,0,124.9007,387.1077,228802,228926,124
104,0,blank,0,278.92305,517.70955,228954,229147,193
104,0,blank,0,287.954725,473.06635,229177,229299,122
104,27,),172,291.04574,447.50278,229329,229486,157
104,0,blank,0,286.8751,479.0734,229517,229549,32
104,0,blank,0,295.746866666667,381.7298,229580,229767,187
104,0,blank,0,292.803,352.8632,229767,229798,31
104,21,0,142,278.8372,320.08675,229829,229890,61
104,21,),143,291.454566666667,333.032466666667,229920,230010,90
104,21,0,142,276.10998,318.05726,230040,230190,150
104,21,),143,285.3824,327.44815,230220,230281,61
104,0,blank,0,283.50668,437.11986,230310,230462,152
104,27,),172,286.988966666667,465.561266666667,230493,230583,90
104,0,blank,0,300.246733333333,476.076033333333,230614,230706,92
104,0,blank,0,296.440983333333,470.791083333333,230737,230914,177
104,0,blank,0,-350,-105,230975,231159,184
104,0,blank,0,-350,-105,231159,231310,151
104,0,blank,0,301.184166666667,450.166933333333,231343,231421,78
104,0,blank,0,277.619633333333,551.690583333333,231451,231633,182
104,0,blank,0,259.1258,583.516366666667,231633,231725,92
104,0,blank,0,261.3336,594.7699,231755,231787,32
104,32,++,200,256.43635,573.5021,231816,231876,60
104,34,num2,210,269.763483333333,614.0739,231905,232086,181
104,34,num2,210,273.251133333333,616.544333333333,232086,232176,90
104,34,i,212,284.034216666667,615.930216666667,232206,232386,180
104,34,i,212,286.04245,619.57055,232386,232445,59
104,0,blank,0,325.6303,611.680333333333,232475,232564,89
104,0,blank,0,329.9868,613.4896,232596,232656,60
104,34,num2,210,253.24428,615.3638,232687,232843,156
104,0,blank,0,293.4571,628.29058,232874,233026,152
104,0,blank,0,319.03388,626.8696,233056,233209,153
104,0,blank,0,291.917433333333,527.996366666667,233240,233427,187
104,0,blank,0,290.537533333333,438.274133333333,233427,233521,94
104,0,blank,0,287.1568,436.4075,233556,233587,31
104,27,),172,290.1337,461.1738,233618,233649,31
104,27,),172,286.36388,458.29526,233679,233832,153
104,0,blank,0,306.81605,468.4841,233862,233924,62
104,0,blank,0,297.59535,461.31845,233954,234016,62
104,0,blank,0,307.3484,472.3864,234046,234108,62
104,0,blank,0,290.24495,477.3901,234139,234201,62
104,0,blank,0,301.8638,475.672333333333,234232,234415,183
104,27,0,171,274.23175,446.0518,234445,234507,62
104,0,blank,0,292.86935,462.512583333333,234537,234720,183
104,0,blank,0,293.9002,328.68965,234750,234812,62
104,0,blank,0,305.4444,329.4492,234843,234874,31
104,21,),143,288.3785,323.909175,234904,235022,118
104,0,blank,0,300.235,327.0946,235052,235083,31
104,0,blank,0,-350,-105,235114,235459,345
104,0,blank,0,-350,-105,235459,235629,170
104,0,blank,0,-350,-105,235629,235798,169
104,0,blank,0,300.807675,468.984,236278,236406,128
104,0,blank,0,306.120233333333,464.882566666667,236437,236529,92
104,0,blank,0,292.4452,476.9797,236561,236623,62
104,0,blank,0,304.24,479.2982,236653,236715,62
104,0,blank,0,301.506,474.0861,236746,236869,123
104,0,blank,0,295.1107,465.64168,236900,237058,158
104,0,blank,0,308.3862,465.5386,237091,237123,32
104,27,),172,287.82285,462.81405,237153,237217,64
104,0,blank,0,294.709675,463.8045,237251,237376,125
104,0,blank,0,292.500933333333,459.271616666667,237408,237595,187
104,0,blank,0,282.0515,457.4275,237595,237626,31
104,0,blank,0,303.04618,464.29068,237658,237815,157
104,0,blank,0,-252.420871428571,-15.4363428571429,237846,238042,196
104,0,blank,0,-350,-105,238042,238099,57
104,0,blank,0,307.8859,474.3712,238128,238175,47
104,0,blank,0,299.441425,464.49885,238205,238332,127
104,0,blank,0,287.0961,473.6906,238366,238457,91
104,0,blank,0,296.5523,466.788166666667,238488,238675,187
104,0,blank,0,303.312525,474.217975,238706,238828,122
104,0,blank,0,306.393233333333,458.756966666667,238858,238950,92
104,0,blank,0,307.6831,459.794266666667,238982,239168,186
104,0,blank,0,300.7292,455.166483333333,239168,239354,186
104,0,blank,0,294.05975,459.22595,239354,239416,62
104,27,0,171,280.8147,456.9111,239447,239478,31
104,27,),172,291.86275,452.06415,239509,239570,61
104,0,blank,0,297.5231,454.0718,239601,239632,31
104,0,blank,0,294.55945,458.006266666667,239663,239852,189
104,0,blank,0,293.6471,466.96764,239852,240009,157
104,0,blank,0,301.8951,471.8165,240041,240072,31
104,0,blank,0,-350,-105,240103,240294,191
104,21,array1,137,122.75115,317.0461,240334,240491,157
104,0,blank,0,301.313575,460.603775,240520,240644,124
104,0,blank,0,303.300316666667,463.285916666667,240676,240863,187
104,0,blank,0,301.1066,466.3047,240863,240894,31
104,0,blank,0,294.119166666667,462.316466666667,240926,241019,93
104,27,),172,286.87375,453.5708,241049,241110,61
104,0,blank,0,293.48245,466.790475,241141,241264,123
104,27,),172,289.151866666667,449.036833333333,241294,241385,91
104,0,blank,0,300.9655,461.85775,241415,241475,60
104,0,blank,0,-130.30215,92.0435666666667,241505,241679,174
104,0,blank,0,-350,-105,241679,241860,181
104,0,blank,0,-350,-105,241860,242040,180
104,0,blank,0,-350,-105,242040,242209,169
104,0,blank,0,-350,-105,242209,242332,123
104,0,blank,0,-350,-105,242332,242467,135
104,0,blank,0,-350,-105,242467,242628,161
104,0,blank,0,-350,-105,242628,242822,194
104,0,blank,0,-350,-105,242822,243001,179
104,0,blank,0,-350,-105,243001,243196,195
104,0,blank,0,-350,-105,243196,243363,167
104,0,blank,0,-350,-105,243363,243542,179
104,0,blank,0,-350,-105,243542,243722,180
104,0,blank,0,-350,-105,243722,243903,181
104,0,blank,0,-350,-105,243903,244084,181
104,0,blank,0,-350,-105,244084,244262,178
104,0,blank,0,-350,-105,244262,244376,114
104,0,blank,0,-350,-105,244376,244554,178
104,0,blank,0,-350,-105,244554,244705,151
104,0,blank,0,-350,-105,244705,244794,89
104,0,blank,0,-350,-105,244794,244969,175
104,0,blank,0,-350,-105,244969,245129,160
104,0,blank,0,-350,-105,245129,245274,145
104,0,blank,0,-350,-105,245274,245466,192
104,0,blank,0,-350,-105,245466,245660,194
104,0,blank,0,-350,-105,245660,245781,121
104,0,blank,0,-350,-105,245781,245916,135
104,0,blank,0,-350,-105,245916,246082,166
104,0,blank,0,-350,-105,246082,246277,195
104,0,blank,0,-350,-105,246277,246468,191
104,0,blank,0,-350,-105,246468,246661,193
104,0,blank,0,-350,-105,246661,246833,172
104,0,blank,0,-350,-105,246833,247002,169
104,0,blank,0,-350,-105,247002,247198,196
104,0,blank,0,-350,-105,247198,247396,198
104,0,blank,0,-350,-105,247396,247590,194
104,0,blank,0,-350,-105,247590,247766,176
104,0,blank,0,-350,-105,247766,247948,182
104,0,blank,0,-350,-105,247948,248132,184
104,0,blank,0,-350,-105,248132,248330,198
104,0,blank,0,-350,-105,248330,248510,180
104,0,blank,0,-350,-105,248510,248685,175
104,0,blank,0,-350,-105,248685,248845,160
104,0,blank,0,-350,-105,248845,248965,120
104,0,blank,0,-350,-105,248965,249139,174
104,0,blank,0,-350,-105,249139,249282,143
104,0,blank,0,-350,-105,249282,249471,189
104,0,blank,0,-350,-105,249471,249668,197
104,0,blank,0,-350,-105,249668,249862,194
104,0,blank,0,-350,-105,249862,250029,167
104,0,blank,0,-350,-105,250029,250196,167
104,0,blank,0,-350,-105,250196,250395,199
104,0,blank,0,-350,-105,250395,250563,168
104,0,blank,0,-350,-105,250563,250750,187
104,0,blank,0,-350,-105,250750,250924,174
104,0,blank,0,-350,-105,250924,251119,195
104,0,blank,0,-350,-105,251119,251296,177
104,0,blank,0,-350,-105,251296,251462,166
104,0,blank,0,-350,-105,251462,251657,195
104,0,blank,0,-350,-105,251657,251853,196
104,0,blank,0,-350,-105,251853,251926,73
104,27,i,168,185.7457,456.63605,252059,252135,76
104,27,i,168,192.38295,447.9009,252175,252231,56
104,0,blank,0,-350,-105,252291,252489,198
104,0,blank,0,-350,-105,252489,252655,166
104,0,blank,0,-350,-105,252655,252802,147
104,26,=,161,63.5517,432.9473,252829,252857,28
104,0,blank,0,57.3755,422.637133333333,252887,253071,184
104,26,=,161,70.3254,436.8658,253103,253164,61
104,0,blank,0,61.072,425.9393,253194,253225,31
104,0,blank,0,183.7648,519.912466666667,253290,253469,179
104,0,blank,0,-350,-105,253469,253667,198
104,0,blank,0,-350,-105,253667,253847,180
104,0,blank,0,-350,-105,253847,253981,134
104,0,blank,0,161.0201,428.055566666667,254049,254219,170
104,0,blank,0,191.184775,437.99095,254219,254395,176
104,0,blank,0,255.089075,437.076325,254395,254575,180
104,0,blank,0,271.88065,444.37385,254575,254755,180
104,0,blank,0,-350,-105,254755,254953,198
104,0,blank,0,-350,-105,254953,255134,181
104,0,blank,0,-350,-105,255134,255271,137
104,0,blank,0,216.54585,474.04065,255302,255489,187
104,29,i,178,208.06375,496.0401,255524,255587,63
104,29,i,178,209.375,495.0473,255649,255773,124
104,29,],182,274.7828,498.5939,255804,255931,127
104,29,],182,280.171833333333,503.026133333333,255961,256053,92
104,29,++,183,288.25795,495.84325,256084,256146,62
104,29,-,180,239.03105,490.7461,256269,256359,90
104,0,blank,0,225.7745,520.357275,256452,256645,193
104,0,blank,0,-50.509225,240.3192,256645,256833,188
104,0,blank,0,-350,-105,256833,257014,181
104,0,blank,0,-350,-105,257014,257192,178
104,0,blank,0,-350,-105,257192,257373,181
104,0,blank,0,-350,-105,257373,257410,37
104,0,blank,0,285.397625,489.396325,257429,257612,183
104,29,],182,279.286875,494.17755,257612,257796,184
104,0,blank,0,222.33255,491.181875,257841,258025,184
104,29,array2,176,182.92415,495.48115,258025,258210,185
104,0,blank,0,77.2945,352.04465,258210,258398,188
104,0,blank,0,-350,-105,258398,258591,193
104,0,blank,0,-350,-105,258591,258765,174
104,29,a,181,260.155366666667,495.951333333333,258797,258907,110
104,29,a,181,258.390266666667,498.572633333333,258907,259060,153
104,29,a,181,260.3629,495.60445,259060,259217,157
104,29,a,181,261.18865,501.7446,259217,259369,152
104,29,a,181,264.46175,498.95065,259400,259492,92
104,29,-,180,242.14684,504.08934,259530,259709,179
104,0,blank,0,76.82845,334.49555,259709,259891,182
104,0,blank,0,-350,-105,259891,260065,174
104,0,blank,0,-350,-105,260065,260245,180
104,0,blank,0,-350,-105,260245,260424,179
104,0,blank,0,-350,-105,260424,260622,198
104,0,blank,0,-350,-105,260622,260939,317
104,0,blank,0,-350,-105,260939,261048,109
104,0,blank,0,-350,-105,261048,261376,328
104,0,blank,0,-350,-105,261376,261639,263
104,0,blank,0,-350,-105,261639,262078,439
104,0,blank,0,-350,-105,262078,262277,199
104,0,blank,0,-350,-105,262277,262371,94
104,0,blank,0,-350,-105,262371,262498,127
104,0,blank,0,-350,-105,262498,262624,126
104,0,blank,0,-350,-105,262624,262805,181
104,0,blank,0,-350,-105,262805,262940,135
104,0,blank,0,-350,-105,262940,263088,148
104,0,blank,0,-350,-105,263088,263312,224
104,0,blank,0,-350,-105,263312,263587,275
104,0,blank,0,-350,-105,263587,263856,269
104,0,blank,0,-350,-105,263856,263893,37
104,0,blank,0,-257.66318,-0.275700000000006,263920,264115,195
104,0,blank,0,-350,-105,264115,264292,177
104,0,blank,0,-350,-105,264292,264479,187
104,0,blank,0,-350,-105,264479,264658,179
104,0,blank,0,-350,-105,264658,264830,172
104,0,blank,0,-350,-105,264870,264949,79
104,0,blank,0,250.8324,524.6253,264949,265082,133
104,0,blank,0,-350,-105,265082,265169,87
104,29,array2,176,164.0456,493.8474,265169,265286,117
104,29,array2,176,160.7988,502.28,265286,265379,93
104,29,[,177,198.6647,495.675475,265438,265628,190
104,29,[,177,199.0411,490.51575,265628,265719,91
104,0,blank,0,-350,-105,265764,265963,199
104,0,blank,0,-350,-105,265963,266141,178
104,0,blank,0,-350,-105,266141,266330,189
104,0,blank,0,-350,-105,266330,266435,105
104,0,blank,0,282.7507,481.38155,266453,266629,176
104,0,blank,0,325.41384,487.36706,266675,266862,187
104,0,blank,0,330.42376,490.157,266862,267019,157
104,0,blank,0,350.3058,494.7534,267051,267146,95
104,0,blank,0,-350,-105,267178,267364,186
104,0,blank,0,-350,-105,267364,267449,85
104,0,blank,0,312.19275,469.943425,267481,267598,117
104,0,blank,0,192.71155,622.875775,267629,267817,188
104,0,blank,0,238.128,560.14415,267817,267941,124
104,0,blank,0,216.59875,592.976275,267972,268142,170
104,34,!=,209,217.5102,610.9338,268142,268188,46
104,34,num2,210,265.582625,618.901775,268236,268418,182
104,0,blank,0,175.9416,641.60365,268418,268599,181
104,0,blank,0,170.196175,642.948275,268599,268784,185
104,0,blank,0,152.312725,678.42305,268784,268959,175
104,0,blank,0,162.148566666667,667.1413,268990,269087,97
104,0,blank,0,193.690175,665.626275,269120,269248,128
104,0,blank,0,-350,-105,269281,269447,166
104,0,blank,0,-76.51085,201.48775,269549,269745,196
104,0,blank,0,242.427575,40.9552,269745,269925,180
104,0,blank,0,228.8068,43.2209,269925,269957,32
104,0,blank,0,202.02405,-2.9794,269989,270055,66
104,0,blank,0,545.91825,207.290925,270179,270336,157
104,0,blank,0,115.94345,-103.8635,270336,270447,111
104,0,blank,0,-350,-105,270473,270649,176
104,0,blank,0,-350,-105,270649,270675,26
104,0,blank,0,275.29235,125.09325,270719,270796,77
104,0,blank,0,347.2737,120.195166666667,270853,271045,192
104,13,array1,79,461.387875,138.21425,271045,271229,184
104,13,array1,79,459.66385,144.03695,271229,271320,91
104,0,blank,0,-350,-105,271414,271554,140
104,10,array2,57,98.98326,91.6667,271594,271771,177
104,13,"%sand%sareanagrams.\n",77,212.3781,142.8498,271771,271833,62
104,0,blank,0,262.05374,283.2407,271865,272026,161
104,0,blank,0,237.53398,287.91974,272059,272216,157
104,20,},129,214.0756,302.308766666667,272249,272346,97
104,20,0,133,208.0629,293.5788,272378,272442,64
104,0,blank,0,352.078133333333,283.475166666667,272473,272570,97
104,0,blank,0,352.843166666667,282.3479,272602,272699,97
104,0,blank,0,389.96125,241.79105,272731,272793,62
104,18,char,106,376.2119,247.6515,272826,272859,33
104,0,blank,0,385.1002,241.9057,272890,272990,100
104,0,blank,0,322.74945,250.27615,273022,273086,64
104,0,blank,0,315.650266666667,247.835833333333,273118,273214,96
104,0,blank,0,-350,-105,273247,273439,192
104,0,blank,0,-350,-105,273439,273618,179
104,0,blank,0,-350,-105,273618,273782,164
104,0,blank,0,-350,-105,273782,273964,182
104,0,blank,0,-350,-105,273964,274109,145
104,0,blank,0,-350,-105,274109,274253,144
104,0,blank,0,-350,-105,274253,274414,161
104,0,blank,0,-350,-105,274414,274609,195
104,0,blank,0,-350,-105,274609,274792,183
104,0,blank,0,-350,-105,274792,274980,188
104,0,blank,0,-350,-105,274980,275179,199
104,0,blank,0,-350,-105,275179,275310,131
104,0,blank,0,-350,-105,275310,275467,157
104,0,blank,0,-350,-105,275467,275537,70
104,0,blank,0,-350,-105,275537,275686,149
104,0,blank,0,-350,-105,275686,275878,192
104,0,blank,0,-350,-105,275878,276054,176
104,0,blank,0,-350,-105,276054,276235,181
104,0,blank,0,-350,-105,276235,276368,133
104,0,blank,0,-350,-105,276368,276507,139
104,0,blank,0,-350,-105,276507,276829,322
104,0,blank,0,-350,-105,276829,276931,102
104,0,blank,0,-350,-105,276931,277414,483
104,0,blank,0,-350,-105,277414,277605,191
104,0,blank,0,-350,-105,277605,277747,142
104,0,blank,0,-90.106125,101.043125,277778,277952,174
104,0,blank,0,-350,-105,277952,278134,182
104,0,blank,0,-350,-105,278134,278333,199
104,0,blank,0,-350,-105,278333,278460,127
104,0,blank,0,-350,-105,278460,278605,145
104,0,blank,0,-350,-105,278605,278751,146
104,0,blank,0,-350,-105,278751,278899,148
104,0,blank,0,-350,-105,278899,279190,291
104,0,blank,0,-350,-105,279190,279303,113
104,23,++,154,299.3831,364.6582,279415,279508,93
104,0,blank,0,-136.7793,48.8201666666667,279559,279758,199
104,0,blank,0,-350,-105,279758,279883,125
104,0,blank,0,-350,-105,279883,280074,191
104,0,blank,0,217.553275,341.67975,280129,280326,197
104,0,blank,0,204.243675,340.56195,280326,280509,183
104,23,[,148,200.1371,367.49496,280509,280683,174
104,23,[,148,202.374633333333,368.828533333333,280683,280778,95
104,23,++,154,294.8271,373.2091,280810,280939,129
104,0,blank,0,-0.737866666666681,142.1871,280970,281157,187
104,0,blank,0,-350,-105,281157,281235,78
104,0,blank,0,-350,-105,281266,281400,134
104,23,i,149,208.44214,360.46462,281421,281596,175
104,23,array1,147,185.15045,359.05325,281627,281690,63
104,23,array1,147,187.917983333333,366.04685,281722,281910,188
104,23,array1,147,188.0857,372.0903,281910,281940,30
104,23,array1,147,192.6505,368.84782,281972,282126,154
104,23,array1,147,191.001733333333,370.948966666667,282157,282250,93
104,23,array1,147,187.6034,364.4203,282281,282343,62
104,20,num2,122,274.2795,298.00425,282374,282436,62
104,0,blank,0,266.87952,282.2867,282466,282619,153
104,20,0,133,209.309733333333,296.32335,282650,282835,185
104,20,},129,217.6126,302.3392,282835,282867,32
104,20,num2,122,258.6545,298.2252,282899,282929,30
104,20,num2,122,262.9838,309.132,282961,283052,91
104,0,blank,0,-350,-105,283083,283245,162
104,0,blank,0,-350,-105,283245,283290,45
104,20,num2,122,278.1583,301.824,283318,283365,47
104,20,num2,122,282.830933333333,307.351716666667,283397,283587,190
104,20,num2,122,279.1134,304.57605,283587,283650,63
104,20,num2,122,277.4088,295.8631,283682,283713,31
104,21,),143,285.56016,314.09174,283745,283901,156
104,20,},129,223.33645,299.476566666667,283932,284116,184
104,20,0,133,210.455875,296.875875,284116,284236,120
104,0,blank,0,-163.148083333333,29.7873,284267,284466,199
104,0,blank,0,-350,-105,284466,284568,102
104,14,else,84,64.6107,164.9686,284656,284757,101
104,20,num2,122,265.0181,296.692833333333,284789,284880,91
104,20,comma,130,225.3466,310.7142,284911,284942,31
104,20,0,133,210.50066,294.51008,284972,285126,154
104,20,num2,122,273.546633333333,305.352616666667,285157,285341,184
104,20,num2,122,268.675833333333,305.213683333333,285371,285551,180
104,20,num2,122,266.364025,298.658825,285551,285672,121
104,23,++,154,306.22265,375.630516666667,285702,285885,183
104,23,++,154,293.02902,362.72922,285885,286037,152
104,23,a,152,274.9061,367.693433333333,286067,286159,92
104,0,blank,0,349.6803,365.71955,286190,286253,63
104,0,blank,0,360.2847,372.6981,286284,286315,31
104,0,blank,0,359.287,374.9101,286346,286407,61
104,0,blank,0,-350,-105,286438,286628,190
104,0,blank,0,-350,-105,286628,286816,188
104,0,blank,0,-350,-105,286816,286867,51
104,0,blank,0,150.76526,208.84168,286924,287089,165
104,20,num2,122,275.247083333333,293.219533333333,287121,287311,190
104,20,num2,122,279.7786,311.8655,287343,287376,33
104,20,num2,122,272.838933333333,295.361916666667,287409,287600,191
104,0,blank,0,261.6595,283.8287,287600,287633,33
104,0,blank,0,-350,-105,287667,287838,171
104,18,char,106,192.4636,249.977966666667,287865,287989,124
104,21,array1,137,130.395,328.6021,287989,288149,160
104,0,blank,0,205.881833333333,26.4942333333333,288149,288348,199
104,0,blank,0,-350,-105,288348,288536,188
104,0,blank,0,-350,-105,288536,288589,53
104,0,blank,0,609.4325,-103.9812,288632,288726,94
104,0,blank,0,-350,-105,288792,288980,188
104,0,blank,0,-350,-105,288980,289131,151
104,16,return,94,47.26805,212.8481,289212,289411,199
104,0,blank,0,-350,-105,289411,289570,159
104,0,blank,0,38.5225,93.4596,289618,289709,91
104,0,blank,0,-350,-105,289709,289822,113
104,0,blank,0,-350,-105,289822,289999,177
104,0,blank,0,-350,-105,289999,290210,211
104,0,blank,0,288.48186,286.3145,290250,290424,174
104,20,},129,218.96545,303.2358,290456,290517,61
104,20,0,133,208.81335,301.40825,290549,290611,62
104,20,},129,217.1781,298.4909,290643,290675,32
104,20,},129,218.58685,297.836,290707,290772,65
104,0,blank,0,-63.8333833333333,115.6749,290803,290996,193
104,0,blank,0,-350,-105,290996,291176,180
104,0,blank,0,-350,-105,291176,291352,176
104,0,blank,0,-350,-105,291352,291547,195
104,0,blank,0,-350,-105,291547,291660,113
104,0,blank,0,219.1074,344.4579,291677,291705,28
104,0,blank,0,197.880333333333,385.7391,291773,291932,159
104,0,blank,0,200.879233333333,357.178066666667,291932,292088,156
104,0,blank,0,69.23015,202.30835,292088,292287,199
104,0,blank,0,-350,-105,292287,292470,183
104,20,num2,122,279.266675,304.296925,292508,292705,197
104,0,blank,0,234.626025,-104.190275,292705,292875,170
104,0,blank,0,-350,-105,292875,293013,138
104,0,blank,0,-350,-105,293013,293136,123
104,0,blank,0,-350,-105,293136,293220,84
104,21,array1,137,147.14452,315.61532,293253,293403,150
104,0,blank,0,147.34594,350.97688,293436,293598,162
104,0,blank,0,237.292433333333,357.893166666667,293631,293829,198
104,0,blank,0,236.291533333333,353.7355,293862,293967,105
104,0,blank,0,269.661383333333,357.506233333333,294000,294199,199
104,23,a,152,269.4554,361.9631,294199,294234,35
104,0,blank,0,111.7642,357.451466666667,294268,294369,101
104,23,num1,145,90.47252,364.44974,294403,294575,172
104,23,num1,145,96.62675,368.7517,294611,294682,71
104,0,blank,0,-350,-105,294718,294835,117
104,18,int,98,8.22004000000001,257.13684,294880,295070,190
104,0,blank,0,102.02674,349.67458,295070,295241,171
104,0,blank,0,98.798125,352.6786,295241,295381,140
104,0,blank,0,97.83266,347.27974,295418,295602,184
104,0,blank,0,152.51655,352.083625,295638,295778,140
104,0,blank,0,160.8082,353.4986,295814,295850,36
104,23,array1,147,152.5013,359.1966,295884,295919,35
104,0,blank,0,223.53658,359.01836,295955,296124,169
104,0,blank,0,-350,-105,296158,296334,176
104,0,blank,0,-350,-105,296334,296508,174
104,0,blank,0,235.83,337.3669,296540,296555,15
104,23,[,148,128.65875,361.1843,296597,296788,191
104,23,array1,147,137.8614,366.106,296788,296819,31
104,23,num1,145,102.0271,359.9866,296851,296883,32
104,23,num1,145,101.5,373.3689,296915,296946,31
104,23,num1,145,95.36415,362.954525,296978,297104,126
104,0,blank,0,136.156183333333,588.895866666667,297136,297325,189
104,0,blank,0,133.759,595.9306,297325,297357,32
104,34,num1,205,144.625983333333,615.236016666667,297388,297577,189
104,34,num1,205,138.1904,604.614,297577,297608,31
104,0,blank,0,220.494866666667,622.9953,297641,297737,96
104,0,blank,0,228.841733333333,593.6356,297770,297866,96
104,0,blank,0,236.378983333333,621.255,297898,298094,196
104,0,blank,0,236.76578,621.02946,298094,298253,159
104,35,return,215,150.8078,630.9931,298285,298316,31
104,0,blank,0,150.117416666667,622.101466666667,298348,298538,190
104,35,return,215,149.34415,632.1303,298538,298601,63
104,35,return,215,154.22455,630.0694,298634,298698,64
104,0,blank,0,-350,-105,298762,298792,30
104,20,num1,113,114.996483333333,309.2139,298843,299013,170
104,21,array1,137,146.2573,315.6602,299046,299078,32
104,20,26,124,136.8173,303.824666666667,299110,299207,97
104,20,{,127,197.5253,306.090816666667,299239,299433,194
104,20,comma,130,229.9494,307.714783333333,299465,299664,199
104,20,comma,130,229.90075,306.571216666667,299664,299863,199
104,20,},129,223.8508,309.9886,299863,299896,33
104,23,-,151,238.897466666667,360.3621,299930,300027,97
104,0,blank,0,237.43795,350.17435,300060,300193,133
104,0,blank,0,-350,-105,300226,300418,192
104,17,},97,10.8078,241.028725,300482,300657,175
104,23,array1,147,137.68,370.3279,300689,300721,32
104,23,num1,145,97.5812333333333,363.2672,300753,300853,100
104,23,num1,145,101.679083333333,363.177483333333,300887,301080,193
104,23,num1,145,94.9971833333333,371.012,301080,301272,192
104,23,num1,145,92.9248,371.791966666667,301272,301369,97
104,23,array1,147,191.7466,363.9365,301402,301434,32
104,23,array1,147,188.2938,368.331633333333,301466,301563,97
104,0,blank,0,229.30542,357.76096,301595,301755,160
104,0,blank,0,230.30695,358.99035,301788,301984,196
104,0,blank,0,-350,-105,302017,302215,198
104,0,blank,0,33.9499,191.5681,302281,302390,109
104,0,blank,0,227.92075,351.9388,302425,302553,128
104,0,blank,0,228.136233333333,348.974516666667,302585,302777,192
104,0,blank,0,233.0453,334.9494,302809,302841,32
104,0,blank,0,227.85825,346.701175,302873,302999,126
104,0,blank,0,232.499275,353.834125,303031,303156,125
104,0,blank,0,229.844233333333,348.232083333333,303188,303381,193
104,0,blank,0,229.8301,349.6493,303381,303414,33
104,0,blank,0,-350,-105,303478,303677,199
104,0,blank,0,-350,-105,303677,303778,101
104,0,blank,0,253.3822,353.6017,303817,303871,54
104,23,-,151,239.291066666667,358.800433333333,303903,304099,196
104,23,-,151,242.559633333333,363.5896,304099,304197,98
104,0,blank,0,138.74405,413.58005,304229,304293,64
104,0,blank,0,132.423,408.644933333333,304325,304425,100
104,32,i,199,173.34955,575.0727,304458,304522,64
104,0,blank,0,173.22345,578.61825,304555,304619,64
104,0,blank,0,180.155916666667,583.57405,304651,304844,193
104,0,blank,0,172.3018,577.9185,304844,304876,32
104,0,blank,0,170.2442,583.15566,304908,305068,160
104,0,blank,0,125.135166666667,573.480366666667,305100,305296,196
104,0,blank,0,-350,-105,305328,305521,193
104,0,blank,0,-350,-105,305521,305697,176
104,0,blank,0,-350,-105,305697,305750,53
104,34,num1,205,161.706666666667,617.047366666667,305781,305866,85
104,35,return,215,170.0405,627.2711,305896,305992,96
104,0,blank,0,231.92945,617.37225,306025,306089,64
104,0,blank,0,225.24945,613.646325,306121,306249,128
104,34,num2,210,236.94705,619.2498,306280,306344,64
104,0,blank,0,237.526475,629.3272,306378,306505,127
104,0,blank,0,229.3179,610.8453,306537,306570,33
104,23,array1,147,138.2231,377.400666666667,306602,306700,98
104,20,num1,113,117.0636,299.0774,306733,306766,33
104,20,num1,113,117.90325,309.681375,306799,306927,128
104,20,26,124,143.023033333333,310.15635,306959,307151,192
104,0,blank,0,138.752875,312.8589,307151,307283,132
104,0,blank,0,-350,-105,307347,307538,191
104,0,blank,0,160.718933333333,343.55925,307568,307742,174
104,0,blank,0,167.31215,353.4359,307742,307805,63
104,0,blank,0,230.7407,362.2454,307838,307869,31
104,0,blank,0,232.432316666667,378.04845,307901,308092,191
104,0,blank,0,254.70848,365.67382,308124,308282,158
104,0,blank,0,-350,-105,308345,308532,187
104,0,blank,0,-350,-105,308532,308709,177
104,0,blank,0,-350,-105,308709,308899,190
104,0,blank,0,-350,-105,308899,309075,176
104,0,blank,0,-350,-105,309075,309221,146
104,0,blank,0,-350,-105,309221,309317,96
104,0,blank,0,-350,-105,309317,309486,169
104,0,blank,0,-350,-105,309486,309664,178
104,0,blank,0,-350,-105,309664,309858,194
104,0,blank,0,-350,-105,309858,310029,171
104,0,blank,0,-350,-105,310029,310207,178
104,0,blank,0,-350,-105,310207,310291,84
104,0,blank,0,-350,-105,310291,310628,337
104,0,blank,0,-350,-105,310628,310803,175
104,0,blank,0,-350,-105,310803,310863,60
104,0,blank,0,-350,-105,310863,311068,205
104,0,blank,0,-350,-105,311068,311276,208
104,0,blank,0,-350,-105,311276,311572,296
104,0,blank,0,-350,-105,311572,311696,124
104,0,blank,0,-350,-105,311696,311839,143
104,0,blank,0,-350,-105,311839,312025,186
104,0,blank,0,-350,-105,312025,312089,64
104,0,blank,0,-350,-105,312089,312363,274
104,0,blank,0,-350,-105,312363,312542,179
104,0,blank,0,312.9657,336.6117,312562,312591,29
104,0,blank,0,-350,-105,312668,312853,185
104,0,blank,0,-350,-105,312853,313033,180
104,0,blank,0,-350,-105,313033,313197,164
104,23,-,151,242.299233333333,373.194466666667,313270,313441,171
104,23,a,152,263.7478,359.99885,313441,313530,89
104,23,],153,289.345675,358.613975,313572,313741,169
104,23,],153,291.157275,361.3346,313741,313916,175
104,0,blank,0,225.0705,349.0475,313916,314095,179
104,0,blank,0,185.2618,357.463325,314125,314248,123
104,0,blank,0,178.438,354.7606,314278,314309,31
104,0,blank,0,-350,-105,314340,314526,186
104,18,find_anagram,99,81.78538,248.18882,314576,314756,180
104,0,blank,0,192.22302,337.19058,314756,314912,156
104,0,blank,0,188.2148,342.6638,314943,314975,32
104,0,blank,0,224.945975,366.347425,315006,315128,122
104,0,blank,0,226.52995,358.921616666667,315160,315348,188
104,0,blank,0,222.324,357.02205,315379,315445,66
104,23,array1,147,150.804825,364.365125,315478,315605,127
104,23,array1,147,147.30355,361.42835,315636,315760,124
104,0,blank,0,-278.6274,-36.4778571428571,315791,315987,196
104,0,blank,0,-350,-105,315987,316039,52
104,0,blank,0,184.5413,302.6636,316168,316193,25
104,0,blank,0,180.7706,350.976,316241,316286,45
104,23,a,152,277.299325,358.3085,316333,316515,182
104,0,blank,0,277.4553,356.068225,316515,316688,173
104,0,blank,0,280.982525,342.22275,316732,316903,171
104,0,blank,0,301.5864,351.820775,316903,317076,173
104,23,++,154,307.5779,359.1898,317076,317107,31
104,0,blank,0,-129.956466666667,51.2191166666667,317137,317311,174
104,0,blank,0,-350,-105,317311,317489,178
104,0,blank,0,-350,-105,317489,317531,42
104,0,blank,0,309.5454,332.48625,317564,317612,48
104,23,++,154,294.097,362.755433333333,317643,317831,188
104,0,blank,0,250.0411,360.9998,317831,317862,31
104,0,blank,0,232.484966666667,348.494533333333,317893,317986,93
104,23,-,151,235.6896,359.920666666667,318018,318111,93
104,0,blank,0,244.0759,355.1501,318142,318172,30
104,0,blank,0,310.9595,355.8432,318204,318235,31
104,0,blank,0,293.3864,352.8159,318266,318297,31
104,0,blank,0,317.5819,384.23635,318328,318390,62
104,0,blank,0,-350,-105,318422,318614,192
104,0,blank,0,-350,-105,318614,318793,179
104,0,blank,0,-350,-105,318793,318919,126
104,0,blank,0,-350,-105,318919,319027,108
104,0,blank,0,224.643875,337.984625,319225,319384,159
104,0,blank,0,232.13055,336.9663,319384,319551,167
104,0,blank,0,287.0807,351.682933333333,319551,319675,124
104,0,blank,0,169.2122,347.137725,319719,319891,172
104,21,i,139,193.0958,323.01792,319891,320059,168
104,0,blank,0,195.39875,336.34095,320091,320153,62
104,0,blank,0,-271.568871428571,-39.4535142857143,320185,320384,199
104,0,blank,0,-350,-105,320384,320450,66
104,0,blank,0,-176.448814285714,11.9286857142857,320481,320670,189
104,0,blank,0,-350,-105,320670,320850,180
104,0,blank,0,-350,-105,320850,321028,178
104,0,blank,0,-350,-105,321028,321210,182
104,0,blank,0,-350,-105,321210,321388,178
104,0,blank,0,-350,-105,321388,321565,177
104,0,blank,0,-350,-105,321565,321691,126
104,0,blank,0,-350,-105,321691,322042,351
104,0,blank,0,-350,-105,322042,322389,347
104,0,blank,0,-350,-105,322389,322554,165
104,0,blank,0,-350,-105,322554,322739,185
104,0,blank,0,-350,-105,322739,322844,105
104,0,blank,0,-95.36225,144.63385,322887,322979,92
104,0,blank,0,156.3329,386.3863,322979,323096,117
104,0,blank,0,157.0289,397.4441,323096,323179,83
104,0,blank,0,-350,-105,323257,323593,336
104,0,blank,0,-350,-105,323593,323835,242
104,0,blank,0,-350,-105,323835,323967,132
104,0,blank,0,-350,-105,323967,324106,139
104,23,array1,147,187.7878,368.7201,324421,324500,79
104,0,blank,0,-350,-105,324606,324750,144
104,0,blank,0,165.7839,397.19,324845,324870,25
104,23,a,152,258.2532,376.0502,324966,325055,89
104,0,blank,0,225.98782,347.74184,325087,325278,191
104,0,blank,0,-235.13208,-21.8791,325278,325457,179
104,0,blank,0,-350,-105,325457,325636,179
104,0,blank,0,-350,-105,325636,325815,179
104,0,blank,0,-350,-105,325815,325998,183
104,0,blank,0,-350,-105,325998,326177,179
104,0,blank,0,-350,-105,326177,326371,194
104,0,blank,0,-350,-105,326371,326560,189
104,0,blank,0,-350,-105,326560,326738,178
104,0,blank,0,-350,-105,326738,326782,44
104,0,blank,0,251.425325,342.9576,326855,327019,164
104,0,blank,0,256.516425,345.03905,327019,327199,180
104,23,++,154,308.1704,359.94494,327199,327381,182
104,23,++,154,310.6311,362.97835,327381,327443,62
104,0,blank,0,-350,-105,327473,327634,161
104,0,blank,0,163.3966,236.71135,327673,327808,135
104,0,blank,0,324.4998,354.4876,327838,327868,30
104,0,blank,0,328.7527,373.4008,327899,327931,32
104,0,blank,0,369.225166666667,373.349616666667,327962,328149,187
104,0,blank,0,356.20856,366.82186,328149,328304,155
104,0,blank,0,364.973725,382.145325,328335,328457,122
104,0,blank,0,252.328166666667,372.7313,328488,328578,90
104,23,i,149,208.1137,376.0764,328609,328700,91
104,23,array1,147,180.308733333333,376.22065,328731,328917,186
104,23,array1,147,183.0586,372.7354,328917,328948,31
104,0,blank,0,-350,-105,328980,329166,186
104,0,blank,0,-350,-105,329166,329355,189
104,0,blank,0,-350,-105,329355,329544,189
104,0,blank,0,-350,-105,329544,329651,107
104,0,blank,0,241.693525,276.351925,329690,329846,156
104,0,blank,0,270.0163,276.697633333333,329846,330021,175
104,0,blank,0,-145.423366666667,36.8558666666667,330021,330149,128
104,0,blank,0,-350,-105,330149,330311,162
104,0,blank,0,-192.71385,9.04105,330390,330565,175
104,0,blank,0,-350,-105,330565,330745,180
104,0,blank,0,283.9436,284.0063,330825,331005,180
104,21,i,139,191.9571,320.8572,331005,331165,160
104,21,i,139,190.4666,317.02795,331165,331251,86
104,0,blank,0,-79.03285,141.256175,331294,331464,170
104,18,find_anagram,99,89.7738166666667,258.263616666667,331515,331692,177
104,0,blank,0,180.18958,336.77898,331722,331869,147
104,21,[,138,181.295533333333,325.138133333333,331899,331988,89
104,0,blank,0,-350,-105,332018,332202,184
104,0,blank,0,-350,-105,332227,332405,178
104,0,blank,0,-350,-105,332405,332463,58
104,0,blank,0,215.807825,316.054675,332563,332743,180
104,21,],140,196.6406,325.6015,332743,332786,43
104,0,blank,0,167.202625,352.927675,332828,333006,178
104,23,array1,147,143.610225,371.7628,333006,333176,170
104,0,blank,0,-252.34284,-7.03772,333176,333357,181
104,0,blank,0,-350,-105,333357,333536,179
104,0,blank,0,-350,-105,333536,333715,179
104,0,blank,0,-350,-105,333715,333896,181
104,0,blank,0,-350,-105,333896,333980,84
104,0,blank,0,-217.3703,78.7429714285714,334047,334243,196
104,0,blank,0,-350,-105,334243,334398,155
104,0,blank,0,-350,-105,334398,334445,47
104,0,blank,0,-350,-105,334468,334652,184
104,0,blank,0,-350,-105,334652,334677,25
104,0,blank,0,101.8307,228.09818,334737,334920,183
104,0,blank,0,244.6946,318.2689,334920,334950,30
104,20,comma,130,227.12125,310.07615,334980,335042,62
104,0,blank,0,234.2548,340.7979,335072,335102,30
104,0,blank,0,236.7089,300.111766666667,335133,335223,90
104,21,i,139,189.0676,333.829966666667,335254,335344,90
104,23,[,148,125.136033333333,358.427433333333,335374,335496,122
104,0,blank,0,117.0277,353.857033333333,335496,335661,165
104,0,blank,0,248.723475,344.020875,335661,335826,165
104,0,blank,0,259.970675,352.29415,335826,335983,157
104,23,a,152,270.858275,372.747275,335983,336140,157
104,0,blank,0,253.84706,343.00762,336140,336324,184
104,0,blank,0,254.3332,362.7168,336324,336384,60
104,0,blank,0,125.107933333333,356.78935,336414,336595,181
104,0,blank,0,77.5644,350.1446,336595,336625,30
104,0,blank,0,78.7765166666667,357.922283333333,336656,336839,183
104,0,blank,0,-306.819671428571,-5.43858571428572,336870,337066,196
104,0,blank,0,-350,-105,337066,337092,26
104,16,return,94,53.3605,206.91428,337142,337323,181
104,0,blank,0,178.04345,291.31765,337323,337445,122
104,0,blank,0,175.613866666667,284.570866666667,337476,337568,92
104,0,blank,0,189.5944,277.1661,337599,337629,30
104,0,blank,0,300.170166666667,289.990133333333,337659,337752,93
104,0,blank,0,296.9869,281.5338,337782,337812,30
104,20,26,124,135.47045,300.09305,337842,338025,183
104,0,blank,0,169.14182,291.11388,338056,338208,152
104,0,blank,0,172.129666666667,295.8278,338238,338329,91
104,0,blank,0,183.8861,283.70145,338359,338542,183
104,0,blank,0,117.716983333333,283.530666666667,338542,338724,182
104,20,num1,113,109.083266666667,294.498166666667,338755,338846,91
104,0,blank,0,109.3667,347.0523,338876,338906,30
104,23,num1,145,113.385525,360.70945,338936,339058,122
104,0,blank,0,-350,-105,339088,339277,189
104,0,blank,0,78.9663,280.169883333333,339303,339486,183
104,23,array1,147,163.6004,359.419966666667,339486,339577,91
104,23,],153,219.580566666667,360.678916666667,339609,339792,183
104,0,blank,0,235.1135,353.2995,339823,339944,121
104,0,blank,0,242.006983333333,356.5233,339974,340157,183
104,0,blank,0,257.277666666667,357.823433333333,340157,340249,92
104,0,blank,0,247.1514,342.662933333333,340279,340371,92
104,23,a,152,260.33255,363.99505,340402,340462,60
104,0,blank,0,251.59385,340.44335,340493,340554,61
104,0,blank,0,209.73718,353.5632,340585,340739,154
104,0,blank,0,-350,-105,340770,340958,188
104,0,blank,0,-350,-105,340958,341138,180
104,0,blank,0,-350,-105,341138,341336,198
104,0,blank,0,343.0299,326.3914,341362,341449,87
104,0,blank,0,355.006616666667,325.9829,341479,341660,181
104,20,0,133,364.1147,307.314,341660,341689,29
104,0,blank,0,359.295,325.2869,341719,341897,178
104,0,blank,0,353.273183333333,322.625233333333,341928,342105,177
104,0,blank,0,358.0638,320.5776,342105,342134,29
104,21,0,142,263.931166666667,325.741466666667,342165,342254,89
104,21,0,142,264.033666666667,326.142033333333,342284,342372,88
104,0,blank,0,156.137125,576.97875,342401,342525,124
104,35,return,215,159.0897,629.6644,342555,342585,30
104,0,blank,0,268.5053,-103.896575,342617,342740,123
104,0,blank,0,217.438566666667,-103.880916666667,342769,342951,182
104,0,blank,0,199.47475,-103.8757,342982,343167,185
104,0,blank,0,198.676833333333,-103.8673,343167,343353,186
104,0,blank,0,656.50415,134.388133333333,343383,343581,198
104,0,blank,0,587.2041,-103.87225,343611,343675,64
104,0,blank,0,593.213383333333,-103.85275,343706,343900,194
104,0,blank,0,584.961566666667,-103.846633333333,343900,343996,96
104,0,blank,0,585.877866666667,-103.860733333333,344027,344218,191
104,0,blank,0,588.0792,-103.8479,344218,344282,64
104,0,blank,0,152.07068,378.79248,344314,344474,160
104,23,array1,147,155.165483333333,376.12775,344505,344695,190
104,23,array1,147,145.8218,367.4263,344695,344727,32
104,0,blank,0,-350,-105,344757,344948,191
104,0,blank,0,-350,-105,344948,345113,165
104,0,blank,0,141.29425,340.8801,345145,345200,55
104,0,blank,0,143.427133333333,355.775633333333,345234,345332,98
104,0,blank,0,99.35756,352.31832,345366,345535,169
104,0,blank,0,145.576625,350.9166,345570,345702,132
104,0,blank,0,146.8226,340.8629,345735,345768,33
104,0,blank,0,-149.04948,73.30612,345799,345985,186
104,0,blank,0,-350,-105,345985,346166,181
104,0,blank,0,-350,-105,346166,346343,177
104,0,blank,0,-350,-105,346343,346398,55
104,0,blank,0,329.137733333333,331.113416666667,346427,346602,175
104,0,blank,0,323.4124,334.761,346633,346727,94
104,0,blank,0,331.9303,337.716466666667,346758,346851,93
104,0,blank,0,322.146883333333,337.514966666667,346883,347074,191
104,0,blank,0,325.5793,331.455216666667,347074,347265,191
104,0,blank,0,327.54295,337.812025,347265,347393,128
104,0,blank,0,329.311625,328.47985,347425,347554,129
104,0,blank,0,326.9446,351.424966666667,347585,347781,196
104,0,blank,0,-350,-105,347813,347983,170
104,18,char,106,196.53814,258.69918,348027,348192,165
104,23,;,155,315.5183,358.4588,348223,348254,31
104,0,blank,0,327.617,351.7042,348286,348318,32
104,0,blank,0,318.1457,342.0006,348347,348379,32
104,0,blank,0,316.2753,321.4886,348409,348440,31
104,0,blank,0,324.05518,346.3822,348471,348628,157
104,0,blank,0,321.67772,348.9331,348660,348817,157
104,0,blank,0,330.153925,332.6379,348848,348973,125
104,0,blank,0,329.33775,339.42065,349004,349067,63
104,0,blank,0,322.26175,327.3438,349099,349162,63
104,0,blank,0,333.076283333333,339.4928,349193,349381,188
104,0,blank,0,335.4763,328.8998,349413,349477,64
104,0,blank,0,-233.791783333333,-26.3723,349509,349683,174
104,0,blank,0,-350,-105,349683,349775,92
104,0,blank,0,316.78928,351.7384,349814,349964,150
104,0,blank,0,226.6219,362.96112,349997,350159,162
104,0,blank,0,229.39625,353.3649,350190,350253,63
104,0,blank,0,305.69405,348.3895,350285,350348,63
104,0,blank,0,323.89995,357.466925,350381,350507,126
104,0,blank,0,332.91735,367.05765,350539,350603,64
104,0,blank,0,328.98494,341.95772,350634,350792,158
104,0,blank,0,326.99945,328.82465,350824,350888,64
104,0,blank,0,324.8959,332.1331,350920,351048,128
104,0,blank,0,246.21445,345.4034,351104,351298,194
104,0,blank,0,239.11285,349.09995,351298,351466,168
104,0,blank,0,245.24988,346.93262,351466,351633,167
104,0,blank,0,247.4519,349.623,351633,351666,33
104,0,blank,0,-350,-105,351697,351891,194
104,18,find_anagram,99,135.94474,254.87966,351922,352087,165
104,23,a,152,268.2761,358.8296,352117,352149,32
104,0,blank,0,275.557566666667,338.76775,352180,352369,189
104,0,blank,0,272.9955,336.63566,352369,352527,158
104,0,blank,0,273.70186,335.97138,352558,352715,157
104,0,blank,0,276.97925,346.2544,352746,352811,65
104,0,blank,0,273.881716666667,345.368816666667,352842,353031,189
104,0,blank,0,273.667283333333,345.095966666667,353031,353225,194
104,0,blank,0,273.125825,338.521225,353225,353351,126
104,0,blank,0,274.057416666667,351.0731,353383,353575,192
104,23,a,152,273.980516666667,359.2233,353575,353773,198
104,0,blank,0,272.3951,357.0441,353773,353806,33
104,0,blank,0,-350,-105,353840,353990,150
104,0,blank,0,-350,-105,354057,354245,188
104,0,blank,0,-350,-105,354245,354359,114
104,0,blank,0,-350,-105,354359,354492,133
104,0,blank,0,152.238166666667,349.86635,354536,354720,184
104,0,blank,0,149.409833333333,340.044233333333,354720,354816,96
104,0,blank,0,154.776133333333,342.1863,354848,354943,95
104,0,blank,0,159.451675,337.7586,354974,355099,125
104,0,blank,0,140.56705,349.71255,355131,355193,62
104,0,blank,0,141.30976,347.3858,355224,355381,157
104,0,blank,0,166.7222,353.5048,355412,355508,96
104,23,array1,147,169.798433333333,358.144333333333,355540,355636,96
104,0,blank,0,182.04625,348.92185,355668,355735,67
104,0,blank,0,175.8405,341.9885,355767,355800,33
104,0,blank,0,-350,-105,355833,356030,197
104,0,blank,0,-350,-105,356030,356203,173
104,0,blank,0,144.0464,351.144,356234,356293,59
104,0,blank,0,149.738483333333,354.8448,356320,356516,196
104,23,array1,147,152.0657,359.376,356516,356550,34
104,21,array1,137,129.07468,324.86748,356583,356752,169
104,21,array1,137,121.906733333333,318.209933333333,356752,356849,97
104,21,array1,137,132.2339,321.7088,356884,356916,32
104,21,array1,137,119.4596,321.683466666667,356949,357047,98
104,21,array1,137,144.02265,318.807916666667,357078,357275,197
104,20,],125,154.3721,298.9781,357308,357342,34
104,0,blank,0,-350,-105,357379,357555,176
104,0,blank,0,-350,-105,357555,357693,138
104,21,array1,137,149.9849,331.2602,357724,357805,81
104,0,blank,0,150.577866666667,336.214733333333,357837,357935,98
104,0,blank,0,146.309866666667,340.423966666667,357967,358066,99
104,0,blank,0,153.517,340.0488,358099,358133,34
104,0,blank,0,178.2978,343.361725,358167,358299,132
104,0,blank,0,179.434766666667,342.495933333333,358332,358525,193
104,0,blank,0,185.6087,346.9728,358525,358591,66
104,0,blank,0,182.5996,348.119633333333,358623,358721,98
104,0,blank,0,149.0237,351.5793,358753,358785,32
104,0,blank,0,149.8273,346.8132,358818,358945,127
104,0,blank,0,137.96585,347.615883333333,358977,359169,192
104,0,blank,0,134.8888,345.1271,359169,359201,32
104,0,blank,0,137.1998,346.5692,359233,359264,31
104,0,blank,0,171.3499,353.0033,359296,359328,32
104,0,blank,0,172.4458,338.426825,359361,359490,129
104,0,blank,0,-350,-105,359522,359655,133
104,0,blank,0,16.462525,191.087325,359681,359814,133
104,0,blank,0,211.641366666667,272.222983333333,359846,360038,192
104,18,char,106,219.42535,267.89515,360038,360103,65
104,0,blank,0,232.48775,230.293733333333,360135,360325,190
104,0,blank,0,231.604575,229.10305,360325,360452,127
104,0,blank,0,233.937666666667,228.8465,360484,360579,95
104,0,blank,0,91.98285,234.0083,360610,360673,63
104,0,blank,0,86.5174,234.667583333333,360704,360898,194
104,0,blank,0,85.4248333333333,232.2666,360898,360994,96
104,0,blank,0,-350,-105,361026,361210,184
104,0,blank,0,-350,-105,361210,361358,148
104,0,blank,0,201.17025,223.8088,361389,361444,55
104,0,blank,0,236.53012,227.88802,361475,361635,160
104,0,blank,0,236.39435,231.98225,361668,361859,191
104,0,blank,0,239.540933333333,232.272183333333,361859,362054,195
104,15,"%sand%sarenotanagrams.\n",87,158.224125,183.329075,362087,362214,127
104,15,"%sand%sarenotanagrams.\n",87,161.11255,191.19675,362245,362308,63
104,0,blank,0,233.26965,240.199133333333,362340,362530,190
104,0,blank,0,219.879883333333,228.334416666667,362530,362723,193
104,0,blank,0,215.304,223.424233333333,362756,362851,95
104,0,blank,0,213.54165,227.10335,362883,362949,66
104,0,blank,0,216.3036,232.2099,362981,363014,33
104,0,blank,0,184.298,233.0598,363047,363183,136
104,0,blank,0,224.270266666667,234.853533333333,363215,363405,190
104,0,blank,0,220.8113,238.6392,363405,363436,31
104,0,blank,0,-350,-105,363469,363577,108
104,0,blank,0,80.079125,147.833875,363602,363724,122
104,21,array1,137,117.595,331.86058,363756,363915,159
104,21,(,136,112.1832,324.79645,363947,364012,65
104,0,blank,0,144.85182,347.00816,364044,364203,159
104,20,[,123,132.2942,305.591066666667,364235,364330,95
104,0,blank,0,-279.809485714286,-46.6108857142857,364362,364557,195
104,11,find_anagram,62,150.3257,97.4998,364609,364670,61
104,11,find_anagram,62,149.60275,100.19395,364707,364761,54
104,8,;,49,171.82516,36.07872,364791,364950,159
104,0,blank,0,156.21406,4.73454,364982,365142,160
104,9,"Enteranotherstring\n",52,230.6127,51.95945,365174,365237,63
104,9,"Enteranotherstring\n",52,231.401933333333,65.4954,365268,365455,187
104,0,blank,0,229.1614,81.4842,365486,365517,31
104,0,blank,0,229.1766,72.9208666666667,365549,365738,189
104,0,blank,0,230.767625,78.479025,365738,365863,125
104,0,blank,0,-350,-105,365895,366085,190
104,0,blank,0,-350,-105,366085,366266,181
104,0,blank,0,-350,-105,366266,366457,191
104,0,blank,0,-350,-105,366457,366481,24
104,0,blank,0,1039.805,294.6282,366511,366537,26
104,0,blank,0,944.814,291.5233,366614,366809,195
104,0,blank,0,941.3325,293.2526,366809,366941,132
104,0,blank,0,942.2236,298.57616,366974,367141,167
104,0,blank,0,946.436666666667,300.718266666667,367141,367243,102
104,0,blank,0,943.809,302.27035,367277,367344,67
104,0,blank,0,959.516,74.32116,367378,367548,170
104,0,blank,0,959.408,79.04268,367548,367713,165
104,0,blank,0,955.899,79.0288,367746,367813,67
104,0,blank,0,952.8196,17.62956,367848,368015,167
104,0,blank,0,953.1955,16.9952,368015,368083,68
104,0,blank,0,253.840825,117.0014,368117,368252,135
104,0,blank,0,204.2857,125.9043,368285,368318,33
104,11,find_anagram,62,121.306175,111.354625,368351,368488,137
104,10,array2,57,108.8991,71.8944,368524,368559,35
105,0,blank,0,-83.4548333333333,4.68366666666667,368971,369067,96
105,0,blank,0,97.5437666666667,70.5583166666667,369100,369295,195
105,0,blank,0,100.34135,70.26165,369295,369492,197
105,0,blank,0,96.60655,69.50715,369525,369655,130
105,0,blank,0,102.3398,63.83365,369688,369754,66
105,0,blank,0,120.985466666667,66.7024833333333,369788,369986,198
105,0,blank,0,-350,-105,370019,370208,189
105,0,blank,0,-350,-105,370208,370367,159
105,0,blank,0,-350,-105,370367,370411,44
105,0,blank,0,157.7247,70.7824,370442,370457,15
105,0,blank,0,261.01235,73.9503833333333,370495,370683,188
105,0,blank,0,234.0101,71.70685,370715,370778,63
105,0,blank,0,235.641266666667,75.8333,370810,370905,95
105,0,blank,0,221.287866666667,74.4208,370936,371129,193
105,0,blank,0,276.467666666667,70.4915,371160,371255,95
105,0,blank,0,274.6175,67.96602,371287,371449,162
105,0,blank,0,281.8648,61.3011,371449,371503,54
105,0,blank,0,65.6201,86.2585,371612,371693,81
105,0,blank,0,76.0269,78.0378,371693,371823,130
105,5,char,26,74.4758,100.7699,371867,371906,39
105,0,blank,0,-350,-105,371942,372126,184
105,0,blank,0,-6.92652000000001,52.03114,372176,372353,177
105,5,100,34,167.891016666667,111.125983333333,372385,372580,195
105,5,100,34,165.2252,109.0937,372580,372613,33
105,0,blank,0,212.145375,116.1437,372644,372773,129
105,0,blank,0,81.792,122.7255,372805,372869,64
105,6,flag,38,89.89605,128.42225,372902,372965,63
105,5,char,26,75.885975,111.8502,372997,373125,128
105,5,char,26,74.58725,95.5659,373158,373223,65
105,5,char,26,72.6508666666667,110.983466666667,373255,373352,97
105,0,blank,0,-350,-105,373386,373581,195
105,3,int,21,3.23464,54.81988,373620,373790,170
105,5,array1,27,93.456725,100.022525,373790,373922,132
105,0,blank,0,196.1964,114.428,373956,374023,67
105,0,blank,0,203.7213,110.12495,374057,374122,65
105,5,array1,27,146.44625,109.0801,374154,374219,65
105,0,blank,0,147.9044,119.5165,374251,374349,98
105,0,blank,0,211.351466666667,120.6304,374381,374479,98
105,7,"Enterthestring\n",42,123.684283333333,135.014433333333,374511,374704,193
105,7,(,41,112.02705,135.0067,374704,374770,66
105,0,blank,0,-350,-105,374835,375014,179
105,0,blank,0,-350,-105,375014,375069,55
105,7,printf,40,64.2765333333333,148.745,375104,375288,184
105,8,gets,45,56.7149,159.5471,375288,375322,34
105,7,printf,40,64.0383,141.3813,375356,375390,34
105,9,printf,50,69.2938666666667,190.089833333333,375426,375534,108
105,9,(,51,109.79232,192.72172,375572,375744,172
105,9,printf,50,103.8007,186.33432,375744,375912,168
105,9,printf,50,103.13674,194.6634,375912,376077,165
105,9,printf,50,101.995066666667,182.744233333333,376110,376212,102
105,0,blank,0,-350,-105,376245,376394,149
105,0,blank,0,-350,-105,376394,376557,163
105,0,blank,0,-350,-105,376557,376609,52
105,0,blank,0,317.6278,203.19145,376644,376703,59
105,0,blank,0,323.689,206.2921,376741,376777,36
105,0,blank,0,244.9551,208.332375,376813,376953,140
105,0,blank,0,250.11832,211.31208,376986,377153,167
105,0,blank,0,244.345033333333,208.529033333333,377153,377261,108
105,11,find_anagram,62,170.0142,229.6491,377296,377333,37
105,11,find_anagram,62,164.773825,225.737525,377371,377509,138
105,0,blank,0,257.7899,218.631,377542,377646,104
105,0,blank,0,-350,-105,377679,377821,142
105,7,"Enterthestring\n",42,128.90396,146.34882,377858,378041,183
105,0,blank,0,251.69675,207.9651,378073,378207,134
105,13,"%sand%sareanagrams.\n",77,306.244383333333,267.030733333333,378241,378437,196
105,0,blank,0,202.8695,419.8473,378468,378534,66
105,20,0,133,213.6561,432.4106,378566,378695,129
105,0,blank,0,157.5631,470.555,378728,378890,162
105,23,array1,147,149.248366666667,490.611966666667,378923,379021,98
105,0,blank,0,157.0975,514.2496,379053,379085,32
105,0,blank,0,146.82675,486.60005,379118,379183,65
105,0,blank,0,897.32978,247.74576,379215,379384,169
105,0,blank,0,960.7474,230.6764,379384,379552,168
105,0,blank,0,955.640333333333,238.802933333333,379552,379652,100
105,0,blank,0,951.2765,238.888216666667,379685,379881,196
105,0,blank,0,950.432,243.898966666667,379881,379980,99
105,0,blank,0,-350,-105,380013,380176,163
105,15,printf,85,96.75368,331.62166,380232,380427,195
105,0,blank,0,204.8326,444.7671,380458,380492,34
105,23,array1,147,161.8517,495.251,380525,380622,97
105,0,blank,0,156.3179,477.9802,380654,380687,33
105,21,array1,137,156.9985,452.24555,380720,380785,65
105,20,],125,160.19295,439.43555,380817,380946,129
105,21,array1,137,151.351066666667,460.796766666667,380978,381170,192
105,0,blank,0,-350,-105,381203,381289,86
105,0,blank,0,942.978,148.8289,381356,381411,55
105,0,blank,0,938.352,161.6622,381447,381478,31
106,0,blank,0,133.19985,316.0727,381937,382001,64
106,16,;,96,127.684325,320.017625,382033,382163,130
106,18,find_anagram,99,134.1839,361.5215,382195,382226,31
106,18,find_anagram,99,121.24,350.9341,382257,382290,33
106,18,find_anagram,99,128.327725,357.902175,382322,382451,129
107,0,blank,0,-350,-105,382954,383053,99
107,0,blank,0,313.427125,350.13765,383081,383198,117
107,0,blank,0,315.004366666667,351.569166666667,383229,383322,93
107,0,blank,0,322.4129,345.062866666667,383354,383447,93
107,0,blank,0,324.34855,342.46765,383479,383668,189
107,0,blank,0,-350,-105,383698,383868,170
107,0,blank,0,-350,-105,383868,383961,93
107,0,blank,0,325.4402,340.014525,384000,384117,117
107,0,blank,0,322.01765,333.81135,384149,384212,63
107,0,blank,0,327.349525,338.0719,384244,384371,127
107,0,blank,0,319.74625,354.15445,384403,384468,65
107,0,blank,0,319.44354,350.37546,384499,384660,161
107,0,blank,0,320.544083333333,353.318333333333,384692,384885,193
107,0,blank,0,-350,-105,384918,385078,160
107,0,blank,0,145.596925,229.988525,385111,385247,136
107,0,blank,0,309.3702,343.24365,385280,385346,66
107,0,blank,0,234.089133333333,368.5082,385378,385476,98
107,0,blank,0,229.8748,362.2249,385509,385541,32
107,0,blank,0,232.1664,366.459,385573,385637,64
107,0,blank,0,240.1094,353.6429,385670,385702,32
107,0,blank,0,316.325,347.2844,385734,385766,32
107,0,blank,0,315.80726,350.71976,385798,385961,163
107,0,blank,0,318.0003,338.970766666667,385992,386088,96
107,0,blank,0,-350,-105,386120,386317,197
107,0,blank,0,-350,-105,386317,386481,164
107,0,blank,0,-350,-105,386481,386584,103
107,0,blank,0,326.88135,351.376716666667,386617,386798,181
107,0,blank,0,325.759216666667,350.896883333333,386798,386991,193
107,0,blank,0,317.616183333333,354.634833333333,387024,387215,191
107,0,blank,0,314.7505,354.47164,387215,387374,159
107,0,blank,0,320.0056,347.652383333333,387405,387594,189
107,0,blank,0,317.87225,343.4638,387594,387657,63
107,0,blank,0,288.92345,341.00305,387689,387877,188
107,0,blank,0,295.5881,334.6071,387877,387908,31
107,0,blank,0,284.4323,341.4705,387940,387971,31
107,0,blank,0,284.6539,346.4669,388002,388034,32
107,0,blank,0,-350,-105,388065,388224,159
107,0,blank,0,-350,-105,388224,388274,50
107,18,char,106,210.556933333333,266.588966666667,388337,388534,197
107,0,blank,0,324.2143,351.8253,388534,388566,32
107,0,blank,0,315.80295,357.4573,388598,388660,62
107,0,blank,0,324.4005,351.1887,388692,388724,32
107,0,blank,0,323.70905,347.31675,388755,388819,64
107,0,blank,0,324.603866666667,349.3984,388851,388946,95
107,0,blank,0,323.60105,348.62775,388977,389105,128
107,0,blank,0,331.9953,343.4679,389136,389167,31
107,0,blank,0,325.168633333333,358.2918,389199,389390,191
107,0,blank,0,322.230066666667,350.873316666667,389390,389583,193
107,0,blank,0,322.74375,341.4066,389583,389649,66
107,0,blank,0,319.1941,349.820483333333,389682,389875,193
107,0,blank,0,314.6393,353.412,389907,389940,33
107,0,blank,0,-350,-105,389972,390160,188
107,16,return,94,76.0350666666667,208.140166666667,390212,390319,107
107,0,blank,0,295.07805,348.8353,390354,390419,65
107,0,blank,0,321.217333333333,352.552983333333,390451,390643,192
107,0,blank,0,319.096466666667,352.9425,390643,390739,96
107,0,blank,0,323.5366,361.6456,390771,390802,31
107,0,blank,0,331.4188,326.2832,390834,390865,31
107,0,blank,0,323.956325,347.5039,390898,391025,127
107,0,blank,0,323.196316666667,340.442033333333,391057,391245,188
107,0,blank,0,321.27255,340.83635,391245,391309,64
107,0,blank,0,-350,-105,391340,391529,189
107,0,blank,0,-350,-105,391529,391725,196
107,0,blank,0,318.7955,344.922266666667,391760,391849,89
107,0,blank,0,230.5828,340.408,391903,392015,112
107,0,blank,0,229.3553,347.8918,392015,392139,124
107,0,blank,0,264.346,347.9867,392232,392299,67
107,0,blank,0,260.1842,342.91445,392331,392393,62
107,0,blank,0,317.979,343.9727,392425,392613,188
107,0,blank,0,313.63695,353.66285,392613,392676,63
107,0,blank,0,234.98935,345.707,392707,392769,62
107,0,blank,0,241.15475,344.083633333333,392801,392991,190
107,0,blank,0,318.483275,354.3322,393022,393151,129
107,0,blank,0,318.8436,343.33945,393183,393247,64
107,0,blank,0,-350,-105,393279,393449,170
107,0,blank,0,-350,-105,393449,393488,39
107,0,blank,0,152.93295,231.18575,393541,393677,136
107,0,blank,0,317.848533333333,347.0688,393710,393806,96
107,0,blank,0,-350,-105,393870,394059,189
107,0,blank,0,-350,-105,394059,394164,105
107,0,blank,0,321.365925,328.654925,394200,394313,113
107,0,blank,0,324.254066666667,327.197666666667,394345,394440,95
107,0,blank,0,245.462866666667,349.5292,394471,394564,93
107,0,blank,0,249.9138,342.0592,394596,394691,95
107,0,blank,0,254.60315,353.861175,394723,394848,125
107,0,blank,0,-350,-105,394879,395044,165
107,0,blank,0,113.01505,223.10255,395074,395223,149
107,0,blank,0,261.068,345.3397,395254,395317,63
107,0,blank,0,263.737166666667,339.2932,395350,395445,95
107,0,blank,0,-226.90822,-16.35156,395477,395657,180
107,0,blank,0,-350,-105,395657,395825,168
107,0,blank,0,273.288166666667,382.273966666667,396369,396495,126
107,0,blank,0,294.499033333333,349.810833333333,396495,396666,171
107,0,blank,0,-350,-105,396666,396861,195
107,0,blank,0,-350,-105,396861,397041,180
107,0,blank,0,-350,-105,397041,397225,184
107,0,blank,0,-350,-105,397225,397403,178
107,0,blank,0,141.952366666667,346.7481,397436,397611,175
107,0,blank,0,-133.46094,105.21976,397611,397790,179
107,0,blank,0,-350,-105,397790,397974,184
107,0,blank,0,-350,-105,397974,398151,177
107,0,blank,0,-350,-105,398151,398349,198
107,0,blank,0,-350,-105,398349,398536,187
107,0,blank,0,-350,-105,398536,398731,195
107,0,blank,0,-350,-105,398731,398907,176
107,0,blank,0,-350,-105,398907,399084,177
107,0,blank,0,-350,-105,399084,399262,178
107,0,blank,0,-350,-105,399262,399440,178
107,0,blank,0,-350,-105,399440,399619,179
107,0,blank,0,-350,-105,399619,399805,186
107,0,blank,0,-350,-105,399805,399988,183
107,0,blank,0,-350,-105,399988,400163,175
107,0,blank,0,-350,-105,400163,400340,177
107,0,blank,0,-350,-105,400340,400396,56
107,0,blank,0,-350,-105,400396,400657,261
107,0,blank,0,-350,-105,400657,400698,41
107,0,blank,0,-350,-105,400698,400934,236
107,0,blank,0,-350,-105,400934,401216,282
107,0,blank,0,-350,-105,401216,401381,165
107,0,blank,0,-24.0317,218.7561,401404,401597,193
107,0,blank,0,145.718,472.6723,401597,401823,226
107,0,blank,0,155.188725,481.070225,401823,401997,174
107,0,blank,0,139.114075,485.1046,401997,402172,175
107,0,blank,0,129.8069,486.595,402172,402215,43
107,0,blank,0,-350,-105,402259,402449,190
107,0,blank,0,-350,-105,402449,402630,181
107,0,blank,0,-350,-105,402630,402795,165
107,0,blank,0,-350,-105,402795,402972,177
107,0,blank,0,-350,-105,402972,403150,178
107,0,blank,0,-350,-105,403150,403328,178
107,0,blank,0,-350,-105,403328,403512,184
107,0,blank,0,-350,-105,403512,403675,163
107,0,blank,0,-350,-105,403675,403836,161
107,0,blank,0,-350,-105,403836,403934,98
107,0,blank,0,-350,-105,403934,404124,190
107,0,blank,0,-350,-105,404124,404308,184
107,0,blank,0,-350,-105,404308,404472,164
107,0,blank,0,-350,-105,404472,404649,177
107,0,blank,0,-350,-105,404649,404798,149
107,0,blank,0,-350,-105,404798,405078,280
107,0,blank,0,-350,-105,405078,405362,284
107,0,blank,0,-350,-105,405362,405537,175
107,0,blank,0,-350,-105,405537,405713,176
107,0,blank,0,-350,-105,405713,405836,123
107,0,blank,0,-350,-105,405836,406047,211
107,0,blank,0,-350,-105,406047,406320,273
107,0,blank,0,-350,-105,406320,406496,176
107,0,blank,0,-350,-105,406496,406693,197
107,0,blank,0,-350,-105,406693,406753,60
107,0,blank,0,18.2816,285.3935,406778,406886,108
107,0,blank,0,271.3814,485.7908,406934,406976,42
107,0,blank,0,231.1201,469.472525,407014,407191,177
107,0,blank,0,212.446975,486.42335,407236,407414,178
107,0,blank,0,226.1337,494.590275,407414,407585,171
107,0,blank,0,162.86818,398.9852,407585,407780,195
107,0,blank,0,151.91805,350.04155,407780,407843,63
107,0,blank,0,148.765733333333,355.810933333333,407875,407970,95
107,0,blank,0,171.9893,353.262583333333,408002,408193,191
107,0,blank,0,222.4396,353.9154,408225,408288,63
107,0,blank,0,222.6938,353.412233333333,408320,408414,94
107,0,blank,0,-350,-105,408447,408607,160
107,18,find_anagram,99,77.67188,260.73126,408636,408808,172
107,23,array1,147,159.5848,370.52515,408808,408872,64
107,23,array1,147,160.802116666667,363.29945,408904,409094,190
107,0,blank,0,160.1195,352.301,409125,409220,95
107,0,blank,0,-350,-105,409253,409446,193
107,0,blank,0,-350,-105,409446,409627,181
107,0,blank,0,-350,-105,409627,409789,162
107,0,blank,0,-350,-105,409789,409968,179
107,0,blank,0,-350,-105,409968,410096,128
107,0,blank,0,-350,-105,410096,410277,181
107,0,blank,0,-350,-105,410277,410463,186
107,0,blank,0,-350,-105,410463,410600,137
107,0,blank,0,-350,-105,410600,410787,187
107,0,blank,0,-350,-105,410787,410966,179
107,0,blank,0,211.478666666667,354.799133333333,410986,411146,160
107,0,blank,0,202.83405,345.8285,411146,411316,170
107,0,blank,0,191.2253,351.1935,411316,411360,44
107,0,blank,0,-350,-105,411404,411579,175
107,0,blank,0,-350,-105,411579,411758,179
107,0,blank,0,-350,-105,411758,411934,176
107,0,blank,0,-350,-105,411934,412113,179
107,0,blank,0,-350,-105,412113,412297,184
107,0,blank,0,-350,-105,412297,412471,174
107,0,blank,0,-350,-105,412471,412550,79
107,0,blank,0,-350,-105,412550,412831,281
107,0,blank,0,-350,-105,412831,412946,115
107,0,blank,0,-350,-105,412946,413056,110
107,0,blank,0,-350,-105,413056,413255,199
107,0,blank,0,-350,-105,413255,413436,181
107,0,blank,0,-350,-105,413436,413590,154
107,0,blank,0,-350,-105,413590,413740,150
107,0,blank,0,-350,-105,413740,414066,326
107,0,blank,0,-350,-105,414066,414256,190
107,0,blank,0,-350,-105,414256,414304,48
107,0,blank,0,-350,-105,414304,414503,199
107,0,blank,0,-350,-105,414503,414528,25
107,0,blank,0,-350,-105,414528,414720,192
107,0,blank,0,-350,-105,414720,414934,214
107,0,blank,0,-350,-105,414934,415130,196
107,0,blank,0,-350,-105,415130,415308,178
107,0,blank,0,-350,-105,415308,415480,172
107,0,blank,0,-350,-105,415480,415626,146
107,0,blank,0,-350,-105,415626,415846,220
107,0,blank,0,-350,-105,415846,416067,221
107,0,blank,0,-350,-105,416067,416264,197
107,0,blank,0,-350,-105,416264,416442,178
107,0,blank,0,-350,-105,416442,416628,186
107,0,blank,0,-350,-105,416628,416807,179
107,0,blank,0,-350,-105,416807,416987,180
107,0,blank,0,-350,-105,416987,417098,111
107,0,blank,0,230.64515,338.14815,417177,417338,161
107,0,blank,0,-48.96565,205.56,417338,417458,120
107,0,blank,0,254.377,470.6833,417458,417657,199
107,0,blank,0,-39.60405,122.58295,417657,417825,168
107,0,blank,0,341.879325,332.820675,417825,418015,190
107,0,blank,0,341.8188,334.53302,418015,418167,152
107,0,blank,0,345.5825,341.2752,418198,418259,61
107,0,blank,0,309.078475,329.1966,418290,418412,122
107,0,blank,0,-350,-105,418442,418548,106
107,0,blank,0,130.16278,244.2792,418589,418761,172
107,0,blank,0,-350,-105,418791,418977,186
107,0,blank,0,-350,-105,418977,419157,180
107,0,blank,0,-350,-105,419157,419340,183
107,0,blank,0,-350,-105,419340,419529,189
107,0,blank,0,-350,-105,419529,419706,177
107,0,blank,0,-350,-105,419706,419902,196
107,0,blank,0,-350,-105,419902,420039,137
107,0,blank,0,-350,-105,420039,420149,110
107,0,blank,0,-350,-105,420149,420355,206
107,0,blank,0,-350,-105,420355,420531,176
107,0,blank,0,-350,-105,420531,420619,88
107,0,blank,0,-350,-105,420619,420798,179
107,0,blank,0,-350,-105,420798,420861,63
107,0,blank,0,-350,-105,420861,421054,193
107,0,blank,0,-350,-105,421054,421255,201
107,0,blank,0,-350,-105,421255,421436,181
107,0,blank,0,-350,-105,421436,421613,177
107,0,blank,0,-350,-105,421613,421790,177
107,0,blank,0,-350,-105,421790,421976,186
107,0,blank,0,-350,-105,421976,422155,179
107,0,blank,0,-350,-105,422155,422344,189
107,0,blank,0,-350,-105,422344,422540,196
107,0,blank,0,-350,-105,422540,422690,150
107,0,blank,0,-350,-105,422690,422811,121
107,0,blank,0,-350,-105,422811,422908,97
107,0,blank,0,-350,-105,422908,423013,105
107,0,blank,0,-350,-105,423013,423220,207
107,0,blank,0,-350,-105,423220,423415,195
107,0,blank,0,-350,-105,423415,423602,187
107,0,blank,0,-350,-105,423602,423777,175
107,0,blank,0,-350,-105,423777,423968,191
107,0,blank,0,-350,-105,423968,424204,236
107,0,blank,0,-350,-105,424204,424492,288
107,0,blank,0,-350,-105,424492,424965,473
107,0,blank,0,-350,-105,424965,425142,177
107,0,blank,0,-350,-105,425142,425318,176
107,0,blank,0,-350,-105,425318,425495,177
107,0,blank,0,-350,-105,425495,425675,180
107,0,blank,0,-350,-105,425675,425859,184
107,0,blank,0,-350,-105,425859,426040,181
107,0,blank,0,-350,-105,426040,426211,171
107,0,blank,0,-350,-105,426211,426241,30
107,0,blank,0,-350,-105,426241,426482,241
107,0,blank,0,-350,-105,426482,426729,247
107,0,blank,0,-350,-105,426729,426873,144
107,0,blank,0,-350,-105,426873,427142,269
107,0,blank,0,-350,-105,427142,427407,265
107,0,blank,0,-350,-105,427407,427581,174
107,0,blank,0,-350,-105,427581,427776,195
107,0,blank,0,-350,-105,427776,427901,125
107,0,blank,0,-350,-105,427901,428018,117
107,0,blank,0,-350,-105,428018,428419,401
107,0,blank,0,-350,-105,428419,428716,297
107,0,blank,0,-350,-105,428716,428850,134
107,0,blank,0,-350,-105,428850,428969,119
107,0,blank,0,-350,-105,428969,429152,183
107,0,blank,0,-350,-105,429152,429329,177
107,0,blank,0,-350,-105,429329,429458,129
107,0,blank,0,-350,-105,429458,429640,182
107,0,blank,0,-350,-105,429640,429818,178
107,0,blank,0,-350,-105,429818,429994,176
107,0,blank,0,-350,-105,429994,430308,314
107,0,blank,0,-350,-105,430308,430504,196
107,0,blank,0,-350,-105,430504,430683,179
107,0,blank,0,-350,-105,430683,430868,185
107,0,blank,0,-350,-105,430868,431051,183
107,0,blank,0,-350,-105,431051,431232,181
107,0,blank,0,-350,-105,431232,431409,177
107,0,blank,0,-350,-105,431409,431583,174
107,0,blank,0,-350,-105,431583,431673,90
107,0,blank,0,-350,-105,431673,431831,158
107,0,blank,0,-350,-105,431831,431992,161
107,0,blank,0,-350,-105,431992,432378,386
107,0,blank,0,-350,-105,432378,432569,191
107,0,blank,0,-350,-105,432569,432748,179
107,0,blank,0,-350,-105,432748,432935,187
107,0,blank,0,-350,-105,432935,433087,152
107,0,blank,0,-350,-105,433087,433266,179
107,0,blank,0,-350,-105,433266,433428,162
107,0,blank,0,-350,-105,433428,433598,170
107,0,blank,0,-350,-105,433598,433781,183
107,0,blank,0,-350,-105,433781,433979,198
107,0,blank,0,-350,-105,433979,434155,176
107,0,blank,0,-350,-105,434155,434243,88
107,0,blank,0,-350,-105,434243,434414,171
107,0,blank,0,-350,-105,434414,434664,250
107,0,blank,0,-350,-105,434664,434839,175
107,0,blank,0,-350,-105,434839,435013,174
107,0,blank,0,-350,-105,435013,435068,55
107,0,blank,0,-350,-105,435068,435216,148
107,0,blank,0,-350,-105,435216,435354,138
107,0,blank,0,-350,-105,435354,435669,315
107,0,blank,0,-350,-105,435669,436019,350
107,0,blank,0,-350,-105,436019,436218,199
107,0,blank,0,-350,-105,436218,436394,176
107,0,blank,0,-350,-105,436394,436537,143
107,0,blank,0,-350,-105,436537,436736,199
107,0,blank,0,-350,-105,436736,436932,196
107,0,blank,0,-350,-105,436932,437110,178
107,0,blank,0,-350,-105,437110,437289,179
107,0,blank,0,-350,-105,437289,437469,180
107,0,blank,0,-350,-105,437469,437648,179
107,0,blank,0,-350,-105,437648,437832,184
107,0,blank,0,-350,-105,437832,438018,186
107,0,blank,0,-350,-105,438018,438052,34
107,0,blank,0,-350,-105,438052,438295,243
107,0,blank,0,-350,-105,438295,438562,267
107,0,blank,0,-350,-105,438562,438702,140
107,0,blank,0,196.901066666667,441.160466666667,438817,439003,186
107,0,blank,0,437.0995,645.4138,439003,439159,156
107,0,blank,0,-350,-105,439159,439432,273
107,0,blank,0,-350,-105,439432,439596,164
107,0,blank,0,-350,-105,439596,439661,65
107,0,blank,0,-350,-105,439761,439908,147
107,0,blank,0,-350,-105,439908,439970,62
107,0,blank,0,686.856,-103.8589,440103,440262,159
107,0,blank,0,675.8275,-103.8656,440412,440462,50
107,0,blank,0,685.49175,-103.866975,440487,440612,125
107,0,blank,0,696.711,-103.8669,440662,440737,75
107,0,blank,0,669.0935,-103.867983333333,440762,440937,175
107,0,blank,0,-350,-105,441019,441195,176
107,0,blank,0,-350,-105,441195,441372,177
107,0,blank,0,-350,-105,441372,441562,190
107,0,blank,0,-350,-105,441562,441599,37
107,0,blank,0,-350,-105,441599,441852,253
107,0,blank,0,-49.52945,188.21055,441972,442092,120
107,0,blank,0,-63.4333,248.54385,442092,442254,162
107,21,!=,141,217.48425,327.7772,442254,442378,124
107,0,blank,0,-350,-105,442378,442580,202
107,0,blank,0,-350,-105,442580,442666,86
107,20,26,124,143.2313,295.579425,442781,442921,140
107,20,26,124,145.603333333333,298.6379,442952,443048,96
107,0,blank,0,-350,-105,443080,443218,138
107,0,blank,0,36.76808,210.37088,443262,443440,178
107,21,array1,137,134.790416666667,332.155416666667,443471,443659,188
107,0,blank,0,145.6994,334.2309,443659,443692,33
107,0,blank,0,202.5418,334.69075,443722,443784,62
107,0,blank,0,194.77492,340.93394,443815,443974,159
107,0,blank,0,197.986883333333,341.01195,444005,444193,188
107,0,blank,0,191.4239,345.8203,444193,444224,31
107,0,blank,0,-350,-105,444256,444438,182
107,0,blank,0,-350,-105,444438,444618,180
107,0,blank,0,-350,-105,444618,444797,179
107,0,blank,0,-350,-105,444797,444972,175
107,0,blank,0,-350,-105,444972,445147,175
107,0,blank,0,-350,-105,445147,445322,175
107,0,blank,0,-350,-105,445322,445499,177
107,0,blank,0,-350,-105,445499,445672,173
107,0,blank,0,-350,-105,445672,445804,132
107,0,blank,0,-350,-105,445804,446003,199
107,0,blank,0,-350,-105,446003,446100,97
107,0,blank,0,-350,-105,446100,446284,184
107,0,blank,0,-350,-105,446284,446469,185
107,0,blank,0,-350,-105,446469,446648,179
107,0,blank,0,-350,-105,446648,446828,180
107,0,blank,0,-350,-105,446828,447014,186
107,0,blank,0,-350,-105,447014,447146,132
107,0,blank,0,-350,-105,447146,447287,141
107,0,blank,0,-350,-105,447287,447348,61
107,0,blank,0,-350,-105,447348,447617,269
107,0,blank,0,-350,-105,447617,447796,179
107,0,blank,0,-350,-105,447796,447971,175
107,0,blank,0,-350,-105,447971,448147,176
107,0,blank,0,-350,-105,448147,448324,177
107,0,blank,0,-350,-105,448324,448501,177
107,0,blank,0,-350,-105,448501,448684,183
107,0,blank,0,-350,-105,448684,448864,180
107,0,blank,0,-350,-105,448864,449044,180
107,0,blank,0,-350,-105,449044,449224,180
107,0,blank,0,-350,-105,449224,449405,181
107,0,blank,0,-350,-105,449405,449480,75
107,13,"%sand%sareanagrams.\n",77,244.409466666667,146.604233333333,449511,449662,151
107,0,blank,0,392.52165,-103.8515,449662,449847,185
107,0,blank,0,-197.581433333333,-104.620133333333,449847,449976,129
107,18,array1,102,246.7656,259.1118,450040,450204,164
107,0,blank,0,315.53232,-103.8667,450204,450392,188
107,0,blank,0,155.7295,-104.43555,450392,450561,169
107,0,blank,0,-350,-105,450561,450713,152
107,0,blank,0,-350,-105,450713,450879,166
107,0,blank,0,139.81545,-104.44955,450927,451108,181
107,0,blank,0,640.06325,-103.91305,451108,451184,76
107,0,blank,0,-10.4766666666667,-104.623966666667,451263,451449,186
107,0,blank,0,-350,-105,451449,451616,167
107,0,blank,0,-350,-105,451616,451660,44
107,0,blank,0,355.4238,551.862766666667,451708,451900,192
107,0,blank,0,316.4438,555.2487,451900,452015,115
107,27,0,171,253.619,455.1829,452040,452126,86
107,0,blank,0,313.7764,627.9844,452126,452398,272
107,0,blank,0,231.9183,405.026466666667,452398,452544,146
107,0,blank,0,-18.531,182.63305,452544,452739,195
107,0,blank,0,-83.0166666666667,193.2761,452739,452906,167
107,0,blank,0,-274.49765,-104.812466666667,452952,453148,196
107,0,blank,0,-350,-105,453148,453327,179
107,0,blank,0,-350,-105,453327,453521,194
107,0,blank,0,-350,-105,453521,453707,186
107,21,while,135,50.46738,323.78762,454083,454258,175
107,0,blank,0,151.7019,437.83045,454258,454321,63
107,0,blank,0,-350,-105,454352,454542,190
107,0,blank,0,-350,-105,454542,454723,181
107,0,blank,0,-350,-105,454723,454888,165
107,0,blank,0,-350,-105,454888,455066,178
107,0,blank,0,-350,-105,455066,455245,179
107,0,blank,0,-350,-105,455245,455337,92
107,0,blank,0,-350,-105,455337,455540,203
107,0,blank,0,-350,-105,455540,455750,210
107,0,blank,0,-350,-105,455750,455812,62
107,0,blank,0,-350,-105,455812,456041,229
107,0,blank,0,-350,-105,456041,456271,230
107,0,blank,0,-350,-105,456271,456448,177
107,0,blank,0,-350,-105,456448,456626,178
107,0,blank,0,-350,-105,456626,456805,179
107,0,blank,0,-350,-105,456805,456982,177
107,0,blank,0,-350,-105,456982,457119,137
107,0,blank,0,-350,-105,457119,457275,156
107,0,blank,0,-350,-105,457275,457451,176
107,0,blank,0,-350,-105,457451,457588,137
107,0,blank,0,-350,-105,457588,457893,305
107,0,blank,0,-350,-105,457893,458073,180
107,0,blank,0,-350,-105,458073,458418,345
107,0,blank,0,-350,-105,458418,458601,183
107,0,blank,0,-350,-105,458601,458777,176
107,0,blank,0,-350,-105,458777,458952,175
107,0,blank,0,-350,-105,458952,459132,180
107,0,blank,0,-350,-105,459132,459310,178
107,0,blank,0,-350,-105,459310,459481,171
107,0,blank,0,-350,-105,459481,459666,185
107,0,blank,0,-350,-105,459666,459820,154
107,0,blank,0,-350,-105,459820,460073,253
107,0,blank,0,-350,-105,460073,460188,115
107,0,blank,0,-350,-105,460188,460464,276
107,0,blank,0,-350,-105,460464,460745,281
107,0,blank,0,-350,-105,460745,460941,196
107,0,blank,0,-350,-105,460941,461182,241
107,0,blank,0,-350,-105,461182,461426,244
107,0,blank,0,-350,-105,461426,461723,297
107,0,blank,0,-350,-105,461723,461900,177
107,0,blank,0,-350,-105,461900,462079,179
107,0,blank,0,-350,-105,462079,462261,182
107,0,blank,0,-350,-105,462261,462436,175
107,0,blank,0,-350,-105,462436,462566,130
107,0,blank,0,-350,-105,462566,462693,127
107,0,blank,0,-350,-105,462693,462864,171
107,0,blank,0,-350,-105,462864,463055,191
107,0,blank,0,-350,-105,463055,463240,185
107,0,blank,0,-350,-105,463240,463439,199
107,0,blank,0,-350,-105,463439,463636,197
107,0,blank,0,-350,-105,463636,463738,102
107,0,blank,0,-350,-105,463738,463837,99
107,0,blank,0,-350,-105,463837,464021,184
107,0,blank,0,-350,-105,464021,464219,198
107,0,blank,0,-350,-105,464219,464421,202
107,0,blank,0,-350,-105,464421,464592,171
107,0,blank,0,-350,-105,464592,464730,138
107,0,blank,0,-350,-105,464730,464924,194
107,0,blank,0,-350,-105,464924,465107,183
107,0,blank,0,-350,-105,465107,465288,181
107,0,blank,0,-350,-105,465288,465465,177
107,0,blank,0,-350,-105,465465,465639,174
107,0,blank,0,-350,-105,465639,465800,161
107,0,blank,0,-350,-105,465800,465970,170
107,0,blank,0,-350,-105,465970,466154,184
107,0,blank,0,-350,-105,466154,466349,195
107,0,blank,0,-350,-105,466349,466529,180
107,0,blank,0,-350,-105,466529,466720,191
107,0,blank,0,-350,-105,466720,466870,150
107,0,blank,0,-350,-105,466870,467020,150
107,0,blank,0,-350,-105,467020,467117,97
107,0,blank,0,-350,-105,467117,467281,164
107,0,blank,0,-350,-105,467281,467459,178
107,0,blank,0,-350,-105,467459,467647,188
107,0,blank,0,-350,-105,467647,467827,180
107,0,blank,0,-350,-105,467827,468004,177
107,0,blank,0,-350,-105,468004,468179,175
107,0,blank,0,-350,-105,468179,468236,57
107,0,blank,0,-350,-105,468236,468435,199
107,0,blank,0,-350,-105,468435,468587,152
107,0,blank,0,-350,-105,468587,468758,171
107,0,blank,0,-350,-105,468758,468813,55
107,0,blank,0,-350,-105,468813,468960,147
107,0,blank,0,-350,-105,468960,469032,72
107,0,blank,0,-350,-105,469032,469211,179
107,0,blank,0,-350,-105,469211,469321,110
107,0,blank,0,-350,-105,469321,469512,191
107,0,blank,0,-350,-105,469512,469659,147
107,0,blank,0,-350,-105,469659,469828,169
107,0,blank,0,-350,-105,469828,469893,65
107,0,blank,0,-350,-105,469893,470060,167
107,0,blank,0,-350,-105,470060,470256,196
107,0,blank,0,-350,-105,470256,470437,181
107,0,blank,0,-350,-105,470437,470635,198
107,0,blank,0,-350,-105,470635,470791,156
107,0,blank,0,158.41675,277.878175,470987,471144,157
107,0,blank,0,-350,-105,471144,471326,182
107,0,blank,0,-350,-105,471326,471505,179
107,0,blank,0,-350,-105,471505,471610,105
107,0,blank,0,-350,-105,471610,471749,139
107,0,blank,0,-350,-105,471749,471919,170
107,0,blank,0,-350,-105,471919,472090,171
107,0,blank,0,-350,-105,472090,472263,173
107,0,blank,0,-350,-105,472263,472382,119
107,0,blank,0,-350,-105,472382,472510,128
107,0,blank,0,-350,-105,472510,472704,194
107,0,blank,0,-350,-105,472704,472893,189
107,0,blank,0,279.864133333333,592.486566666667,472954,473119,165
107,0,blank,0,269.5781,626.4069,473119,473260,141
107,0,blank,0,-350,-105,473260,473377,117
107,0,blank,0,-350,-105,473377,473464,87
107,0,blank,0,127.654525,352.1548,473506,473686,180
107,0,blank,0,-192.687825,38.8283,473723,473892,169
107,0,blank,0,39.1234333333333,275.883633333333,473918,474042,124
107,29,array2,176,138.0097,503.4816,474112,474201,89
107,0,blank,0,124.7705,502.3089,474201,474313,112
107,0,blank,0,-350,-105,474425,474618,193
107,0,blank,0,-350,-105,474618,474800,182
107,0,blank,0,-350,-105,474800,474969,169
107,0,blank,0,-350,-105,474969,475152,183
107,0,blank,0,-350,-105,475152,475330,178
107,0,blank,0,-350,-105,475330,475510,180
107,0,blank,0,-350,-105,475510,475690,180
107,0,blank,0,-350,-105,475690,475858,168
107,0,blank,0,-350,-105,475858,476001,143
107,0,blank,0,-350,-105,476001,476197,196
107,0,blank,0,-350,-105,476197,476383,186
107,0,blank,0,-350,-105,476383,476576,193
107,0,blank,0,-350,-105,476576,476751,175
107,0,blank,0,-350,-105,476751,476938,187
107,0,blank,0,-350,-105,476938,477119,181
107,0,blank,0,-350,-105,477119,477295,176
107,0,blank,0,-350,-105,477295,477457,162
107,0,blank,0,-350,-105,477457,477589,132
107,0,blank,0,-350,-105,477589,477721,132
107,0,blank,0,-350,-105,477721,477864,143
107,0,blank,0,-350,-105,477864,478046,182
107,0,blank,0,-350,-105,478046,478223,177
107,0,blank,0,-350,-105,478223,478320,97
107,0,blank,0,-350,-105,478338,478365,27
107,0,blank,0,-350,-105,478365,478588,223
107,0,blank,0,-350,-105,478588,478746,158
107,0,blank,0,139.8794,346.697275,478788,478956,168
107,0,blank,0,250.9651,487.787575,478956,479127,171
107,0,blank,0,246.6485,524.3181,479127,479302,175
107,0,blank,0,277.7086,529.3513,479302,479344,42
107,0,blank,0,322.91205,583.970383333333,479375,479565,190
107,0,blank,0,-350,-105,479597,479789,192
107,0,blank,0,-350,-105,479789,479972,183
107,0,blank,0,262.7898,510.398025,480019,480163,144
107,0,blank,0,204.45005,541.706925,480197,480372,175
107,0,blank,0,287.134275,569.5127,480372,480548,176
107,0,blank,0,301.8837,587.3134,480548,480636,88
107,0,blank,0,296.0158,590.236775,480687,480867,180
107,34,i,212,289.6981,600.4605,480867,480956,89
107,0,blank,0,661.246533333333,-103.913833333333,481000,481133,133
107,0,blank,0,696.7695,-103.9144,481164,481291,127
107,0,blank,0,681.055333333333,-103.8754,481322,481512,190
107,0,blank,0,673.5535,-103.8647,481512,481576,64
107,0,blank,0,686.848333333333,-103.891433333333,481610,481708,98
107,0,blank,0,-350,-105,481743,481890,147
107,0,blank,0,150.00026,442.18404,481917,482092,175
107,0,blank,0,272.22365,584.94905,482092,482157,65
107,0,blank,0,296.511166666667,551.545,482188,482282,94
107,0,blank,0,-350,-105,482313,482484,171
107,0,blank,0,-350,-105,482484,482562,78
107,0,blank,0,199.319225,598.656425,482669,482839,170
107,0,blank,0,200.5058,609.6155,482839,482884,45
107,34,num2,210,265.044825,610.90805,482927,483107,180
107,0,blank,0,111.1475,421.0669,483149,483324,175
107,0,blank,0,-350,-105,483324,483520,196
107,0,blank,0,-350,-105,483520,483700,180
107,0,blank,0,-350,-105,483700,483889,189
107,0,blank,0,-350,-105,483889,484019,130
107,0,blank,0,310.600433333333,596.819566666667,484089,484239,150
107,0,blank,0,-350,-105,484269,484453,184
107,0,blank,0,-350,-105,484453,484634,181
107,0,blank,0,-350,-105,484634,484806,172
107,0,blank,0,-350,-105,484806,484970,164
107,0,blank,0,-350,-105,484970,485149,179
107,0,blank,0,-350,-105,485149,485328,179
107,0,blank,0,-350,-105,485328,485515,187
107,0,blank,0,-350,-105,485515,485697,182
107,0,blank,0,-350,-105,485697,485875,178
107,0,blank,0,-350,-105,485875,486051,176
107,0,blank,0,-350,-105,486051,486227,176
107,0,blank,0,-350,-105,486227,486404,177
107,0,blank,0,-350,-105,486404,486581,177
107,0,blank,0,-350,-105,486581,486610,29
107,0,blank,0,-350,-105,486610,486797,187
107,0,blank,0,-350,-105,486797,486982,185
107,0,blank,0,-350,-105,486982,487026,44
107,0,blank,0,-350,-105,487026,487222,196
107,0,blank,0,-350,-105,487222,487366,144
107,0,blank,0,-350,-105,487366,487558,192
107,0,blank,0,-350,-105,487558,487714,156
107,0,blank,0,-350,-105,487714,487887,173
107,0,blank,0,-350,-105,487887,488064,177
107,0,blank,0,-350,-105,488064,488253,189
107,0,blank,0,-350,-105,488253,488430,177
107,0,blank,0,-350,-105,488430,488601,171
107,0,blank,0,-350,-105,488601,488653,52
107,0,blank,0,112.9494,691.0353,488684,488715,31
107,0,blank,0,108.776725,687.477725,488786,488947,161
107,0,blank,0,147.019975,588.68665,488947,489119,172
107,0,blank,0,179.825125,568.266425,489119,489292,173
107,0,blank,0,203.7211,581.560325,489292,489464,172
107,32,0,193,138.819666666667,564.1995,489464,489574,110
107,0,blank,0,-350,-105,489606,489795,189
107,0,blank,0,-350,-105,489795,489931,136
107,0,blank,0,-350,-105,489931,490051,120
107,32,=,192,123.440275,563.511525,490082,490204,122
107,0,blank,0,130.239975,565.7887,490236,490365,129
107,30,++,186,109.21955,520.6927,490398,490463,65
107,30,++,186,110.3214,518.0964,490493,490524,31
107,29,array2,176,151.37925,496.29475,490555,490619,64
107,0,blank,0,165.82002,514.52838,490651,490809,158
107,0,blank,0,174.9769,598.98,490842,490874,32
107,34,i,212,183.7991,615.0165,490906,490938,32
107,34,i,212,176.5998,616.4717,490969,490999,30
107,0,blank,0,218.787033333333,626.812416666667,491031,491225,194
107,0,blank,0,229.7481,624.4445,491225,491256,31
107,0,blank,0,229.6779,619.41696,491289,491446,157
107,34,num2,210,236.243,610.4718,491478,491540,62
107,0,blank,0,-235.50296,37.93784,491571,491748,177
107,0,blank,0,-350,-105,491748,491774,26
107,21,while,135,86.98505,326.674016666667,491800,491993,193
107,0,blank,0,227.0278,617.7202,491993,492026,33
107,34,!=,209,213.65225,607.8973,492057,492123,66
107,0,blank,0,218.068733333333,625.040033333333,492156,492253,97
107,0,blank,0,217.818433333333,621.7266,492284,492476,192
107,34,!=,209,216.002575,618.10425,492476,492603,127
107,0,blank,0,154.11456,621.47752,492635,492793,158
107,34,num1,205,147.70805,618.3592,492825,492889,64
107,35,return,215,146.8635,635.1661,492921,492955,34
107,0,blank,0,-350,-105,492986,493173,187
107,0,blank,0,-350,-105,493173,493344,171
107,0,blank,0,-350,-105,493344,493504,160
107,34,[,211,276.31525,606.9849,493532,493601,69
107,0,blank,0,280.57375,596.61255,493641,493713,72
107,0,blank,0,283.79355,574.560333333333,493741,493929,188
107,0,blank,0,279.45865,588.9348,493929,493991,62
107,0,blank,0,230.120066666667,530.322633333333,494021,494208,187
107,0,blank,0,232.0427,577.712833333333,494208,494298,90
107,0,blank,0,230.430066666667,554.710466666667,494330,494422,92
107,0,blank,0,228.56485,542.4712,494453,494594,141
107,0,blank,0,330.8176,615.2941,494594,494688,94
107,0,blank,0,315.33485,597.0016,494688,494864,176
107,0,blank,0,318.5452,605.56682,494864,495036,172
107,0,blank,0,320.1363,619.441,495036,495068,32
107,0,blank,0,320.1523,613.878,495099,495164,65
107,0,blank,0,-350,-105,495195,495390,195
107,0,blank,0,-350,-105,495390,495542,152
107,0,blank,0,-350,-105,495542,495609,67
107,0,blank,0,325.563575,570.915675,495641,495757,116
107,0,blank,0,324.336,608.9397,495789,495822,33
107,34,!=,209,222.4554,610.1876,495854,495887,33
107,34,!=,209,221.790975,616.9383,495919,496047,128
107,34,!=,209,222.660033333333,613.087116666667,496080,496269,189
107,0,blank,0,231.24435,601.6792,496269,496337,68
107,0,blank,0,228.5073,604.9593,496370,496401,31
107,0,blank,0,231.3262,586.8678,496432,496464,32
107,0,blank,0,230.89875,601.9695,496495,496619,124
107,0,blank,0,222.58502,598.58974,496650,496808,158
107,0,blank,0,-268.1424,-4.76507142857143,496840,497035,195
107,0,blank,0,-350,-105,497035,497215,180
107,0,blank,0,-350,-105,497215,497392,177
107,0,blank,0,-350,-105,497392,497443,51
107,0,blank,0,103.26736,630.0335,497469,497662,193
107,0,blank,0,123.1512,649.3314,497662,497724,62
107,34,if,203,92.8147,611.84005,497755,497817,62
107,0,blank,0,80.5689,601.1481,497847,497878,31
107,34,if,203,98.9173,605.2742,497908,497939,31
107,0,blank,0,100.57515,589.9197,497971,498153,182
107,0,blank,0,160.0682,621.4763,498183,498213,30
107,34,num1,205,162.32745,615.757675,498244,498366,122
107,34,num1,205,158.387,601.95555,498397,498458,61
107,35,return,215,170.26785,631.0749,498487,498549,62
107,0,blank,0,164.273966666667,608.174633333333,498580,498673,93
107,35,return,215,170.11056,626.92396,498704,498859,155
107,0,blank,0,211.426783333333,622.45335,498890,499077,187
107,0,blank,0,236.03395,620.1286,499077,499140,63
107,34,num2,210,237.239766666667,618.098266666667,499171,499265,94
107,0,blank,0,-350,-105,499296,499462,166
107,0,blank,0,-350,-105,499462,499645,183
107,0,blank,0,-350,-105,499645,499759,114
107,0,blank,0,-350,-105,499759,499946,187
107,0,blank,0,-350,-105,499946,500028,82
107,0,blank,0,134.88,466.1249,500063,500112,49
107,29,array2,176,176.429783333333,506.171966666667,500143,500339,196
107,29,array2,176,159.2644,498.2485,500339,500535,196
107,29,array2,176,151.638225,508.467775,500535,500665,130
107,29,array2,176,147.8677,505.96645,500698,500762,64
107,0,blank,0,106.7035,513.156566666667,500795,500889,94
107,29,num2,174,105.9627,493.1201,500920,500953,33
107,0,blank,0,115.7832,514.21915,500984,501049,65
107,0,blank,0,-350,-105,501081,501274,193
107,0,blank,0,-350,-105,501274,501438,164
107,0,blank,0,-350,-105,501438,501549,111
107,29,array2,176,174.781466666667,493.089533333333,501581,501662,81
107,29,array2,176,185.32735,493.1258,501693,501817,124
107,29,array2,176,177.785975,502.912075,501848,501974,126
107,0,blank,0,167.58285,484.9307,502005,502067,62
107,0,blank,0,230.32235,488.3029,502099,502162,63
107,0,blank,0,228.644333333333,499.529366666667,502195,502289,94
107,0,blank,0,214.3329,475.6058,502319,502350,31
107,27,array2,166,169.8844,462.925175,502380,502506,126
107,0,blank,0,178.04715,469.4527,502538,502599,61
107,0,blank,0,176.383125,479.1235,502631,502756,125
107,0,blank,0,-350,-105,502787,502979,192
107,0,blank,0,-350,-105,502979,503153,174
107,0,blank,0,-350,-105,503153,503301,148
107,0,blank,0,330.72812,479.6157,503340,503483,143
107,0,blank,0,325.7763,496.4171,503515,503547,32
107,0,blank,0,331.04722,484.98832,503579,503738,159
107,0,blank,0,327.467,479.05435,503769,503955,186
107,0,blank,0,325.98502,484.90884,503955,504111,156
107,0,blank,0,318.473033333333,481.066766666667,504141,504330,189
107,0,blank,0,313.80275,470.02765,504361,504424,63
107,0,blank,0,245.352766666667,472.8179,504455,504547,92
107,0,blank,0,238.421966666667,480.444716666667,504577,504762,185
107,0,blank,0,245.74975,485.99045,504762,504824,62
107,0,blank,0,242.8014,483.5905,504855,504887,32
107,0,blank,0,242.303166666667,480.622266666667,504918,505010,92
107,34,num2,210,245.10275,615.558316666667,505041,505232,191
107,0,blank,0,259.2323,625.313,505232,505263,31
107,0,blank,0,256.2574,625.31068,505294,505452,158
107,0,blank,0,-350,-105,505484,505669,185
107,0,blank,0,-350,-105,505669,505863,194
107,0,blank,0,-350,-105,505863,505914,51
107,0,blank,0,260.1398,589.70785,506059,506123,64
107,32,++,200,265.777875,562.689475,506156,506283,127
107,0,blank,0,255.405883333333,595.055183333333,506315,506503,188
107,0,blank,0,248.5531,592.489,506503,506597,94
107,0,blank,0,256.687183333333,580.56025,506628,506819,191
107,0,blank,0,255.962666666667,583.574666666667,506819,506914,95
107,0,blank,0,-46.0034666666667,218.6512,506946,507130,184
107,0,blank,0,-350,-105,507130,507284,154
107,0,blank,0,-350,-105,507284,507464,180
107,0,blank,0,-350,-105,507464,507581,117
107,35,return,215,136.068866666667,626.524733333333,507606,507792,186
107,34,num1,205,149.8629,603.6461,507792,507825,33
107,35,return,215,176.439633333333,628.066466666667,507856,507951,95
107,0,blank,0,176.9948,644.43375,507984,508046,62
107,34,!=,209,219.0694,615.4823,508078,508110,32
107,0,blank,0,222.91346,637.14604,508142,508322,180
107,0,blank,0,224.3527,636.73985,508322,508386,64
107,0,blank,0,231.06445,622.096125,508419,508548,129
107,34,num2,210,245.245,616.3265,508580,508612,32
107,0,blank,0,243.7794,635.2501,508643,508675,32
107,0,blank,0,-350,-105,508738,508926,188
107,0,blank,0,-350,-105,508926,509122,196
107,32,i,199,251.31434,575.22064,509154,509309,155
107,0,blank,0,163.969475,651.775775,509341,509468,127
107,0,blank,0,136.4064,647.6054,509499,509530,31
107,0,blank,0,134.6227,669.593866666667,509561,509654,93
107,0,blank,0,66.2823333333333,705.41055,509685,509870,185
107,0,blank,0,61.7643,695.3057,509870,509964,94
107,0,blank,0,69.9348,707.19865,509996,510058,62
107,35,return,215,151.01374,633.31882,510091,510270,179
107,0,blank,0,73.2148,694.2039,510302,510334,32
107,0,blank,0,86.583775,702.084025,510366,510523,157
107,0,blank,0,80.80035,700.0803,510564,510628,64
107,32,for,189,62.59845,568.5446,510660,510722,62
107,32,for,189,66.9363666666667,571.804666666667,510754,510848,94
107,0,blank,0,108.180733333333,627.345883333333,510880,511069,189
107,0,blank,0,154.35546,655.69112,511100,511257,157
107,0,blank,0,-350,-105,511288,511487,199
107,0,blank,0,33.96225,500.5103,511533,511726,193
107,34,(,204,120.173183333333,614.152516666667,511726,511915,189
107,0,blank,0,107.8868,616.4168,511915,511978,63
107,0,blank,0,88.5416,594.42295,512009,512072,63
107,0,blank,0,106.5623,604.8461,512104,512167,63
107,0,blank,0,143.6752,649.8327,512198,512385,187
107,0,blank,0,-350,-105,512449,512637,188
107,0,blank,0,-350,-105,512637,512830,193
107,0,blank,0,-350,-105,512830,512926,96
107,0,blank,0,275.226466666667,524.912566666667,512961,513050,89
107,0,blank,0,255.3659,593.55015,513078,513267,189
107,0,blank,0,237.2121,591.3488,513267,513298,31
107,34,num2,210,247.16205,601.0267,513329,513390,61
107,0,blank,0,345.211516666667,597.94945,513420,513606,186
107,0,blank,0,335.838616666667,560.818683333333,513606,513791,185
107,0,blank,0,-350,-105,513791,513987,196
107,0,blank,0,-350,-105,513987,514163,176
107,0,blank,0,-350,-105,514163,514325,162
107,0,blank,0,-350,-105,514325,514507,182
107,0,blank,0,-350,-105,514507,514689,182
107,0,blank,0,-350,-105,514689,514872,183
107,0,blank,0,-350,-105,514872,515070,198
107,0,blank,0,-350,-105,515070,515259,189
107,0,blank,0,-350,-105,515259,515426,167
107,0,blank,0,-350,-105,515426,515615,189
107,0,blank,0,-350,-105,515615,515791,176
107,0,blank,0,-350,-105,515791,515972,181
107,0,blank,0,-350,-105,515972,516149,177
107,0,blank,0,-350,-105,516149,516326,177
107,0,blank,0,-350,-105,516326,516505,179
107,0,blank,0,-350,-105,516505,516684,179
107,0,blank,0,-350,-105,516684,516864,180
107,0,blank,0,-350,-105,516864,517052,188
107,0,blank,0,-350,-105,517052,517233,181
107,0,blank,0,-350,-105,517233,517354,121
107,0,blank,0,-350,-105,517354,517461,107
107,0,blank,0,-350,-105,517461,517574,113
107,0,blank,0,-350,-105,517574,517703,129
107,0,blank,0,-350,-105,517703,517855,152
107,0,blank,0,-350,-105,517855,518050,195
107,0,blank,0,-350,-105,518050,518231,181
107,0,blank,0,-350,-105,518231,518405,174
107,0,blank,0,-350,-105,518405,518582,177
107,0,blank,0,-350,-105,518582,518758,176
107,0,blank,0,-350,-105,518758,518936,178
107,0,blank,0,-350,-105,518936,519121,185
107,0,blank,0,-350,-105,519121,519300,179
107,0,blank,0,-350,-105,519300,519481,181
107,0,blank,0,-350,-105,519481,519664,183
107,0,blank,0,-350,-105,519664,519844,180
107,0,blank,0,-350,-105,519844,520012,168
107,0,blank,0,-350,-105,520012,520188,176
107,0,blank,0,-350,-105,520188,520328,140
107,0,blank,0,-350,-105,520328,520494,166
107,0,blank,0,-350,-105,520494,520689,195
107,0,blank,0,-350,-105,520689,520870,181
107,0,blank,0,-350,-105,520870,521049,179
107,0,blank,0,-350,-105,521049,521227,178
107,0,blank,0,-350,-105,521227,521403,176
107,0,blank,0,-350,-105,521403,521577,174
107,0,blank,0,-350,-105,521577,521749,172
107,0,blank,0,-350,-105,521749,521891,142
107,0,blank,0,-350,-105,521891,522033,142
107,0,blank,0,-350,-105,522033,522218,185
107,0,blank,0,-350,-105,522218,522403,185
107,0,blank,0,-350,-105,522403,522591,188
107,0,blank,0,-350,-105,522591,522776,185
107,0,blank,0,-350,-105,522776,522959,183
107,0,blank,0,-350,-105,522959,523143,184
107,0,blank,0,-350,-105,523143,523324,181
107,0,blank,0,-350,-105,523324,523505,181
107,0,blank,0,-350,-105,523505,523685,180
107,0,blank,0,-350,-105,523685,523865,180
107,0,blank,0,-350,-105,523865,524040,175
107,0,blank,0,-350,-105,524040,524219,179
107,0,blank,0,-350,-105,524219,524396,177
107,0,blank,0,-350,-105,524396,524575,179
107,0,blank,0,-350,-105,524575,524753,178
107,0,blank,0,-350,-105,524753,524777,24
107,0,blank,0,-14.2288,387.112,524795,524924,129
107,0,blank,0,136.769175,655.749025,524969,525150,181
107,20,[,123,285.6562,305.2633,525150,525314,164
107,9,"Enteranotherstring\n",52,175.9852,49.578125,525314,525499,185
107,13,"%sand%sareanagrams.\n",77,350.0295,141.82065,525499,525674,175
107,0,blank,0,-350,-105,525674,525813,139
107,0,blank,0,403.4913,40.0278166666667,525848,526039,191
107,0,blank,0,551.7522,71.9479,526039,526161,122
107,0,blank,0,936.187333333333,193.48275,526192,526375,183
107,0,blank,0,932.4015,196.6284,526375,526437,62
107,0,blank,0,944.0855,203.942025,526468,526590,122
107,0,blank,0,958.224833333333,151.04505,526620,526799,179
107,0,blank,0,958.613666666667,139.084766666667,526799,526890,91
107,0,blank,0,955.6052,145.80226,526920,527070,150
107,0,blank,0,954.737,120.9799,527101,527162,61
107,0,blank,0,-4.80866666666664,-42.7382333333333,527192,527284,92
107,0,blank,0,109.499433333333,-17.7512666666667,527314,527500,186
107,7,"Enterthestring\n",42,202.980433333333,18.8767166666667,527530,527715,185
107,8,array1,47,152.191625,39.514625,527746,527867,121
107,7,"Enterthestring\n",42,125.166766666667,21.4321,527898,528080,182
107,7,(,41,106.816,8.129825,528080,528204,124
107,0,blank,0,73.0155,26.99565,528234,528294,60
107,7,printf,40,68.3183,17.4012,528324,528414,90
107,7,printf,40,59.0054,8.4415,528445,528596,151
108,0,blank,0,-350,-105,529181,529330,149
108,0,blank,0,159.3681,-55.2784666666667,529387,529481,94
108,0,blank,0,439.51335,-28.50235,529512,529573,61
108,0,blank,0,438.9104,-11.4348,529604,529666,62
108,1,Program,4,54.2408,10.3103,529697,529789,92
108,0,blank,0,61.3797,2.1114,529820,529851,31
108,1,C,3,29.47075,13.5801166666667,529881,530067,186
108,2,include,15,18.86436,33.40014,530097,530250,153
108,2,include,15,18.9957,32.8154,530281,530311,30
108,0,blank,0,119.76055,76.38555,530341,530403,62
108,0,blank,0,119.590366666667,73.8582666666667,530434,530527,93
108,0,blank,0,116.97675,81.6802,530558,530619,61
108,0,blank,0,-40.40095,17.0605833333333,530651,530837,186
108,0,blank,0,-350,-105,530837,530914,77
108,0,blank,0,-350,-105,530964,531162,198
108,0,blank,0,-350,-105,531162,531361,199
108,0,blank,0,165.35505,42.59215,531391,531442,51
108,2,stdio,17,148.468633333333,30.18945,531473,531654,181
108,0,blank,0,133.478333333333,24.6954,531685,531775,90
108,2,.,18,161.210666666667,26.3309,531806,531986,180
108,1,Check,6,193.85216,20.86062,531986,532135,149
108,0,blank,0,195.401266666667,-10.5243166666667,532165,532345,180
108,1,Check,6,200.5297,4.28075,532375,532493,118
108,0,blank,0,192.0954,27.658,532523,532553,30
108,0,blank,0,250.05935,52.6361,532583,532764,181
108,0,blank,0,240.955383333333,68.5014333333333,532764,532949,185
108,0,blank,0,-264.975328571429,-81.6712142857143,532949,533142,193
108,0,blank,0,-350,-105,533142,533168,26
108,0,blank,0,184.21144,-1.05464,533194,533345,151
108,0,blank,0,337.74614,50.41642,533375,533535,160
108,0,blank,0,342.59175,44.83755,533566,533628,62
108,0,blank,0,184.812533333333,85.0237333333333,533657,533840,183
108,0,blank,0,154.0478,81.4056,533840,533871,31
108,0,blank,0,163.079233333333,88.2483,533902,533995,93
108,0,blank,0,179.6954,133.38965,534025,534087,62
108,0,blank,0,173.3251,129.8849,534117,534178,61
108,7,"Enterthestring\n",42,183.14035,135.2074,534208,534269,61
108,0,blank,0,194.124,122.187025,534300,534420,120
108,0,blank,0,201.7201,130.2718,534450,534632,182
108,5,comma,31,211.411666666667,95.0988666666667,534661,534752,91
108,5,[,33,291.7744,92.8233666666667,534782,534872,90
108,0,blank,0,208.70025,83.3074833333333,534902,535082,180
108,0,blank,0,177.1725,79.1855,535082,535112,30
108,0,blank,0,171.7302,77.06725,535142,535202,60
108,7,"Enterthestring\n",42,238.348475,153.28,535232,535352,120
108,7,"Enterthestring\n",42,228.459883333333,147.72155,535381,535565,184
108,0,blank,0,-67.21955,47.934,535565,535731,166
108,0,blank,0,-350,-105,535731,535895,164
108,0,blank,0,-350,-105,535895,535996,101
108,0,blank,0,176.875933333333,170.73755,536031,536200,169
108,8,),48,160.238,176.0187,536200,536231,31
108,0,blank,0,245.261166666667,170.294866666667,536261,536439,178
108,9,"Enteranotherstring\n",52,240.668,183.2887,536439,536469,30
108,0,blank,0,218.389133333333,167.03625,536499,536678,179
108,0,blank,0,216.047233333333,176.477066666667,536678,536766,88
108,0,blank,0,331.6307,168.19318,536795,536945,150
108,0,blank,0,354.11665,162.388233333333,536975,537154,179
108,0,blank,0,415.1302,159.72505,537154,537213,59
108,0,blank,0,356.423516666667,147.586533333333,537243,537423,180
108,7,"Enterthestring\n",42,230.2586,150.10055,537423,537483,60
108,9,"Enteranotherstring\n",52,208.289975,182.5218,537513,537633,120
108,0,blank,0,184.2837,200.1163,537663,537782,119
108,7,printf,40,87.8071333333333,145.92145,537811,537990,179
108,0,blank,0,-350,-105,537990,538187,197
108,0,blank,0,-350,-105,538187,538333,146
108,9,"Enteranotherstring\n",52,199.9781,186.207,538369,538385,16
108,11,array2,66,364.208025,228.894525,538419,538540,121
108,11,array2,66,363.4021,230.69325,538570,538630,60
108,0,blank,0,314.92675,205.9634,538660,538841,181
108,0,blank,0,409.678233333333,208.315583333333,538841,539020,179
108,0,blank,0,440.71785,236.37055,539020,539199,179
108,13,"%sand%sareanagrams.\n",77,256.011483333333,267.89345,539199,539380,181
108,13,"%sand%sareanagrams.\n",77,307.91325,271.7988,539411,539592,181
108,15,printf,85,137.92,319.64135,539592,539652,60
108,0,blank,0,146.148666666667,309.519033333333,539684,539777,93
108,15,"%sand%sarenotanagrams.\n",87,156.744,322.9369,539808,539841,33
108,15,printf,85,138.1002,328.892,539871,539933,62
108,0,blank,0,984.045166666667,159.161516666667,539963,540152,189
108,0,blank,0,972.685,161.3742,540152,540182,30
108,0,blank,0,984.0105,157.19705,540211,540271,60
108,0,blank,0,961.472666666667,155.607766666667,540301,540389,88
108,0,blank,0,970.4315,155.96485,540418,540477,59
108,0,blank,0,-350,-105,540508,540691,183
108,8,array1,47,112.519316666667,168.344766666667,540727,540911,184
108,0,blank,0,210.658633333333,256.845733333333,540942,541127,185
108,0,blank,0,861.270333333333,150.281883333333,541127,541313,186
108,0,blank,0,938.965,169.8829,541346,541376,30
108,0,blank,0,23.2441428571429,-45.544,541406,541604,198
108,0,blank,0,-350,-105,541604,541786,182
108,0,blank,0,-350,-105,541786,541837,51
108,0,blank,0,359.44442,245.40322,541871,542022,151
108,0,blank,0,408.0052,226.0434,542052,542083,31
108,0,blank,0,431.0796,247.7402,542113,542143,30
108,0,blank,0,443.59945,229.593716666667,542173,542354,181
108,0,blank,0,450.5982,229.5927,542354,542384,30
108,0,blank,0,326.865566666667,306.693216666667,542413,542592,179
108,0,blank,0,168.1782,338.1189,542623,542683,60
108,18,find_anagram,99,107.250166666667,377.9043,542713,542802,89
108,0,blank,0,113.2867,363.1636,542831,542951,120
108,15,printf,85,108.080133333333,315.158633333333,542982,543078,96
108,15,printf,85,83.749925,317.54685,543109,543229,120
108,14,else,84,79.7452333333333,305.763533333333,543260,543439,179
108,13,printf,75,86.3332,277.16505,543469,543530,61
108,0,blank,0,-350,-105,543560,543746,186
108,0,blank,0,-350,-105,543746,543809,63
109,18,char,106,338.046,263.2121,544400,544430,30
109,0,blank,0,328.33915,246.5848,544460,544520,60
109,18,char,106,336.2112,262.6184,544642,544671,29
109,0,blank,0,252.77404,270.5934,544706,544855,149
109,21,while,135,75.1614,324.1416,544943,544973,30
109,21,while,135,89.4537,323.8865,545152,545182,30
109,0,blank,0,-350,-105,545241,545396,155
109,0,blank,0,160.3332,339.9843,546310,546340,30
109,0,blank,0,170.0685,388.6192,546371,546401,30
109,23,array1,147,160.3781,362.3392,546432,546462,30
109,0,blank,0,127.7516,385.0409,546738,546769,31
109,24,++,157,105.5445,394.4687,546919,546949,30
109,23,num1,145,100.2339,371.4652,547165,547195,30
109,0,blank,0,95.437,288.0264,547348,547379,31
109,0,blank,0,115.3904,281.73885,547626,547688,62
109,0,blank,0,226.3702,287.5934,547719,547750,31
109,20,},129,215.6747,300.3879,547812,547842,30
109,0,blank,0,-350,-105,547934,548119,185
109,0,blank,0,-350,-105,548119,548288,169
109,0,blank,0,-350,-105,548288,548388,100
109,23,[,148,195.5523,364.7499,548420,548434,14
109,0,blank,0,139.9378,383.124,548655,548686,31
109,0,blank,0,168.5231,385.0464,549232,549263,31
109,0,blank,0,186.6002,379.2874,549417,549448,31
109,0,blank,0,173.2203,353.0077,549539,549569,30
109,0,blank,0,218.0261,349.2641,549778,549807,29
109,0,blank,0,238.36205,341.9677,550082,550142,60
109,0,blank,0,98.79055,337.35665,550203,550264,61
109,0,blank,0,-350,-105,550414,550600,186
109,0,blank,0,-350,-105,550600,550788,188
109,0,blank,0,211.5963,351.4776,550932,550962,30
109,21,!=,141,218.3459,332.0356,551143,551172,29
109,21,!=,141,233.169,313.0427,551321,551350,29
109,24,i,156,91.6503,384.31905,551409,551469,60
109,0,blank,0,91.2874,340.3047,551766,551795,29
109,0,blank,0,-350,-105,551942,552123,181
109,0,blank,0,-350,-105,552123,552202,79
109,0,blank,0,253.524,367.8498,552398,552428,30
109,0,blank,0,262.1725,350.701266666667,552487,552578,91
109,23,a,152,261.3826,363.0134,552698,552728,30
109,24,++,157,100.2167,388.8219,552818,552848,30
109,23,num1,145,95.0164,361.5233,552909,552939,30
109,0,blank,0,89.8836,380.294033333333,553059,553151,92
109,0,blank,0,72.7013,385.8911,553269,553300,31
109,0,blank,0,77.5769,395.2701,553421,553483,62
109,0,blank,0,81.14955,376.1109,553513,553572,59
109,0,blank,0,150.8231,468.1698,553663,553692,29
109,27,array2,166,150.4561,459.5961,553753,553783,30
109,0,blank,0,-350,-105,553933,554114,181
109,0,blank,0,-350,-105,554114,554292,178
109,0,blank,0,233.6422,502.1782,554498,554527,29
109,0,blank,0,255.5864,485.4733,554706,554735,29
109,29,[,177,127.4151,504.1544,554973,555004,31
109,0,blank,0,110.1319,512.0847,555033,555063,30
109,0,blank,0,142.4041,540.1027,555123,555153,30
109,0,blank,0,163.8927,576.1505,555606,555636,30
109,0,blank,0,158.37925,645.6025,555847,555908,61
109,0,blank,0,230.6254,625.3633,556146,556247,101
109,0,blank,0,-350,-105,556514,556697,183
109,0,blank,0,-350,-105,556697,556788,91
109,0,blank,0,150.6479,641.8259,557371,557402,31
109,35,return,215,174.4644,637.0545,557433,557463,30
109,35,return,215,160.0226,632.0383,557556,557586,30
109,0,blank,0,158.3128,620.6028,557957,557988,31
109,0,blank,0,201.6996,603.8878,558169,558199,30
109,0,blank,0,176.8398,592.7951,558289,558349,60
109,0,blank,0,-350,-105,558473,558653,180
109,0,blank,0,-350,-105,558653,558698,45
109,0,blank,0,167.7393,655.5507,559054,559085,31
109,9,"Enteranotherstring\n",52,175.142,56.7211,559272,559333,61
109,0,blank,0,289.4946,-34.6639,559425,559455,30
109,0,blank,0,-350,-105,559548,559729,181
109,0,blank,0,-350,-105,559729,559866,137
109,0,blank,0,-350,-105,559866,560063,197
109,0,blank,0,-350,-105,560063,560249,186
109,0,blank,0,-350,-105,560249,560435,186
109,0,blank,0,-350,-105,560435,560637,202
109,0,blank,0,-350,-105,560637,560841,204
109,0,blank,0,-350,-105,560841,560978,137
109,0,blank,0,156.4652,730.1854,561068,561098,30
109,0,blank,0,113.4162,747.7215,561251,561281,30
109,0,blank,0,93.1899,723.2015,561312,561342,30
109,0,blank,0,281.94675,430.9389,561590,561652,62
109,0,blank,0,-350,-105,561682,561835,153
109,11,array1,64,275.03425,98.4587,562005,562061,56
109,0,blank,0,287.6008,118.5095,562183,562213,30
109,11,array1,64,288.6484,108.7906,562308,562341,33
109,0,blank,0,272.2583,123.195,562405,562437,32
