Frameno_fix,lineno_fix,Tokenname_fix,tokens_id,gaze_X_fix,gaze_Y_fix,timestamp_fix_start,timestamp_fix_end,time_duration
100,0,blank,0,30.18004,-68.04734,4077,4243,166
100,0,blank,0,34.31772,-66.7348,4243,4411,168
100,0,blank,0,44.32592,-64.73084,4411,4579,168
100,0,blank,0,565.31672,12.53458,4613,4784,171
100,0,blank,0,518.9756,-14.18706,4784,4954,170
100,0,blank,0,534.66808,-21.13954,4954,5125,171
100,0,blank,0,529.20064,-15.91582,5125,5296,171
100,0,blank,0,477.99184,-3.09462,5296,5466,170
100,0,blank,0,492.81444,-10.68866,5466,5636,170
100,0,blank,0,500.6271,-5.80889999999999,5636,5670,34
100,0,blank,0,379.6358,-9.39076,5704,5876,172
100,0,blank,0,372.9774,-2.886775,5876,6013,137
100,0,blank,0,479.73512,-9.8339,6047,6217,170
100,0,blank,0,478.35822,-2.42692,6217,6387,170
100,0,blank,0,373.64096,-3.6279,6387,6556,169
100,0,blank,0,362.869575,-0.488375000000001,6556,6694,138
100,5,char,26,77.22568,99.4887,6728,6903,175
100,5,char,26,61.72138,93.00756,6903,7079,176
100,5,char,26,64.86592,93.8665,7079,7255,176
100,6,flag,38,93.77384,129.436,7255,7425,170
100,6,flag,38,98.14282,130.86008,7425,7600,175
100,0,blank,0,65.39706,77.0869,7600,7769,169
100,2,include,15,38.28255,40.9919333333333,7769,7968,199
100,1,Program,4,79.60935,13.0822333333333,7968,8162,194
100,1,Check,6,166.456116666667,12.9961,8162,8356,194
100,1,Check,6,203.106833333333,11.8872166666667,8356,8550,194
100,1,whether,7,275.485666666667,4.51376666666667,8550,8746,196
100,0,blank,0,316.24805,27.85015,8746,8811,65
100,0,blank,0,-350,-105,8844,9037,193
100,1,whether,7,282.615616666667,8.48075,9063,9248,185
100,1,Strings,9,364.99082,11.73548,9248,9416,168
100,1,are,10,419.48302,7.53922,9416,9587,171
100,1,are,10,424.33468,12.77632,9587,9756,169
100,1,are,10,439.84942,11.1234,9756,9924,168
100,0,blank,0,445.3267,14.14135,9924,10061,137
100,1,are,10,424.408,5.3502,10061,10168,107
100,1,are,10,429.7602,9.1948,10168,10290,122
100,0,blank,0,419.6738,0.650099999999995,10290,11051,761
100,0,blank,0,405.12048,4.81096,11051,11222,171
100,0,blank,0,405.05628,6.83734,11222,11396,174
100,0,blank,0,440.62202,2.9044,11396,11569,173
100,0,blank,0,410.88974,3.72286,11569,11741,172
100,1,Strings,9,359.56388,5.19814,11741,11914,173
100,1,Strings,9,364.74678,8.06054,11914,12086,172
100,1,Strings,9,348.38346,13.14752,12086,12259,173
100,1,whether,7,276.38528,19.6904,12259,12436,177
100,1,whether,7,267.47168,20.45566,12436,12612,176
100,1,whether,7,251.558333333333,23.445,12612,12798,186
100,3,main,22,63.482,61.2879,12832,13010,178
100,0,blank,0,71.74658,71.11016,13010,13182,172
100,6,flag,38,102.13636,117.02158,13182,13355,173
100,6,flag,38,104.19422,123.86322,13355,13528,173
100,7,"Enterthestring\n",42,164.1442,150.1738,13528,13699,171
100,7,"Enterthestring\n",42,170.55,148.4586,13699,13733,34
100,0,blank,0,-350,-105,13801,13885,84
100,6,flag,38,116.249116666667,127.797266666667,14000,14194,194
100,6,;,39,126.758075,115.99275,14194,14332,138
100,0,blank,0,160.0887,113.8064,14332,14697,365
100,5,[,33,157.70304,110.58592,14697,14865,168
100,0,blank,0,161.7227,113.27426,14865,15040,175
100,6,flag,38,94.37052,131.25428,15040,15214,174
100,7,printf,40,91.1988,138.36756,15214,15391,177
100,7,"Enterthestring\n",42,115.087433333333,150.1433,15391,15503,112
100,8,array1,47,123.3708,167.6728,15503,15757,254
100,8,array1,47,128.00874,171.13494,15757,15938,181
100,8,array1,47,113.9442,172.42536,15938,16117,179
100,8,gets,45,66.52828,167.83612,16117,16298,181
100,8,gets,45,67.67848,161.03578,16298,16487,189
100,7,printf,40,76.77584,147.349,16487,16665,178
100,7,printf,40,77.4682,145.696,16665,16841,176
100,7,printf,40,68.99274,151.537,16841,17021,180
100,7,printf,40,52.59846,148.00544,17021,17199,178
100,0,blank,0,73.29034,113.92722,17199,17377,178
100,6,flag,38,118.39694,114.43558,17377,17557,180
100,5,array1,27,132.369866666667,105.091333333333,17557,17668,111
100,0,blank,0,-350,-105,17703,17818,115
100,0,blank,0,106.4688,113.1186,17865,17924,59
100,5,array1,27,104.66456,109.91018,17997,18163,166
100,0,blank,0,74.06984,112.82366,18163,18346,183
100,5,char,26,63.40262,111.35448,18346,18531,185
100,0,blank,0,105.0694,113.36692,18531,18706,175
100,0,blank,0,104.35308,112.2639,18706,18881,175
100,0,blank,0,145.9942,118.3355,18881,19053,172
100,0,blank,0,211.69188,115.14886,19053,19231,178
100,5,100,34,175.16934,105.73578,19231,19409,178
100,5,array1,27,151.92472,100.48062,19409,19578,169
100,5,100,34,164.9724,108.76718,19578,19751,173
100,0,blank,0,168.87296,115.02708,19751,19926,175
100,6,;,39,129.93602,123.56974,19926,20095,169
100,6,flag,38,113.29676,122.43374,20095,20264,169
100,0,blank,0,111.07062,113.99606,20264,20433,169
100,6,;,39,129.0313,116.85954,20433,20602,169
100,0,blank,0,191.04204,114.1604,20602,20776,174
100,5,100,34,174.16062,108.79944,20776,20947,171
100,5,array1,27,148.454216666667,98.8104166666667,20947,21145,198
100,5,array1,27,119.416766666667,102.9584,21145,21344,199
100,5,array1,27,133.22692,98.41254,21344,21511,167
100,0,blank,0,218.0339,95.03316,21511,21682,171
100,5,100,34,170.20586,95.1084,21682,21854,172
100,5,array1,27,140.97352,96.87154,21854,22021,167
100,5,array1,27,145.56284,98.03044,22021,22190,169
100,5,[,33,161.77748,99.4506,22190,22356,166
100,5,array2,32,225.71575,96.5369333333334,22356,22554,198
100,5,array2,32,245.256433333333,97.73345,22554,22753,199
100,5,array2,32,253.339766666667,97.0881333333333,22753,22952,199
100,5,100,34,168.44964,99.03176,22952,23120,168
100,5,array1,27,139.96935,103.0229,23120,23319,199
100,5,array1,27,124.512233333333,103.029683333333,23319,23515,196
100,5,array1,27,127.243966666667,104.632533333333,23515,23712,197
100,6,flag,38,91.7601,125.39508,23712,23879,167
100,6,flag,38,85.1347,127.11224,23879,24048,169
100,7,printf,40,72.73668,136.10466,24048,24216,168
100,7,printf,40,58.12392,140.9511,24216,24386,170
100,0,blank,0,78.96574,130.09302,24386,24556,170
100,6,flag,38,83.32356,127.8294,24556,24725,169
100,0,blank,0,82.46404,131.36666,24725,24894,169
100,6,int,37,61.769,127.382883333333,24894,25093,199
100,5,char,26,67.5478833333333,106.441166666667,25093,25288,195
100,0,blank,0,92.63218,105.08434,25288,25455,167
100,5,array1,27,111.99254,96.05656,25455,25621,166
100,0,blank,0,91.54428,107.62516,25621,25788,167
100,5,char,26,79.39164,108.32212,25788,25958,170
100,0,blank,0,77.93568,115.74756,25958,26129,171
100,0,blank,0,76.05962,117.86018,26129,26298,169
100,6,flag,38,108.34694,133.12084,26298,26468,170
100,7,"Enterthestring\n",42,157.32594,155.8409,26468,26637,169
100,7,"Enterthestring\n",42,224.29834,142.51928,26637,26809,172
100,7,"Enterthestring\n",42,212.5142,147.93112,26809,26981,172
100,7,"Enterthestring\n",42,145.5617,152.84724,26981,27151,170
100,7,"Enterthestring\n",42,170.48958,151.9262,27151,27318,167
100,7,"Enterthestring\n",42,173.93966,147.64716,27318,27488,170
100,7,printf,40,103.89844,135.10924,27488,27656,168
100,6,flag,38,112.52668,116.12198,27656,27822,166
100,0,blank,0,82.30225,124.024983333333,27822,28020,198
100,6,flag,38,83.05104,117.64966,28020,28187,167
100,6,int,37,73.87444,116.74544,28187,28360,173
100,6,int,37,54.4522833333333,115.8671,28360,28559,199
100,0,blank,0,81.61074,114.16784,28559,28727,168
100,5,char,26,80.7002166666667,111.550583333333,28727,28926,199
100,5,array1,27,113.43302,108.7568,28926,29095,169
100,5,array1,27,138.02244,99.62266,29095,29262,167
100,5,[,33,159.89225,96.7553833333333,29262,29460,198
100,5,array2,32,228.76826,95.76634,29460,29629,169
100,5,comma,31,206.19206,94.03168,29629,29797,168
100,5,array1,27,152.41424,94.63482,29797,29964,167
100,5,array1,27,153.75712,92.15682,29964,30136,172
100,5,array1,27,126.27686,100.76822,30136,30307,171
100,5,array1,27,127.5629,101.93905,30307,30412,105
100,5,array1,27,141.1553,96.3771,30412,30531,119
100,5,array1,27,145.8383,103.7263,30531,30653,122
100,5,array1,27,147.518266666667,100.745733333333,30653,30826,173
100,5,array1,27,145.09382,99.8166,30826,31011,185
100,5,array1,27,131.82022,103.78548,31011,31181,170
100,5,array1,27,113.213183333333,101.096966666667,31181,31378,197
100,5,array1,27,111.399233333333,95.2748,31378,31571,193
100,5,array1,27,121.108533333333,102.59195,31571,31767,196
100,5,100,34,170.080233333333,102.657866666667,31767,31965,198
100,5,array2,32,224.62518,98.6032,31965,32131,166
100,5,array2,32,235.011433333333,98.1073166666667,32131,32329,198
100,5,array2,32,231.5347,102.9313,32329,32361,32
100,5,char,26,49.01714,95.75856,32394,32562,168
100,5,char,26,55.6694,94.08138,32562,32733,171
100,6,int,37,58.993,115.466516666667,32733,32931,198
100,6,int,37,67.21068,131.58634,32931,33098,167
100,6,flag,38,92.47932,133.92386,33098,33262,164
100,0,blank,0,113.1838,144.72888,33262,33434,172
100,0,blank,0,69.86432,134.7735,33434,33600,166
100,7,"Enterthestring\n",42,116.73984,145.944,33600,33770,170
100,7,"Enterthestring\n",42,152.22474,154.47384,33770,33940,170
100,7,"Enterthestring\n",42,200.8287,144.10474,33940,34108,168
100,7,"Enterthestring\n",42,226.66725,137.990166666667,34108,34306,198
100,7,"Enterthestring\n",42,250.16094,142.2672,34306,34473,167
100,7,"Enterthestring\n",42,195.635033333333,151.5107,34473,34670,197
100,8,array1,47,119.973266666667,163.925483333333,34670,34868,198
100,8,gets,45,75.42688,167.03326,34868,35035,167
100,8,gets,45,60.07984,162.12612,35035,35203,168
100,8,gets,45,61.0691,164.34476,35203,35369,166
100,8,array1,47,93.6936166666666,163.776633333333,35369,35568,199
100,8,array1,47,108.739466666667,167.560566666667,35568,35763,195
100,8,array1,47,110.175066666667,162.20915,35763,35958,195
100,8,array1,47,117.970566666667,167.858416666667,35958,36152,194
100,8,array1,47,123.80405,166.590983333333,36152,36348,196
100,8,array1,47,121.3552,170.316,36348,36545,197
100,8,array1,47,121.2608,172.189483333333,36545,36744,199
100,9,printf,50,97.81265,182.847683333333,36744,36942,198
100,9,printf,50,100.4596,181.045975,36942,37075,133
100,11,find_anagram,62,198.6872,242.1859,37075,37619,544
100,9,"Enteranotherstring\n",52,193.58038,181.97502,37619,37800,181
100,9,"Enteranotherstring\n",52,260.403316666667,182.54565,37800,37996,196
100,9,"Enteranotherstring\n",52,196.76284,183.50856,37996,38164,168
100,9,"Enteranotherstring\n",52,190.01925,189.1259,38164,38231,67
100,10,gets,55,76.4987833333333,214.0754,38298,38485,187
100,10,array2,57,120.699616666667,205.878516666667,38485,38681,196
100,10,array2,57,101.626166666667,215.17765,38681,38877,196
100,11,flag,60,68.0417666666667,229.992533333333,38877,39073,196
100,11,flag,60,53.48514,232.68288,39073,39239,166
100,11,flag,60,50.1498,231.29092,39239,39407,168
100,0,blank,0,88.707,222.874933333333,39407,39506,99
100,0,blank,0,-350,-105,39539,39648,109
100,10,array2,57,112.077916666667,209.442566666667,39741,39925,184
100,10,array2,57,110.794216666667,207.76915,39925,40119,194
100,0,blank,0,104.6671,193.972333333333,40119,40312,193
100,8,array1,47,104.054566666667,168.395166666667,40312,40407,95
100,0,blank,0,-350,-105,40470,40653,183
100,0,blank,0,-350,-105,40653,40821,168
100,0,blank,0,-350,-105,40821,40996,175
100,0,blank,0,-350,-105,40996,41138,142
100,0,blank,0,230.60342,127.05312,41171,41348,177
100,7,"Enterthestring\n",42,234.73145,139.5589,41348,41413,65
100,0,blank,0,235.3635,220.973416666667,41446,41638,192
100,0,blank,0,232.65105,221.4808,41638,41829,191
100,0,blank,0,236.699683333333,215.63975,41829,42020,191
100,11,array1,64,248.209933333333,235.436966666667,42020,42211,191
100,11,find_anagram,62,218.625466666667,234.25285,42211,42401,190
100,0,blank,0,188.8407,246.67155,42401,42595,194
100,12,1,73,166.280733333333,245.304533333333,42595,42695,100
100,11,comma,65,306.578733333333,242.9878,42728,42926,198
100,11,array2,66,348.666733333333,233.652283333333,42926,43125,199
100,11,array2,66,352.883083333333,238.433216666667,43125,43321,196
100,11,),67,386.383633333333,233.577816666667,43321,43520,199
100,0,blank,0,413.467433333333,233.208066666667,43520,43716,196
100,0,blank,0,435.8688,233.639,43716,43912,196
100,11,array2,66,327.508666666667,237.904466666667,43912,44106,194
100,11,array1,64,279.707233333333,238.248283333333,44106,44300,194
100,11,find_anagram,62,201.658766666667,241.563483333333,44300,44497,197
100,12,),74,176.658833333333,256.824083333333,44497,44696,199
100,12,==,72,148.888566666667,259.586783333333,44696,44894,198
100,12,),74,179.567816666667,264.01015,44894,45088,194
100,0,blank,0,208.004316666667,256.427783333333,45088,45286,198
100,0,blank,0,206.25645,264.647216666667,45286,45483,197
100,0,blank,0,183.907816666667,256.929483333333,45483,45677,194
100,0,blank,0,185.376983333333,265.769116666667,45677,45870,193
100,0,blank,0,188.73705,263.843566666667,45870,46066,196
100,0,blank,0,212.4388,262.544883333333,46066,46262,196
100,0,blank,0,197.616683333333,255.447216666667,46262,46457,195
100,0,blank,0,187.1712,249.04595,46457,46655,198
100,0,blank,0,195.198083333333,259.59945,46655,46852,197
100,0,blank,0,221.80692,258.06326,46852,47020,168
100,0,blank,0,219.54766,266.34618,47020,47188,168
100,13,"%sand%sareanagrams.\n",77,218.708016666667,267.804316666667,47188,47384,196
100,0,blank,0,272.709483333333,289.183566666667,47384,47577,193
100,13,"%sand%sareanagrams.\n",77,358.32865,287.619716666667,47577,47774,197
100,0,blank,0,360.25638,288.97338,47774,47940,166
100,0,blank,0,300.59834,291.45496,47940,48108,168
100,0,blank,0,283.39412,294.91366,48108,48277,169
100,13,"%sand%sareanagrams.\n",77,250.299116666667,281.892333333333,48277,48476,199
100,0,blank,0,217.138283333333,263.8286,48476,48674,198
100,0,blank,0,220.1237,262.257783333333,48674,48873,199
100,0,blank,0,216.320216666667,262.7367,48873,49072,199
100,13,"%sand%sareanagrams.\n",77,200.85738,268.38948,49072,49239,167
100,13,"%sand%sareanagrams.\n",77,194.72882,272.04554,49239,49406,167
100,13,"%sand%sareanagrams.\n",77,223.92878,271.93492,49406,49576,170
100,0,blank,0,-350,-105,49610,49792,182
100,0,blank,0,-350,-105,49792,49842,50
100,0,blank,0,216.2025,258.222766666667,49870,49960,90
100,0,blank,0,-350,-105,49994,50160,166
100,0,blank,0,-350,-105,50160,50344,184
100,0,blank,0,-350,-105,50344,50536,192
100,0,blank,0,-350,-105,50536,50707,171
100,0,blank,0,-350,-105,50707,50896,189
100,0,blank,0,-350,-105,50896,51024,128
100,0,blank,0,-350,-105,51024,51138,114
100,0,blank,0,-350,-105,51138,51331,193
100,0,blank,0,-350,-105,51331,51472,141
100,0,blank,0,-350,-105,51472,51567,95
100,0,blank,0,-350,-105,51567,51734,167
100,0,blank,0,-350,-105,51734,51860,126
100,0,blank,0,-350,-105,51860,52054,194
100,0,blank,0,-350,-105,52054,52155,101
100,0,blank,0,-350,-105,52155,52338,183
100,0,blank,0,-350,-105,52338,52513,175
100,0,blank,0,-350,-105,52513,52689,176
100,0,blank,0,-350,-105,52689,52866,177
100,0,blank,0,-350,-105,52866,53050,184
100,0,blank,0,-350,-105,53050,53222,172
100,0,blank,0,-350,-105,53222,53401,179
100,0,blank,0,-350,-105,53401,53511,110
100,0,blank,0,-350,-105,53511,53713,202
100,0,blank,0,-350,-105,53713,53884,171
100,0,blank,0,-350,-105,53884,54059,175
100,0,blank,0,-350,-105,54059,54205,146
100,0,blank,0,-350,-105,54205,54381,176
100,0,blank,0,-350,-105,54381,54552,171
100,0,blank,0,-350,-105,54552,54662,110
100,13,"%sand%sareanagrams.\n",77,208.088075,279.7743,54765,54958,193
100,0,blank,0,220.1749,310.35215,54958,55059,101
100,13,"%sand%sareanagrams.\n",77,327.201266666667,283.995633333333,55108,55256,148
100,13,"%sand%sareanagrams.\n",77,195.88106,281.98418,55304,55491,187
100,13,"%sand%sareanagrams.\n",77,195.401,283.36075,55491,55686,195
100,13,"%sand%sareanagrams.\n",77,256.665366666667,279.290483333333,55686,55883,197
100,13,"%sand%sareanagrams.\n",77,286.505966666667,269.194166666667,55883,56079,196
100,13,"%sand%sareanagrams.\n",77,284.44145,272.589266666667,56079,56275,196
100,13,"%sand%sareanagrams.\n",77,228.803283333333,275.023566666667,56275,56474,199
100,13,"%sand%sareanagrams.\n",77,255.354583333333,273.974333333333,56474,56670,196
100,13,"%sand%sareanagrams.\n",77,295.072316666667,271.68195,56670,56868,198
100,13,"%sand%sareanagrams.\n",77,374.1523,271.447316666667,56868,57067,199
100,0,blank,0,423.35345,271.319883333333,57067,57265,198
100,13,"%sand%sareanagrams.\n",77,396.909283333333,271.309733333333,57265,57463,198
100,13,"%sand%sareanagrams.\n",77,411.721933333333,274.162333333333,57463,57661,198
100,13,"%sand%sareanagrams.\n",77,422.333766666667,274.78855,57661,57859,198
100,13,array1,79,475.06025,270.52475,57859,58057,198
100,13,array1,79,485.205083333333,273.967083333333,58057,58254,197
100,13,"%sand%sareanagrams.\n",77,372.892883333333,269.43905,58254,58453,199
100,0,blank,0,349.196933333333,265.963983333333,58453,58648,195
100,13,"%sand%sareanagrams.\n",77,288.225716666667,268.9321,58648,58843,195
100,13,"%sand%sareanagrams.\n",77,186.687183333333,276.939233333333,58843,59040,197
100,13,"%sand%sareanagrams.\n",77,181.00805,276.06305,59040,59234,194
100,13,"%sand%sareanagrams.\n",77,236.9713,280.78015,59234,59433,199
100,13,"%sand%sareanagrams.\n",77,251.6369,280.177766666667,59433,59626,193
100,13,"%sand%sareanagrams.\n",77,307.670616666667,277.461883333333,59626,59818,192
100,13,"%sand%sareanagrams.\n",77,261.434016666667,283.681333333333,59818,60005,187
100,13,"%sand%sareanagrams.\n",77,234.334233333333,282.985616666667,60005,60193,188
100,13,"%sand%sareanagrams.\n",77,238.133983333333,282.44375,60193,60386,193
100,13,"%sand%sareanagrams.\n",77,164.5175,275.106933333333,60386,60582,196
100,0,blank,0,162.045483333333,265.873983333333,60582,60778,196
100,12,==,72,138.4187,260.4468,60778,60976,198
100,12,==,72,144.58704,260.71546,60976,61143,167
100,0,blank,0,153.32006,272.00098,61143,61313,170
100,12,==,72,139.32604,261.94396,61313,61479,166
100,0,blank,0,147.769,266.1076,61479,61513,34
100,0,blank,0,-350,-105,61546,61737,191
100,0,blank,0,-350,-105,61737,61929,192
100,0,blank,0,-350,-105,61929,62115,186
100,0,blank,0,-350,-105,62115,62289,174
100,0,blank,0,-350,-105,62289,62470,181
100,0,blank,0,-350,-105,62470,62664,194
100,0,blank,0,-350,-105,62664,62737,73
100,0,blank,0,-350,-105,62737,62929,192
100,0,blank,0,-350,-105,62929,63106,177
100,0,blank,0,-350,-105,63106,63280,174
100,0,blank,0,-350,-105,63280,63455,175
100,0,blank,0,-350,-105,63455,63632,177
100,0,blank,0,-350,-105,63632,63808,176
100,0,blank,0,-350,-105,63808,63966,158
100,0,blank,0,-350,-105,63966,64152,186
100,0,blank,0,-350,-105,64152,64341,189
100,0,blank,0,-350,-105,64341,64364,23
100,0,blank,0,-350,-105,64364,64584,220
100,0,blank,0,-350,-105,64584,64710,126
100,0,blank,0,229.650983333333,288.495283333333,65020,65206,186
100,13,"%sand%sareanagrams.\n",77,222.18295,275.775683333333,65206,65400,194
100,13,"%sand%sareanagrams.\n",77,223.535766666667,271.299983333333,65400,65594,194
100,0,blank,0,223.004583333333,264.375983333333,65594,65785,191
100,0,blank,0,219.850366666667,266.5899,65785,65972,187
100,13,"%sand%sareanagrams.\n",77,219.410216666667,270.430783333333,65972,66165,193
100,13,"%sand%sareanagrams.\n",77,221.5328,268.6326,66165,66230,65
100,13,"%sand%sareanagrams.\n",77,422.60882,283.85056,66263,66435,172
100,13,comma,80,431.72356,277.37102,66435,66605,170
100,13,"%sand%sareanagrams.\n",77,412.47536,269.34516,66605,66776,171
100,13,"%sand%sareanagrams.\n",77,379.98178,270.40742,66776,66947,171
100,13,"%sand%sareanagrams.\n",77,371.578,269.52006,66947,67116,169
100,13,"%sand%sareanagrams.\n",77,357.130766666667,272.366883333333,67116,67315,199
100,13,"%sand%sareanagrams.\n",77,360.9726,272.2774,67315,67384,69
100,13,"%sand%sareanagrams.\n",77,172.311733333333,278.835683333333,67418,67617,199
100,13,"%sand%sareanagrams.\n",77,167.736983333333,278.76035,67617,67816,199
100,0,blank,0,114.056683333333,266.971116666667,67816,68013,197
100,13,printf,75,114.529383333333,267.294216666667,68013,68212,199
100,13,(,76,151.38602,278.87006,68212,68383,171
100,13,"%sand%sareanagrams.\n",77,168.53704,284.65874,68383,68551,168
100,13,printf,75,142.7525,281.40132,68551,68721,170
100,13,printf,75,141.89764,279.25446,68721,68892,171
100,13,"%sand%sareanagrams.\n",77,164.304766666667,281.547966666667,68892,69091,199
100,13,"%sand%sareanagrams.\n",77,155.060533333333,280.464183333333,69091,69286,195
100,13,printf,75,121.93228,275.08716,69286,69452,166
100,13,(,76,145.2894,275.59915,69452,69651,199
100,13,"%sand%sareanagrams.\n",77,158.52808,273.31734,69651,69818,167
100,13,"%sand%sareanagrams.\n",77,178.009016666667,275.51185,69818,70016,198
100,13,"%sand%sareanagrams.\n",77,215.4449,274.86008,70016,70186,170
100,13,"%sand%sareanagrams.\n",77,196.3965,277.39224,70186,70352,166
100,13,"%sand%sareanagrams.\n",77,231.32992,270.66198,70352,70519,167
100,13,"%sand%sareanagrams.\n",77,234.30858,275.7901,70519,70686,167
100,13,"%sand%sareanagrams.\n",77,206.66206,274.8375,70686,70853,167
100,13,"%sand%sareanagrams.\n",77,186.619866666667,278.446383333333,70853,71049,196
100,13,"%sand%sareanagrams.\n",77,217.12375,281.574583333333,71049,71245,196
100,13,"%sand%sareanagrams.\n",77,242.84955,276.66185,71245,71443,198
100,13,"%sand%sareanagrams.\n",77,244.2066,277.7213,71443,71565,122
100,13,"%sand%sareanagrams.\n",77,283.3779,274.94215,71565,71754,189
100,13,"%sand%sareanagrams.\n",77,240.995116666667,274.470866666667,71754,71951,197
100,13,"%sand%sareanagrams.\n",77,224.637233333333,271.924966666667,71951,72143,192
100,13,"%sand%sareanagrams.\n",77,251.548616666667,277.2789,72143,72338,195
100,13,"%sand%sareanagrams.\n",77,284.186666666667,275.521,72338,72531,193
100,13,"%sand%sareanagrams.\n",77,293.927583333333,273.484916666667,72531,72725,194
100,13,"%sand%sareanagrams.\n",77,291.75905,273.663916666667,72725,72918,193
100,13,"%sand%sareanagrams.\n",77,292.007483333333,272.3326,72918,73112,194
100,13,"%sand%sareanagrams.\n",77,290.784966666667,273.417366666667,73112,73307,195
100,13,"%sand%sareanagrams.\n",77,296.70935,276.08855,73307,73504,197
100,13,"%sand%sareanagrams.\n",77,310.85134,275.939,73504,73671,167
100,13,"%sand%sareanagrams.\n",77,310.94788,275.24614,73671,73837,166
100,13,"%sand%sareanagrams.\n",77,309.77274,271.42974,73837,74004,167
100,13,"%sand%sareanagrams.\n",77,291.7442,274.514,74004,74171,167
100,13,"%sand%sareanagrams.\n",77,259.07372,274.174,74171,74338,167
100,13,"%sand%sareanagrams.\n",77,192.8732,283.47572,74338,74507,169
100,13,"%sand%sareanagrams.\n",77,191.5984,276.1863,74507,74674,167
100,13,"%sand%sareanagrams.\n",77,183.680483333333,273.369216666667,74674,74873,199
100,13,"%sand%sareanagrams.\n",77,184.468883333333,269.236266666667,74873,75068,195
100,13,"%sand%sareanagrams.\n",77,172.760833333333,273.266166666667,75068,75263,195
100,13,"%sand%sareanagrams.\n",77,157.5384,270.222516666667,75263,75456,193
100,13,(,76,150.1885,274.397616666667,75456,75650,194
100,13,"%sand%sareanagrams.\n",77,181.08445,268.92395,75650,75845,195
100,13,"%sand%sareanagrams.\n",77,247.8833,269.143066666667,75845,76038,193
100,0,blank,0,228.483066666667,265.77245,76038,76229,191
100,13,"%sand%sareanagrams.\n",77,166.509916666667,272.629216666667,76229,76418,189
100,13,"%sand%sareanagrams.\n",77,164.647033333333,272.01005,76418,76606,188
100,13,"%sand%sareanagrams.\n",77,160.9404,274.786083333333,76606,76794,188
100,13,"%sand%sareanagrams.\n",77,160.290333333333,276.6192,76794,76981,187
100,0,blank,0,200.11425,298.92915,76981,77167,186
100,13,"%sand%sareanagrams.\n",77,198.091416666667,279.350783333333,77167,77356,189
100,13,"%sand%sareanagrams.\n",77,222.574516666667,276.88975,77356,77547,191
100,0,blank,0,234.0704,296.582733333333,77547,77739,192
100,15,"%sand%sarenotanagrams.\n",87,231.655833333333,315.4337,77739,77930,191
100,15,"%sand%sarenotanagrams.\n",87,229.034983333333,314.596666666667,77930,78117,187
100,18,array1,102,241.14615,392.978025,78117,78241,124
100,0,blank,0,354.210525,347.48585,78327,78507,180
100,0,blank,0,338.838325,305.36505,78507,78686,179
100,11,array2,66,341.93095,228.00705,78686,78778,92
100,12,),74,179.7739,265.89505,78825,79006,181
100,12,==,72,149.257266666667,261.6415,79006,79142,136
100,12,flag,71,115.5329,255.7243,79142,79318,176
100,13,printf,75,125.2578,275.19116,79318,79488,170
100,12,==,72,141.229166666667,254.778133333333,79488,79670,182
100,11,find_anagram,62,137.317366666667,238.974466666667,79670,79855,185
100,0,blank,0,119.927283333333,298.85975,79855,80047,192
100,15,printf,85,116.626916666667,319.420066666667,80047,80242,195
100,15,printf,85,108.76955,329.73975,80242,80440,198
100,16,return,94,88.2195,342.2742,80440,80477,37
100,15,"%sand%sarenotanagrams.\n",87,357.588433333333,315.566366666667,80609,80707,98
100,0,blank,0,462.940066666667,337.285083333333,80776,80963,187
100,0,blank,0,468.55645,303.030766666667,80963,81155,192
100,13,array1,79,459.718266666667,279.881566666667,81155,81344,189
100,13,array1,79,496.20484,268.79646,81344,81512,168
100,0,blank,0,-350,-105,81544,81737,193
100,0,blank,0,-350,-105,81737,81928,191
100,0,blank,0,-350,-105,81928,82102,174
100,0,blank,0,-350,-105,82102,82300,198
100,0,blank,0,-350,-105,82300,82422,122
100,0,blank,0,-350,-105,82422,82530,108
100,0,blank,0,-350,-105,82530,82687,157
100,0,blank,0,-350,-105,82687,82786,99
100,0,blank,0,-350,-105,82786,82960,174
100,0,blank,0,-350,-105,82960,83141,181
100,0,blank,0,-350,-105,83141,83316,175
100,0,blank,0,-350,-105,83316,83493,177
100,0,blank,0,-350,-105,83493,83671,178
100,0,blank,0,-350,-105,83671,83848,177
100,0,blank,0,-350,-105,83848,84026,178
100,0,blank,0,-350,-105,84026,84157,131
100,0,blank,0,-350,-105,84157,84265,108
100,0,blank,0,-350,-105,84265,84378,113
100,0,blank,0,-350,-105,84378,84512,134
100,0,blank,0,-350,-105,84512,84617,105
100,0,blank,0,-350,-105,84617,84813,196
100,0,blank,0,-350,-105,84813,84971,158
100,0,blank,0,-350,-105,84971,85028,57
100,0,blank,0,-350,-105,85028,85226,198
100,0,blank,0,-350,-105,85226,85419,193
100,0,blank,0,-350,-105,85419,85542,123
100,0,blank,0,-350,-105,85542,85728,186
100,0,blank,0,-350,-105,85728,85912,184
100,0,blank,0,-350,-105,85912,86021,109
100,0,blank,0,-350,-105,86021,86151,130
100,0,blank,0,-350,-105,86151,86299,148
100,0,blank,0,-350,-105,86299,86492,193
100,0,blank,0,-350,-105,86492,86519,27
100,0,blank,0,-350,-105,86519,86719,200
100,0,blank,0,-350,-105,86719,86923,204
100,0,blank,0,-350,-105,86923,87112,189
100,0,blank,0,-350,-105,87112,87295,183
100,0,blank,0,-350,-105,87295,87483,188
100,0,blank,0,-350,-105,87483,87657,174
100,0,blank,0,-350,-105,87657,87832,175
100,0,blank,0,-350,-105,87832,88009,177
100,0,blank,0,-350,-105,88009,88186,177
100,0,blank,0,-350,-105,88186,88311,125
100,0,blank,0,-350,-105,88311,88773,462
100,0,blank,0,-350,-105,88773,88902,129
100,15,"%sand%sarenotanagrams.\n",87,158.004466666667,311.078266666667,88945,89118,173
100,15,printf,85,132.84425,323.6827,89118,89211,93
100,12,flag,71,112.8846,250.2656,89398,89492,94
100,0,blank,0,472.51156,313.23118,89546,89730,184
100,15,array1,89,532.16614,329.18484,89730,89903,173
100,15,array2,91,574.82856,325.04818,89903,90074,171
100,15,array2,91,567.8466,331.16425,90074,90146,72
100,0,blank,0,323.85958,332.41154,90181,90374,193
100,0,blank,0,330.28778,353.38,90374,90550,176
100,0,blank,0,205.236225,407.22285,90583,90756,173
100,18,char,106,198.38894,393.9332,90756,90921,165
100,0,blank,0,178.44265,366.817625,90955,91134,179
100,0,blank,0,165.46784,360.55728,91134,91302,168
100,18,char,106,189.89124,392.12654,91302,91472,170
100,18,(,100,165.36792,392.99764,91472,91641,169
100,0,blank,0,156.202666666667,401.758466666667,91641,91768,127
100,0,blank,0,166.645,353.378,91768,91877,109
100,0,blank,0,177.2979,352.5226,91877,92008,131
100,0,blank,0,201.339766666667,342.436766666667,92008,92179,171
100,0,blank,0,217.3174,336.79458,92179,92345,166
100,0,blank,0,236.92354,374.5809,92345,92512,167
100,18,array1,102,243.48506,396.51248,92512,92696,184
100,0,blank,0,237.91642,398.0097,92696,92866,170
100,0,blank,0,180.994666666667,401.796383333333,92866,93061,195
100,18,(,100,170.07925,379.64135,93061,93125,64
100,0,blank,0,373.72594,403.38346,93157,93335,178
100,0,blank,0,312.97836,387.26444,93335,93512,177
100,0,blank,0,315.53368,393.9498,93512,93681,169
100,0,blank,0,312.8005,401.94805,93681,93748,67
100,0,blank,0,330.480616666667,447.987,93815,94014,199
100,20,=,132,333.08675,430.61475,94014,94085,71
100,0,blank,0,278.32574,411.68808,94162,94339,177
100,0,blank,0,240.325833333333,407.357166666667,94339,94531,192
100,0,blank,0,240.938716666667,403.20525,94531,94729,198
100,20,26,124,302.52078,440.91704,94729,94906,177
100,20,26,124,296.989,437.77406,94906,95080,174
100,0,blank,0,267.25925,405.075225,95080,95255,175
100,0,blank,0,426.52156,405.67762,95291,95468,177
100,18,array2,107,429.36002,395.45894,95468,95650,182
100,0,blank,0,464.33856,420.92254,95650,95815,165
100,0,blank,0,486.93756,423.72326,95815,95978,163
100,0,blank,0,324.052933333333,440.149183333333,96010,96209,199
100,0,blank,0,322.8182,449.387183333333,96209,96403,194
100,20,num2,122,259.3477,429.5922,96403,96597,194
100,0,blank,0,242.048816666667,424.057083333333,96597,96788,191
100,0,blank,0,223.829016666667,407.774583333333,96788,96978,190
100,0,blank,0,225.574433333333,400.278483333333,96978,97166,188
100,0,blank,0,216.371466666667,396.309433333333,97166,97353,187
100,18,char,106,213.708316666667,384.77535,97353,97540,187
100,18,char,106,212.0042,390.18528,97540,97700,160
100,18,array2,107,381.9644,392.443766666667,97733,97931,198
100,0,blank,0,459.521766666667,400.721383333333,97931,98125,194
100,18,),110,458.717033333333,397.953533333333,98125,98323,198
100,0,blank,0,456.62622,399.39192,98323,98490,167
100,18,),110,457.039183333333,395.634816666667,98490,98688,198
100,18,array2,107,414.852566666667,390.197466666667,98688,98883,195
100,18,char,106,362.751,380.835766666667,98883,99080,197
100,0,blank,0,368.84608,388.58158,99080,99247,167
100,18,array2,107,376.7769,389.9047,99247,99281,34
100,0,blank,0,918.548166666667,370.292633333333,99348,99546,198
100,0,blank,0,1024.1728,273.76382,99546,99740,194
100,0,blank,0,1016.5602,301.294,99740,99908,168
100,0,blank,0,1019.3506,295.11786,99908,100075,167
100,0,blank,0,1021.2928,295.20698,100075,100244,169
100,0,blank,0,1017.505,281.69216,100244,100414,170
100,0,blank,0,1002.6365,281.79885,100414,100484,70
100,18,comma,105,308.24588,379.60164,100551,100723,172
100,18,comma,105,308.09395,397.579716666667,100723,100918,195
100,0,blank,0,303.867133333333,399.878366666667,100918,101017,99
101,0,blank,0,202.923733333333,269.012966666667,101477,101576,99
101,0,blank,0,240.058666666667,294.803733333333,101641,101738,97
101,0,blank,0,204.574533333333,277.293166666667,101770,101871,101
101,0,blank,0,226.194575,275.292275,102033,102218,185
101,20,{,127,202.008316666667,309.4082,102218,102410,192
101,0,blank,0,207.259366666667,322.5776,102410,102608,198
101,18,char,106,222.373383333333,262.592833333333,102608,102799,191
101,18,char,106,222.89225,257.0683,102799,102987,188
101,18,char,106,215.3091,262.921283333333,102987,103176,189
101,18,find_anagram,99,167.9905,261.7041,103176,103363,187
101,18,array1,102,280.182183333333,262.4039,103394,103586,192
101,18,array1,102,282.02564,259.46852,103586,103754,168
101,18,array1,102,278.378666666667,253.4971,103754,103855,101
101,0,blank,0,165.41992,270.76598,103891,104076,185
101,18,find_anagram,99,158.01966,266.17052,104076,104256,180
101,0,blank,0,156.72716,271.16292,104256,104431,175
101,0,blank,0,156.661,271.01018,104431,104605,174
101,0,blank,0,276.39018,270.20152,104605,104776,171
101,18,],109,310.34384,257.1187,104776,104949,173
101,18,char,106,349.8611,258.26946,104949,105126,177
101,18,array2,107,428.95058,256.09496,105126,105304,178
101,18,array2,107,403.35888,259.37986,105304,105478,174
101,0,blank,0,376.03838,273.04254,105478,105651,173
101,0,blank,0,347.43628,283.83176,105651,105824,173
101,0,blank,0,328.9249,287.98054,105824,106002,178
101,0,blank,0,313.1058,289.30882,106002,106179,177
101,18,array1,102,290.2594,267.89346,106179,106353,174
101,18,],109,305.19166,257.26682,106353,106523,170
101,18,char,106,337.15586,260.1108,106523,106694,171
101,18,char,106,380.11502,256.79818,106694,106865,171
101,18,char,106,370.6478,248.94124,106865,107037,172
101,18,char,106,360.52258,249.38438,107037,107209,172
101,18,],109,306.24766,255.48444,107209,107383,174
101,18,array1,102,282.84678,251.14046,107383,107557,174
101,18,array1,102,263.05008,258.0474,107557,107730,173
101,18,array1,102,255.1159,258.50446,107730,107906,176
101,0,blank,0,291.11898,284.59082,107906,108079,173
101,20,26,124,307.0817,300.47544,108079,108246,167
101,18,comma,105,325.34272,256.6119,108246,108414,168
101,18,char,106,368.2079,257.01168,108414,108582,168
101,18,array2,107,387.25,254.80666,108582,108752,170
101,18,char,106,334.68236,248.42404,108752,108924,172
101,18,comma,105,330.6206,255.1964,108924,108958,34
101,0,blank,0,271.686733333333,268.7169,109028,109142,114
101,0,blank,0,-350,-105,109178,109348,170
101,18,[,108,298.0761,263.71538,109507,109674,167
101,18,[,108,298.330066666667,265.491633333333,109674,109866,192
101,0,blank,0,314.306166666667,268.611683333333,109866,110055,189
101,0,blank,0,299.645516666667,269.944433333333,110055,110244,189
101,18,array1,102,271.860033333333,267.003316666667,110244,110432,188
101,18,[,108,298.960566666667,263.301916666667,110432,110622,190
101,18,array1,102,274.53335,262.080433333333,110622,110814,192
101,18,char,106,187.3284,260.150266666667,110814,111011,197
101,0,blank,0,165.23352,270.5072,111011,111178,167
101,0,blank,0,148.406233333333,269.6358,111178,111377,199
101,18,comma,105,328.243866666667,261.198633333333,111410,111606,196
101,18,comma,105,323.477066666667,263.542583333333,111606,111800,194
101,0,blank,0,293.714416666667,259.70955,111800,111993,193
101,18,array1,102,288.2954,265.037225,111993,112147,154
101,0,blank,0,241.1906,308.9608,112147,112270,123
101,0,blank,0,234.12705,304.2465,112270,112460,190
101,0,blank,0,209.8015,316.62062,112460,112635,175
101,0,blank,0,207.773416666667,314.2611,112635,112829,194
101,0,blank,0,193.310583333333,276.789083333333,112829,113023,194
101,18,char,106,189.1688,259.05355,113023,113219,196
101,18,char,106,190.0905,257.87146,113219,113386,167
101,18,array1,102,253.1766,261.455966666667,113386,113584,198
101,18,[,108,295.094516666667,250.427116666667,113584,113775,191
101,18,comma,105,332.229883333333,253.803033333333,113775,113970,195
101,0,blank,0,353.99905,270.098766666667,113970,114162,192
101,18,char,106,339.375283333333,264.830216666667,114162,114350,188
101,18,array2,107,406.6812,267.085516666667,114350,114548,198
101,0,blank,0,442.638216666667,278.431583333333,114548,114736,188
101,0,blank,0,439.411266666667,269.483616666667,114736,114930,194
101,0,blank,0,470.438733333333,258.74105,114930,115120,190
101,0,blank,0,478.6897,257.391666666667,115120,115311,191
101,0,blank,0,495.30655,257.69485,115311,115375,64
101,18,comma,105,326.314283333333,255.494833333333,115407,115598,191
101,18,comma,105,323.87235,260.644433333333,115598,115793,195
101,0,blank,0,243.752266666667,286.13505,115793,115987,194
101,20,},129,222.1718,311.698166666667,115987,116182,195
101,0,blank,0,207.57482,320.3762,116182,116352,170
101,20,],125,157.598566666667,309.9368,116352,116456,104
101,0,blank,0,185.16908,311.0148,116524,116701,177
101,0,blank,0,238.07515,320.87055,116701,116867,166
101,0,blank,0,241.2501,307.19655,116936,117135,199
101,20,{,127,201.4665,299.7927,117135,117202,67
101,0,blank,0,213.664725,313.2239,117299,117432,133
101,29,a,181,259.5322,493.5553,117467,117504,37
101,0,blank,0,284.300533333333,298.58065,117568,117761,193
101,20,num2,122,283.749216666667,300.615216666667,117761,117959,198
101,20,26,124,303.00295,303.354333333333,117959,118154,195
101,20,{,127,362.236466666667,306.97745,118154,118350,196
101,20,},129,382.491566666667,303.662583333333,118350,118544,194
101,20,0,133,370.873883333333,297.57005,118544,118739,195
101,20,{,127,359.512333333333,307.201983333333,118739,118935,196
101,0,blank,0,352.213466666667,302.044883333333,118935,119132,197
101,20,0,133,372.730333333333,299.2994,119132,119329,197
101,0,blank,0,403.259483333333,300.30115,119329,119526,197
101,20,0,133,447.106683333333,301.847516666667,119526,119719,193
101,0,blank,0,479.249533333333,315.003216666667,119719,119918,199
101,0,blank,0,469.381033333333,297.2901,119918,120110,192
101,20,comma,130,389.252816666667,306.480333333333,120110,120304,194
101,0,blank,0,408.4883,335.5018,120304,120336,32
101,0,blank,0,255.59188,334.05838,120368,120529,161
101,21,0,142,257.3235,316.4857,120529,120595,66
101,0,blank,0,232.48425,345.17185,120658,120824,166
101,0,blank,0,215.254925,317.6923,120824,120967,143
101,20,0,133,207.0242,303.9887,120967,121040,73
101,23,a,152,259.1786,366.5735,121069,121106,37
101,0,blank,0,215.51335,324.5534,121204,121388,184
101,21,!=,141,224.949566666667,319.485116666667,121388,121572,184
101,20,num2,122,258.757,305.706133333333,121572,121758,186
101,20,num2,122,265.47785,308.306233333333,121758,121948,190
101,21,0,142,279.366733333333,314.32305,121948,122136,188
101,20,[,123,290.4197,307.141116666667,122136,122324,188
101,0,blank,0,284.860333333333,309.637383333333,122324,122514,190
101,0,blank,0,346.36965,306.113083333333,122514,122704,190
101,20,i,131,408.98685,299.200916666667,122704,122893,189
101,20,=,132,433.93605,302.214066666667,122893,123084,191
101,20,=,132,433.180883333333,303.7878,123084,123277,193
101,20,=,132,429.592083333333,298.500966666667,123277,123467,190
101,20,=,132,430.332983333333,302.230066666667,123467,123658,191
101,20,=,132,425.4255,304.039083333333,123658,123848,190
101,0,blank,0,439.30755,306.782683333333,123848,124039,191
101,0,blank,0,395.74115,303.066733333333,124039,124229,190
101,0,blank,0,352.121666666667,305.47455,124229,124421,192
101,0,blank,0,346.772066666667,311.07585,124421,124610,189
101,20,{,127,359.71215,300.654933333333,124610,124806,196
101,0,blank,0,382.8477,318.2716,124806,124999,193
101,0,blank,0,367.873333333333,321.9837,124999,125191,192
101,0,blank,0,345.47715,302.947583333333,125191,125387,196
101,20,{,127,353.04215,306.230833333333,125387,125581,194
101,0,blank,0,370.6113,321.599616666667,125581,125772,191
101,0,blank,0,369.14488,342.28508,125772,125933,161
101,0,blank,0,373.09495,323.408833333333,125999,126196,197
101,20,],125,315.787133333333,294.641866666667,126196,126298,102
101,21,0,142,276.6392,327.95485,126476,126576,100
101,0,blank,0,406.31445,273.738583333333,126614,126813,199
101,18,char,106,369.75244,267.07516,126813,126984,171
101,18,char,106,351.57895,255.8079,126984,127056,72
101,0,blank,0,477.79286,259.4991,127091,127264,173
101,0,blank,0,468.9577,267.07625,127264,127328,64
101,0,blank,0,549.8546,367.6103,127393,127429,36
101,0,blank,0,443.6837,260.0553,127460,127494,34
101,0,blank,0,278.487416666667,284.9751,127526,127724,198
101,0,blank,0,330.002983333333,316.52615,127724,127920,196
101,0,blank,0,384.697333333333,328.326183333333,127920,128112,192
101,0,blank,0,458.32505,325.790216666667,128112,128303,191
101,0,blank,0,462.652633333333,331.326033333333,128303,128496,193
101,0,blank,0,487.093966666667,326.23605,128496,128692,196
101,0,blank,0,482.529233333333,322.757033333333,128692,128890,198
101,0,blank,0,463.47365,310.4092,128890,129085,195
101,0,blank,0,458.5722,317.584033333333,129085,129283,198
101,0,blank,0,496.64558,307.83068,129283,129452,169
101,0,blank,0,502.7647,317.40044,129452,129621,169
101,0,blank,0,504.093783333333,318.56525,129621,129819,198
101,0,blank,0,448.31448,322.67594,129819,129986,167
101,0,blank,0,449.75968,316.1824,129986,130154,168
101,0,blank,0,419.62728,313.4523,130154,130322,168
101,20,comma,130,386.34526,310.72786,130322,130495,173
101,20,{,127,355.68326,311.37496,130495,130665,170
101,20,=,132,339.44812,309.2535,130665,130838,173
101,20,26,124,309.06798,311.93096,130838,131007,169
101,20,26,124,303.11294,311.75316,131007,131178,171
101,0,blank,0,292.691,318.772,131178,131211,33
101,20,;,134,461.95552,310.98218,131245,131420,175
101,0,blank,0,485.73472,304.73986,131420,131593,173
101,0,blank,0,488.67315,294.65205,131593,131661,68
101,0,blank,0,174.79006,316.31654,131695,131875,180
101,21,array1,137,162.86684,323.14252,131875,132051,176
101,21,array1,137,152.48724,320.4605,132051,132220,169
101,0,blank,0,330.38604,317.46826,132254,132424,170
101,0,blank,0,328.8658,312.449966666667,132424,132562,138
101,0,blank,0,212.5852,337.1359,132680,132813,133
101,21,array1,137,153.7224,330.792333333333,132813,132987,174
101,0,blank,0,212.2421,322.09772,132987,133156,169
101,21,0,142,249.8474,315.7832,133156,133325,169
101,21,0,142,260.74796,319.83556,133325,133496,171
101,21,),143,288.1315,325.68078,133496,133669,173
101,21,0,142,265.91114,324.69346,133669,133843,174
101,0,blank,0,235.7965,326.69776,133843,134014,171
101,21,!=,141,232.01298,325.99034,134014,134185,171
101,0,blank,0,234.86732,326.49716,134185,134356,171
101,21,0,142,255.32894,327.53722,134356,134527,171
101,21,0,142,261.64014,321.94482,134527,134695,168
101,21,0,142,260.13056,331.07862,134695,134865,170
101,21,0,142,264.1489,324.82668,134865,135035,170
101,21,0,142,274.28648,322.99014,135035,135203,168
101,0,blank,0,313.52872,314.49322,135203,135372,169
101,0,blank,0,320.15408,323.2431,135372,135542,170
101,0,blank,0,320.68166,314.57072,135542,135713,171
101,21,0,142,279.87944,322.14898,135713,135885,172
101,21,0,142,262.4086,323.3923,135885,136056,171
101,0,blank,0,234.14904,317.87526,136056,136227,171
101,0,blank,0,229.8334,343.75314,136227,136397,170
101,0,blank,0,236.668816666667,339.249,136397,136595,198
101,0,blank,0,209.26538,284.18948,136595,136764,169
101,0,blank,0,202.18332,268.43436,136764,136931,167
101,0,blank,0,209.5141,281.670333333333,136931,137032,101
101,18,],109,311.11318,258.9683,137066,137239,173
101,18,char,106,354.33574,255.42146,137239,137409,170
101,0,blank,0,357.4719,239.5468,137409,137474,65
101,18,[,108,447.829966666667,253.1632,137540,137738,198
101,0,blank,0,465.025833333333,258.15335,137738,137932,194
101,18,],109,457.1841,250.0496,137932,137965,33
101,0,blank,0,293.28696,335.82494,137998,138166,168
101,0,blank,0,243.1411,330.9006,138166,138335,169
101,21,!=,141,221.97184,325.7336,138335,138504,169
101,21,i,139,192.19624,323.40488,138504,138672,168
101,21,!=,141,221.2608,321.9262,138672,138842,170
101,21,!=,141,226.34872,329.56366,138842,139015,173
101,20,num2,122,250.3149,310.6875,139015,139186,171
101,0,blank,0,249.58168,312.63772,139186,139356,170
101,0,blank,0,282.4462,322.44854,139356,139527,171
101,21,),143,284.21284,323.29848,139527,139698,171
101,0,blank,0,305.95848,320.98348,139698,139869,171
101,20,],125,319.95976,305.22038,139869,140037,168
101,0,blank,0,329.09886,322.11586,140037,140205,168
101,0,blank,0,336.20684,318.12036,140205,140375,170
101,0,blank,0,324.73384,337.3041,140375,140544,169
101,0,blank,0,317.732583333333,353.088483333333,140544,140743,199
101,23,i,149,204.32222,370.74998,140743,140910,167
101,23,[,148,196.95368,369.5412,140910,141077,167
101,23,i,149,206.18634,370.04274,141077,141245,168
101,0,blank,0,250.94006,370.47966,141245,141413,168
101,0,blank,0,283.38902,371.23304,141413,141581,168
101,23,++,154,299.1807,375.4152,141581,141748,167
101,0,blank,0,323.338916666667,373.053366666667,141748,141946,198
101,23,;,155,321.438616666667,364.42625,141946,142145,199
101,0,blank,0,315.52285,329.353466666667,142145,142342,197
101,0,blank,0,228.47676,335.33566,142342,142508,166
101,21,!=,141,229.77236,325.15102,142508,142674,166
101,21,i,139,188.74052,323.82324,142674,142843,169
101,21,i,139,192.14344,324.31156,142843,143013,170
101,21,),143,287.82284,314.2536,143013,143185,172
101,21,),143,284.46302,317.40056,143185,143355,170
101,0,blank,0,318.12198,318.15264,143355,143524,169
101,21,),143,289.768766666667,318.407583333333,143524,143721,197
101,21,!=,141,226.26676,324.91462,143721,143889,168
101,21,!=,141,229.63948,323.32824,143889,144058,169
101,21,0,142,251.0847,320.1418,144058,144225,167
101,21,0,142,279.21306,322.30966,144225,144391,166
101,0,blank,0,317.447583333333,324.478466666667,144391,144588,197
101,20,26,124,309.272,310.730266666667,144588,144787,199
101,0,blank,0,316.0576,321.8918,144787,144954,167
101,0,blank,0,334.323983333333,323.815666666667,144954,145151,197
101,0,blank,0,328.641133333333,323.158066666667,145151,145349,198
101,0,blank,0,332.0911,314.752433333333,145349,145548,199
101,21,),143,287.58198,326.54294,145548,145718,170
101,21,),143,284.6234,319.47498,145718,145888,170
101,0,blank,0,238.28524,324.02608,145888,146058,170
101,21,!=,141,222.58548,328.17082,146058,146226,168
101,21,0,142,261.57686,324.09152,146226,146395,169
101,21,0,142,271.15512,332.28174,146395,146569,174
101,23,-,151,242.79036,376.57432,146569,146739,170
101,0,blank,0,192.55844,390.2719,146739,146910,171
101,23,],153,284.84614,377.82176,146910,147078,168
101,0,blank,0,374.4438,374.86986,147078,147245,167
101,0,blank,0,362.95626,376.00034,147245,147413,168
101,0,blank,0,361.00235,374.600816666667,147413,147610,197
101,0,blank,0,337.479633333333,384.505783333333,147610,147801,191
101,0,blank,0,255.481033333333,393.712766666667,147801,147992,191
101,0,blank,0,226.749,377.98045,147992,148120,128
101,0,blank,0,204.0791,378.063666666667,148183,148380,197
101,23,a,152,268.04285,374.877166666667,148380,148579,199
101,23,],153,290.8164,365.604633333333,148579,148776,197
101,0,blank,0,340.2298,369.734183333333,148776,148975,199
101,0,blank,0,327.63076,367.49758,148975,149143,168
101,23,;,155,321.714816666667,373.330283333333,149143,149340,197
101,0,blank,0,251.496483333333,372.192833333333,149340,149534,194
101,0,blank,0,233.349383333333,377.22685,149534,149723,189
101,23,],153,215.311183333333,370.409,149723,149915,192
101,23,i,149,205.59685,372.740333333333,149915,150107,192
101,23,a,152,266.547333333333,363.22925,150107,150301,194
101,23,a,152,260.773033333333,368.199833333333,150301,150499,198
101,23,a,152,257.22066,369.37318,150499,150666,167
101,23,a,152,262.41598,369.23016,150666,150834,168
101,23,a,152,258.75322,375.17316,150834,151002,168
101,23,++,154,299.12668,367.26124,151002,151171,169
101,0,blank,0,323.05734,380.48802,151171,151340,169
101,23,;,155,321.89274,368.37914,151340,151506,166
101,0,blank,0,326.04768,370.6675,151506,151674,168
101,23,++,154,298.44262,374.4217,151674,151840,166
101,23,a,152,260.96914,371.57928,151840,152009,169
101,23,a,152,258.89776,373.25632,152009,152177,168
101,23,],153,216.16422,372.44486,152177,152348,171
101,23,i,149,204.36858,368.54056,152348,152515,167
101,23,[,148,196.69068,368.34058,152515,152682,167
101,23,[,148,195.76655,363.7877,152682,152748,66
101,0,blank,0,372.33085,366.01635,152781,152949,168
101,0,blank,0,342.1934,339.9085,153196,153221,25
101,0,blank,0,346.5349,356.607,153323,153348,25
101,0,blank,0,-350,-105,153385,153503,118
101,0,blank,0,331.9182,361.5737,153555,153598,43
101,0,blank,0,354.7759,367.51985,153669,153860,191
101,0,blank,0,346.9845,367.62298,153860,154027,167
101,0,blank,0,346.90324,362.67454,154027,154196,169
101,0,blank,0,226.2378,382.035983333333,154230,154426,196
101,0,blank,0,212.74655,380.2117,154426,154625,199
101,0,blank,0,192.2062,378.5107,154625,154794,169
101,0,blank,0,195.45868,382.35068,154794,154962,168
101,0,blank,0,195.39316,381.17176,154962,155129,167
101,23,[,148,197.10964,373.82768,155129,155299,170
101,0,blank,0,193.49332,378.85092,155299,155470,171
101,23,],153,221.3944,376.84666,155470,155641,171
101,23,a,152,259.86424,370.78396,155641,155812,171
101,23,a,152,273.4875,377.6974,155812,155983,171
101,23,;,155,316.8424,371.91782,155983,156154,171
101,23,;,155,317.00096,375.21364,156154,156327,173
101,0,blank,0,327.29266,369.64304,156327,156499,172
101,23,++,154,311.16252,370.11662,156499,156673,174
101,0,blank,0,255.9553,366.42366,156673,156842,169
101,23,a,152,257.24676,374.72558,156842,157013,171
101,0,blank,0,253.66484,373.54042,157013,157182,169
101,23,++,154,306.40524,370.8078,157182,157352,170
101,23,++,154,302.15552,364.74358,157352,157522,170
101,23,-,151,239.5817,374.79085,157522,157721,199
101,0,blank,0,243.7467,374.1383,157721,157889,168
101,23,-,151,241.63438,372.60656,157889,158055,166
101,23,a,152,257.98478,372.30778,158055,158223,168
101,0,blank,0,275.832433333333,382.394533333333,158223,158422,199
101,23,a,152,262.28582,363.11892,158422,158593,171
101,0,blank,0,245.34828,347.03246,158593,158763,170
101,0,blank,0,241.67426,343.26122,158763,158932,169
101,0,blank,0,243.25518,348.9677,158932,159103,171
101,0,blank,0,247.35244,341.8386,159103,159273,170
101,0,blank,0,255.46522,366.68524,159273,159443,170
101,0,blank,0,253.44364,364.11136,159443,159611,168
101,23,],153,219.40614,372.84002,159611,159780,169
101,0,blank,0,250.16846,370.55428,159780,159947,167
101,0,blank,0,215.81236,378.53758,159947,160114,167
101,23,[,148,202.3191,372.95438,160114,160290,176
101,23,],153,220.0844,365.38216,160290,160471,181
101,0,blank,0,247.70244,346.22888,160471,160642,171
101,0,blank,0,250.94032,341.38272,160642,160809,167
101,0,blank,0,269.582133333333,350.303483333333,160809,161006,197
101,0,blank,0,345.4236,388.9081,161006,161039,33
101,0,blank,0,319.2916,384.576716666667,161105,161302,197
101,0,blank,0,335.42646,373.55472,161302,161471,169
101,0,blank,0,292.109933333333,374.385383333333,161471,161670,199
101,23,a,152,258.29828,372.78246,161670,161839,169
101,0,blank,0,222.359,376.24628,161839,162008,169
101,23,],153,217.37198,372.37114,162008,162175,167
101,0,blank,0,200.25548,381.27046,162175,162343,168
101,0,blank,0,223.1054,378.99032,162343,162512,169
101,0,blank,0,240.669583333333,383.711866666667,162512,162711,199
101,0,blank,0,278.03064,380.16384,162711,162879,168
101,0,blank,0,325.16982,379.6219,162879,163048,169
101,0,blank,0,352.68918,381.83298,163048,163217,169
101,0,blank,0,358.44096,383.97674,163217,163389,172
101,0,blank,0,323.64422,380.48026,163389,163562,173
101,0,blank,0,314.8753,385.57635,163562,163631,69
101,0,blank,0,-350,-105,163665,163779,114
101,23,a,152,256.720616666667,366.56805,163938,164132,194
101,23,a,152,256.36862,369.90954,164132,164302,170
101,0,blank,0,207.87502,388.34512,164302,164475,173
101,0,blank,0,210.23638,384.09692,164475,164647,172
101,0,blank,0,193.20606,382.72648,164647,164813,166
101,23,],153,214.0032,370.160725,164813,164963,150
101,0,blank,0,252.7655,403.09828,164995,165162,167
101,23,a,152,271.647183333333,376.328466666667,165162,165357,195
101,23,++,154,300.588383333333,372.082033333333,165357,165552,195
101,0,blank,0,326.196166666667,377.6293,165552,165749,197
101,0,blank,0,205.3853,420.612083333333,165781,165976,195
101,0,blank,0,182.8997,417.97226,165976,166143,167
101,0,blank,0,170.8807,435.54538,166143,166309,166
101,27,array2,166,160.85272,446.09398,166309,166476,167
101,27,array2,166,151.2982,454.91754,166476,166647,171
101,27,array2,166,154.09434,448.33842,166647,166817,170
101,27,array2,166,158.63088,454.61874,166817,166988,171
101,27,[,167,175.22096,456.92058,166988,167158,170
101,27,array2,166,172.6821,455.53178,167158,167329,171
101,27,array2,166,171.04304,453.88002,167329,167498,169
101,27,array2,166,166.85556,450.42842,167498,167669,171
101,27,array2,166,171.72954,452.9005,167669,167841,172
101,27,array2,166,167.6117,451.30364,167841,168013,172
101,0,blank,0,169.723,442.69258,168013,168185,172
101,0,blank,0,150.37468,419.38198,168185,168356,171
101,0,blank,0,171.25758,409.15566,168356,168528,172
101,0,blank,0,172.26102,397.69506,168528,168700,172
101,0,blank,0,166.31546,356.09042,168700,168871,171
101,0,blank,0,159.6903,350.4133,168871,168939,68
101,27,array2,166,167.10776,445.15162,168973,169145,172
101,0,blank,0,166.82344,444.5697,169145,169321,176
101,0,blank,0,179.80924,470.96012,169321,169491,170
101,27,==,170,214.47592,457.58428,169491,169661,170
101,0,blank,0,237.541,419.64396,169661,169829,168
101,0,blank,0,221.25032,351.8592,169829,169998,169
101,0,blank,0,234.40156,326.29416,169998,170166,168
101,21,0,142,248.37886,326.11144,170166,170336,170
101,21,0,142,278.29682,321.51908,170336,170505,169
101,0,blank,0,343.00666,325.06212,170505,170675,170
101,0,blank,0,355.3949,348.14835,170675,170874,199
101,0,blank,0,361.64444,373.5767,170874,171042,168
101,0,blank,0,362.7082,370.64108,171042,171208,166
101,0,blank,0,325.18596,381.84214,171208,171375,167
101,0,blank,0,189.4932,399.16212,171375,171543,168
101,0,blank,0,190.34958,402.0521,171543,171712,169
101,0,blank,0,196.7326,468.38034,171712,171879,167
101,0,blank,0,205.5882,478.32192,171879,172046,167
101,0,blank,0,207.3338,471.38006,172046,172215,169
101,27,0,171,270.1695,461.78106,172215,172387,172
101,0,blank,0,281.63428,459.8128,172387,172555,168
101,27,0,171,271.77576,465.80784,172555,172724,169
101,0,blank,0,240.686,454.96278,172724,172894,170
101,0,blank,0,235.60576,459.88506,172894,173065,171
101,27,==,170,215.32036,462.62712,173065,173239,174
101,27,==,170,217.52765,465.3986,173239,173334,95
101,0,blank,0,224.332,467.0322,173334,173463,129
101,0,blank,0,240.106,477.2038,173463,173574,111
101,0,blank,0,273.963733333333,473.9914,173574,173750,176
101,0,blank,0,293.425483333333,469.733983333333,173750,173949,199
101,0,blank,0,328.42748,469.8189,173949,174117,168
101,0,blank,0,332.84465,466.6086,174117,174316,199
101,0,blank,0,332.716966666667,469.339466666667,174316,174514,198
101,0,blank,0,325.5873,469.72392,174514,174682,168
101,0,blank,0,313.6736,464.12578,174682,174848,166
101,27,0,171,266.85502,463.0192,174848,175016,168
101,0,blank,0,241.71462,460.92486,175016,175185,169
101,0,blank,0,233.032516666667,469.323416666667,175185,175384,199
101,27,0,171,258.67278,460.64418,175384,175550,166
101,27,0,171,266.27066,462.33118,175550,175718,168
101,0,blank,0,307.72892,460.50992,175718,175888,170
101,0,blank,0,320.17442,465.25432,175888,176057,169
101,27,0,171,266.53182,460.28278,176057,176226,169
101,27,0,171,259.9435,462.3269,176226,176399,173
101,0,blank,0,260.022733333333,469.297166666667,176399,176501,102
101,21,0,142,268.15736,323.1718,176535,176704,169
101,0,blank,0,282.57158,327.62396,176704,176872,168
101,0,blank,0,292.83336,333.62516,176872,177040,168
101,0,blank,0,296.56254,482.4394,177074,177242,168
101,27,==,170,222.18788,461.03266,177242,177411,169
101,27,array2,166,165.79072,465.97202,177411,177581,170
101,0,blank,0,151.15078,477.01452,177581,177754,173
101,0,blank,0,144.22945,468.287,177754,177929,175
101,0,blank,0,153.00574,475.40542,177929,178100,171
101,0,blank,0,270.06818,475.0117,178134,178304,170
101,0,blank,0,282.91546,490.6858,178304,178473,169
101,0,blank,0,310.29218,514.05054,178473,178641,168
101,0,blank,0,316.75034,515.86252,178641,178808,167
101,0,blank,0,335.690366666667,510.574916666667,178808,179006,198
101,0,blank,0,191.13322,532.95052,179039,179212,173
101,0,blank,0,217.27094,512.20002,179212,179387,175
101,0,blank,0,265.79704,475.34644,179387,179563,176
101,0,blank,0,305.65206,474.74212,179563,179733,170
101,0,blank,0,129.82346,470.9991,179766,179941,175
101,0,blank,0,80.27772,478.12268,179941,180109,168
101,0,blank,0,69.5136,474.8208,180109,180180,71
101,0,blank,0,-350,-105,180214,180405,191
101,0,blank,0,-350,-105,180405,180594,189
101,0,blank,0,-350,-105,180594,180776,182
101,0,blank,0,-350,-105,180776,180939,163
101,0,blank,0,-350,-105,180939,181073,134
101,0,blank,0,-350,-105,181073,181198,125
101,0,blank,0,-350,-105,181198,181351,153
101,0,blank,0,-350,-105,181351,181525,174
101,0,blank,0,-350,-105,181525,181699,174
101,0,blank,0,-350,-105,181699,181891,192
101,0,blank,0,-350,-105,181891,182081,190
101,0,blank,0,-350,-105,182081,182208,127
101,0,blank,0,-350,-105,182208,182362,154
101,0,blank,0,-350,-105,182362,182504,142
101,0,blank,0,-350,-105,182504,182677,173
101,0,blank,0,-350,-105,182677,182838,161
101,0,blank,0,-350,-105,182838,183006,168
101,0,blank,0,-350,-105,183006,183197,191
101,0,blank,0,-350,-105,183197,183374,177
101,0,blank,0,-350,-105,183374,183560,186
101,0,blank,0,-350,-105,183560,183736,176
101,0,blank,0,-350,-105,183736,183922,186
101,0,blank,0,-350,-105,183922,184110,188
101,0,blank,0,-350,-105,184110,184284,174
101,0,blank,0,-350,-105,184284,184473,189
101,0,blank,0,-350,-105,184473,184651,178
101,0,blank,0,-350,-105,184651,184825,174
101,0,blank,0,-350,-105,184825,185012,187
101,0,blank,0,-350,-105,185012,185129,117
101,0,blank,0,-350,-105,185129,185293,164
101,0,blank,0,-350,-105,185293,185441,148
101,0,blank,0,-350,-105,185441,185640,199
101,0,blank,0,-350,-105,185640,185837,197
101,0,blank,0,-350,-105,185837,185990,153
101,0,blank,0,-350,-105,185990,186129,139
101,0,blank,0,-350,-105,186129,186245,116
101,0,blank,0,-350,-105,186245,186435,190
101,0,blank,0,-350,-105,186435,186612,177
101,0,blank,0,-350,-105,186612,186789,177
101,0,blank,0,-350,-105,186789,186939,150
101,0,blank,0,-350,-105,186939,187115,176
101,0,blank,0,-350,-105,187115,187295,180
101,0,blank,0,-350,-105,187295,187476,181
101,0,blank,0,-350,-105,187476,187657,181
101,0,blank,0,-350,-105,187657,187842,185
101,0,blank,0,-350,-105,187842,188026,184
101,0,blank,0,-350,-105,188026,188213,187
101,0,blank,0,-350,-105,188213,188395,182
101,0,blank,0,-350,-105,188395,188594,199
101,0,blank,0,-350,-105,188594,188760,166
101,0,blank,0,-350,-105,188760,188944,184
101,0,blank,0,-350,-105,188944,189121,177
101,0,blank,0,-350,-105,189121,189302,181
101,0,blank,0,-350,-105,189302,189493,191
101,0,blank,0,-350,-105,189493,189625,132
101,0,blank,0,-350,-105,189625,189803,178
101,0,blank,0,-350,-105,189803,189969,166
101,0,blank,0,-350,-105,189969,190150,181
101,0,blank,0,-350,-105,190150,190327,177
101,0,blank,0,-350,-105,190327,190503,176
101,0,blank,0,-350,-105,190503,190680,177
101,0,blank,0,-350,-105,190680,190704,24
101,0,blank,0,-350,-105,190704,190938,234
101,0,blank,0,235.5834,677.4689,191222,191327,105
101,0,blank,0,-350,-105,191428,191608,180
101,0,blank,0,-350,-105,191608,191765,157
101,0,blank,0,-350,-105,191765,191922,157
101,0,blank,0,-350,-105,191922,192115,193
101,0,blank,0,-350,-105,192115,192297,182
101,0,blank,0,-350,-105,192297,192420,123
101,0,blank,0,-350,-105,192420,192505,85
101,0,blank,0,-350,-105,192505,192639,134
101,0,blank,0,-350,-105,192639,192818,179
101,0,blank,0,-350,-105,192818,192997,179
101,0,blank,0,-350,-105,192997,193170,173
101,0,blank,0,-350,-105,193170,193277,107
101,0,blank,0,-350,-105,193277,193396,119
101,0,blank,0,-350,-105,193396,193548,152
101,0,blank,0,-350,-105,193548,193627,79
101,0,blank,0,-350,-105,193627,193819,192
101,0,blank,0,-350,-105,193819,193906,87
101,0,blank,0,-350,-105,193906,194080,174
101,0,blank,0,-350,-105,194080,194268,188
101,0,blank,0,-350,-105,194268,194441,173
101,0,blank,0,-350,-105,194441,194610,169
101,0,blank,0,-350,-105,194610,194783,173
101,0,blank,0,-350,-105,194783,194973,190
101,0,blank,0,-350,-105,194973,195091,118
101,0,blank,0,-350,-105,195091,195275,184
101,0,blank,0,-350,-105,195275,195471,196
101,0,blank,0,-350,-105,195471,195578,107
101,29,a,181,251.1271,501.1218,195596,195626,30
101,0,blank,0,-350,-105,195755,195954,199
101,0,blank,0,-350,-105,195954,196127,173
101,0,blank,0,-350,-105,196127,196321,194
101,0,blank,0,-350,-105,196321,196517,196
101,0,blank,0,-350,-105,196517,196689,172
101,0,blank,0,-350,-105,196689,196860,171
101,0,blank,0,-350,-105,196860,197056,196
101,0,blank,0,-350,-105,197056,197164,108
101,0,blank,0,-350,-105,197164,197356,192
101,0,blank,0,-350,-105,197356,197548,192
101,0,blank,0,-350,-105,197548,197745,197
101,0,blank,0,-350,-105,197745,197924,179
101,0,blank,0,-350,-105,197924,198092,168
101,0,blank,0,-350,-105,198092,198288,196
101,0,blank,0,-350,-105,198288,198435,147
101,0,blank,0,-350,-105,198435,198605,170
101,0,blank,0,-350,-105,198605,198729,124
101,0,blank,0,-350,-105,198729,198917,188
101,0,blank,0,-350,-105,198917,198989,72
101,0,blank,0,110.985683333333,485.117716666667,199009,199207,198
101,29,num2,174,116.643583333333,490.637266666667,199207,199406,199
101,0,blank,0,122.200316666667,487.053333333333,199406,199602,196
101,0,blank,0,98.76882,481.1991,199602,199776,174
101,0,blank,0,146.93822,480.65974,199776,199947,171
101,0,blank,0,154.81668,485.19612,199947,200128,181
101,0,blank,0,169.37188,487.05276,200128,200311,183
101,0,blank,0,170.2689,484.02486,200311,200482,171
101,0,blank,0,173.61266,487.16304,200482,200662,180
101,0,blank,0,162.18224,489.09248,200662,200848,186
101,0,blank,0,164.01772,489.63128,200848,201027,179
101,0,blank,0,175.18594,484.67416,201027,201207,180
101,27,array2,166,163.46514,465.36188,201207,201375,168
101,27,array2,166,148.37206,453.62564,201375,201569,194
101,0,blank,0,156.17712,478.3726,201569,201753,184
101,0,blank,0,159.8233,479.30806,201753,201924,171
101,0,blank,0,191.52342,482.4411,201924,202093,169
101,0,blank,0,228.84885,478.904233333333,202093,202288,195
101,0,blank,0,250.20206,472.5857,202288,202455,167
101,0,blank,0,150.799916666667,403.168966666667,202455,202650,195
101,0,blank,0,138.19232,344.3549,202650,202816,166
101,0,blank,0,162.12102,349.55514,202816,202990,174
101,0,blank,0,161.8358,335.5716,202990,203027,37
101,0,blank,0,246.4154,481.764,203059,203257,198
101,0,blank,0,263.62725,473.4775,203257,203453,196
101,0,blank,0,254.9926,473.7965,203453,203648,195
101,0,blank,0,240.764016666667,409.2836,203648,203846,198
101,0,blank,0,235.10845,339.287,203846,204041,195
101,0,blank,0,270.540933333333,341.312583333333,204041,204234,193
101,27,0,171,263.54355,455.336766666667,204234,204432,198
101,29,array2,176,150.893133333333,500.876183333333,204432,204627,195
101,29,num2,174,92.7607333333333,501.037233333333,204627,204823,196
101,29,num2,174,95.1439333333333,506.757516666667,204823,205016,193
101,29,num2,174,89.4295,500.749,205016,205048,32
101,0,blank,0,133.6805,396.495783333333,205081,205273,192
101,24,++,157,110.2235,388.6293,205273,205371,98
101,27,array2,166,129.5257,461.6091,205436,205634,198
101,0,blank,0,94.3277666666667,512.65265,205634,205827,193
101,0,blank,0,53.1711166666667,529.971716666667,205827,206020,193
101,0,blank,0,56.0705333333333,490.937183333333,206020,206212,192
101,0,blank,0,69.16094,423.2557,206283,206470,187
101,0,blank,0,73.5778333333333,417.5059,206470,206608,138
101,29,num2,174,111.5941,502.9171,206640,206677,37
101,0,blank,0,188.2954,541.2757,206806,206873,67
101,0,blank,0,126.357783333333,535.862516666667,206904,207099,195
101,0,blank,0,75.5258,541.829733333333,207099,207291,192
101,0,blank,0,63.33632,540.64636,207291,207459,168
101,0,blank,0,92.2145166666667,544.313166666667,207459,207653,194
101,0,blank,0,97.7627,543.0511,207653,207685,32
101,0,blank,0,103.44565,449.124866666667,207718,207917,199
101,0,blank,0,153.74136,443.09422,207917,208083,166
101,0,blank,0,161.758,441.03626,208083,208252,169
101,0,blank,0,164.7299,433.8818,208252,208321,69
101,0,blank,0,125.513783333333,550.817766666667,208354,208552,198
101,0,blank,0,193.74052,534.37752,208552,208720,168
101,0,blank,0,192.34045,536.150533333333,208720,208912,192
101,0,blank,0,176.8296,550.4896,208912,209104,192
101,0,blank,0,183.157833333333,542.201466666667,209104,209296,192
101,0,blank,0,189.756033333333,541.0627,209296,209489,193
101,0,blank,0,204.4889,551.8169,209489,209521,32
101,0,blank,0,262.9548,549.1292,209554,209586,32
101,0,blank,0,224.566583333333,537.888066666667,209741,209932,191
101,0,blank,0,202.612866666667,544.903483333333,209932,210128,196
101,0,blank,0,217.25125,552.44575,210128,210324,196
101,32,26,197,218.2101,561.845283333333,210324,210522,198
101,0,blank,0,225.11885,578.38845,210522,210720,198
101,0,blank,0,162.377983333333,594.88525,210720,210918,198
101,34,num1,205,144.67472,600.7962,210918,211085,167
101,0,blank,0,140.123916666667,596.649683333333,211085,211284,199
101,0,blank,0,128.67344,595.63816,211284,211451,167
101,0,blank,0,140.747433333333,587.7771,211451,211649,198
101,0,blank,0,160.9775,585.910866666667,211649,211846,197
101,0,blank,0,161.434066666667,589.575933333333,211846,211944,98
101,32,++,200,257.931433333333,569.38095,211977,212175,198
101,32,++,200,254.767066666667,571.37155,212175,212372,197
101,0,blank,0,167.634983333333,588.048516666667,212372,212569,197
101,0,blank,0,177.01196,589.88532,212569,212736,167
101,0,blank,0,175.99274,586.68082,212736,212904,168
101,0,blank,0,183.4715,594.653066666667,212904,213100,196
101,34,],213,184.14755,601.0047,213100,213166,66
101,0,blank,0,182.4104,598.862,213234,213268,34
101,0,blank,0,250.18724,577.80412,213301,213471,170
101,0,blank,0,271.2852,591.83568,213471,213639,168
101,0,blank,0,238.51946,571.03206,213639,213833,194
101,0,blank,0,264.569133333333,590.13975,213833,214029,196
101,32,++,200,255.4102,573.5091,214029,214083,54
101,0,blank,0,-350,-105,214184,214270,86
101,0,blank,0,253.008075,593.306275,214411,214583,172
101,0,blank,0,285.04586,598.98948,214583,214752,169
101,0,blank,0,267.22195,593.625466666667,214752,214951,199
101,0,blank,0,231.5083,609.3253,214951,215119,168
101,34,],213,190.16266,601.58116,215119,215310,191
101,35,;,217,207.229316666667,629.845483333333,215310,215507,197
101,0,blank,0,259.8829,667.57825,215507,215636,129
101,0,blank,0,208.30644,588.2661,215668,215859,191
101,0,blank,0,179.297,564.6523,215859,215926,67
101,0,blank,0,202.138983333333,607.09915,216202,216390,188
101,0,blank,0,196.47614,583.3561,216390,216586,196
101,32,0,193,139.39275,574.527316666667,216586,216775,189
101,0,blank,0,136.896616666667,582.4237,216775,216973,198
101,0,blank,0,129.8375,554.383916666667,216973,217171,198
101,32,i,199,94.166975,558.84115,217171,217302,131
101,0,blank,0,-350,-105,217366,217498,132
101,0,blank,0,98.07192,592.56524,217610,217790,180
101,34,num1,205,134.549316666667,613.760066666667,217790,217983,193
101,0,blank,0,152.9224,661.553266666667,218014,218204,190
101,35,return,215,138.30825,637.57725,218204,218266,62
101,0,blank,0,211.042183333333,658.593683333333,218297,218486,189
101,0,blank,0,211.5403,682.2236,218486,218516,30
101,0,blank,0,-350,-105,218548,218579,31
101,34,],213,188.3501,608.1865,218604,218630,26
101,0,blank,0,185.3273,639.13744,218698,218842,144
101,0,blank,0,-350,-105,218905,218935,30
101,34,[,211,171.3803,616.3153,218960,218987,27
101,0,blank,0,193.606,619.7534,219060,219085,25
101,0,blank,0,101.790983333333,583.235116666667,219124,219319,195
101,0,blank,0,69.8803,552.766933333333,219319,219516,197
101,0,blank,0,73.19338,551.73478,219516,219683,167
101,0,blank,0,66.5907,553.19636,219683,219850,167
101,0,blank,0,120.53805,511.844875,219850,219981,131
101,0,blank,0,151.93504,538.34088,220077,220246,169
101,0,blank,0,130.308533333333,545.21475,220246,220442,196
101,0,blank,0,160.2845,546.6825,220508,220539,31
101,0,blank,0,134.4287,543.96055,220603,220739,136
101,0,blank,0,166.86092,548.7832,220804,220971,167
101,0,blank,0,140.13325,543.804066666667,221065,221260,195
101,0,blank,0,183.3092,546.895566666667,221260,221387,127
101,0,blank,0,188.7402,511.05775,221452,221516,64
101,0,blank,0,169.52774,534.46708,221608,221769,161
101,0,blank,0,177.78245,566.36525,221769,221871,102
101,0,blank,0,198.87774,545.66364,222000,222173,173
101,0,blank,0,189.2294,533.17496,222173,222346,173
101,0,blank,0,187.51926,536.8805,222346,222514,168
101,0,blank,0,204.642933333333,537.038083333333,222514,222710,196
101,0,blank,0,196.98872,535.2776,222710,222880,170
101,0,blank,0,191.18415,531.9045,222880,222945,65
101,0,blank,0,199.88502,553.17676,223011,223184,173
101,32,26,197,222.51374,561.73206,223184,223356,172
101,0,blank,0,225.02526,553.62436,223356,223524,168
101,0,blank,0,156.23792,586.14272,223524,223694,170
101,0,blank,0,154.1897,592.66964,223694,223864,170
101,32,;,198,226.07312,555.0007,223864,224033,169
101,0,blank,0,182.298366666667,574.794016666667,224033,224230,197
101,0,blank,0,147.32378,586.3484,224230,224397,167
101,0,blank,0,174.272433333333,577.610166666667,224397,224498,101
101,0,blank,0,131.94916,579.32196,224532,224695,163
101,0,blank,0,107.94925,586.289475,224695,224871,176
101,0,blank,0,116.80116,596.029,224871,225044,173
101,0,blank,0,125.102866666667,585.2853,225044,225240,196
101,0,blank,0,201.6544,540.5052,225240,225274,34
101,0,blank,0,138.20722,593.7573,225306,225475,169
101,0,blank,0,145.17594,598.86074,225475,225640,165
101,0,blank,0,148.037783333333,590.408883333333,225640,225839,199
101,0,blank,0,169.923966666667,594.915333333333,225839,225937,98
101,34,num1,205,160.4483,599.10405,226003,226068,65
101,34,num2,210,233.0116,617.3806,226101,226134,33
101,34,),214,309.0976,617.554016666667,226166,226358,192
101,0,blank,0,294.360483333333,574.5259,226358,226557,199
101,34,num2,210,256.794583333333,599.86825,226557,226754,197
101,34,i,212,176.5912,599.86332,226754,226925,171
101,0,blank,0,195.8978,581.87798,226925,227102,177
101,0,blank,0,161.1258,587.93004,227102,227273,171
101,0,blank,0,109.241866666667,590.1962,227273,227471,198
101,0,blank,0,190.978633333333,592.032583333333,227505,227699,194
101,34,num1,205,138.44718,599.8472,227699,227866,167
101,0,blank,0,138.52456,590.05006,227866,228039,173
101,34,num1,205,133.53226,609.3695,228039,228214,175
101,34,num1,205,132.85642,612.24946,228214,228391,177
101,34,i,212,174.45508,605.2445,228391,228564,173
101,34,!=,209,218.77382,604.35018,228564,228732,168
101,0,blank,0,221.8668,596.76945,228732,228798,66
101,29,array2,176,133.7204,505.48294,228831,228999,168
101,29,num2,174,104.35398,506.18366,228999,229167,168
101,29,num2,174,83.8292333333333,497.648383333333,229167,229365,198
101,0,blank,0,97.4980666666667,456.545316666667,229365,229560,195
101,0,blank,0,95.4579166666667,378.684566666667,229560,229756,196
101,23,num1,145,93.5242333333334,368.97495,229756,229950,194
101,0,blank,0,96.4527666666667,354.62075,229950,230146,196
101,0,blank,0,101.733016666667,320.499816666667,230146,230339,193
101,20,[,123,132.517833333333,306.47525,230339,230535,196
101,20,=,132,182.1108,299.896683333333,230535,230727,192
101,20,26,124,311.96075,298.990933333333,230727,230918,191
101,0,blank,0,329.519016666667,298.982433333333,230918,231111,193
101,0,blank,0,271.783833333333,286.754833333333,231111,231305,194
101,0,blank,0,251.98555,289.45325,231305,231496,191
101,0,blank,0,256.101816666667,288.255333333333,231496,231688,192
101,0,blank,0,264.230316666667,290.186933333333,231688,231880,192
101,0,blank,0,266.243233333333,283.573266666667,231880,232072,192
101,0,blank,0,305.166283333333,288.3019,232072,232264,192
101,0,blank,0,379.564916666667,287.236466666667,232264,232452,188
101,0,blank,0,329.34638,275.26624,232452,232615,163
101,0,blank,0,282.29124,270.2346,232615,232785,170
101,20,0,133,371.778733333333,293.20705,232785,232976,191
101,0,blank,0,376.706866666667,287.357583333333,232976,233167,191
101,0,blank,0,384.773666666667,282.131316666667,233167,233359,192
101,0,blank,0,384.7753,281.3991,233359,233550,191
101,0,blank,0,393.8918,293.62995,233550,233617,67
101,0,blank,0,250.58204,284.07146,233650,233817,167
101,0,blank,0,240.1599,274.28942,233817,233985,168
101,0,blank,0,114.27612,285.42114,233985,234156,171
101,0,blank,0,127.549233333333,286.467566666667,234156,234260,104
101,0,blank,0,-350,-105,234297,234488,191
101,0,blank,0,-350,-105,234488,234541,53
101,0,blank,0,-350,-105,234541,234694,153
101,0,blank,0,-350,-105,234694,234859,165
101,0,blank,0,-350,-105,234859,235024,165
101,0,blank,0,-350,-105,235024,235194,170
101,0,blank,0,-350,-105,235194,235378,184
101,0,blank,0,-350,-105,235378,235518,140
101,0,blank,0,-350,-105,235518,235906,388
101,0,blank,0,-350,-105,235906,236100,194
101,0,blank,0,-350,-105,236100,236242,142
101,0,blank,0,-350,-105,236242,236435,193
101,0,blank,0,-350,-105,236435,236625,190
101,0,blank,0,-350,-105,236625,236813,188
101,0,blank,0,-350,-105,236813,237003,190
101,0,blank,0,-350,-105,237003,237180,177
101,0,blank,0,-350,-105,237180,237364,184
101,0,blank,0,-350,-105,237364,237551,187
101,0,blank,0,-350,-105,237551,237722,171
101,0,blank,0,-350,-105,237722,237917,195
101,0,blank,0,-350,-105,237917,238100,183
101,0,blank,0,-350,-105,238100,238294,194
101,0,blank,0,-350,-105,238294,238431,137
101,0,blank,0,-350,-105,238431,238612,181
101,0,blank,0,-350,-105,238612,238763,151
101,0,blank,0,-350,-105,238763,238923,160
101,0,blank,0,-350,-105,238923,239086,163
101,0,blank,0,-350,-105,239086,239218,132
101,0,blank,0,-350,-105,239218,239381,163
101,0,blank,0,-350,-105,239381,239522,141
101,0,blank,0,-350,-105,239522,239710,188
101,0,blank,0,-350,-105,239710,239831,121
101,0,blank,0,-350,-105,239831,240019,188
101,0,blank,0,-350,-105,240019,240176,157
101,0,blank,0,-350,-105,240176,240342,166
101,0,blank,0,-350,-105,240342,240525,183
101,0,blank,0,-350,-105,240525,240719,194
101,0,blank,0,-350,-105,240719,240868,149
101,0,blank,0,-350,-105,240868,241023,155
101,0,blank,0,-350,-105,241023,241111,88
101,0,blank,0,-350,-105,241111,241243,132
101,0,blank,0,-350,-105,241243,241422,179
101,0,blank,0,-350,-105,241422,241541,119
101,0,blank,0,-350,-105,241541,241728,187
101,20,[,123,287.233816666667,310.4027,241759,241946,187
101,20,[,123,289.475933333333,301.3923,241946,242142,196
101,20,0,133,366.27266,304.03716,242142,242310,168
101,20,},129,377.4395,299.79574,242310,242481,171
101,20,0,133,365.50866,302.69644,242481,242659,178
101,20,{,127,358.07258,305.09188,242659,242835,176
101,20,{,127,355.34638,301.53114,242835,243012,177
101,20,{,127,359.11744,298.80612,243012,243191,179
101,20,0,133,364.80002,297.23754,243191,243369,178
101,20,0,133,363.08434,297.09394,243369,243548,179
101,20,{,127,362.04926,292.67652,243548,243731,183
101,0,blank,0,349.22096,291.04298,243731,243925,194
101,20,=,132,341.5734,292.9007,243925,244117,192
101,0,blank,0,354.24388,290.82538,244117,244309,192
101,20,{,127,356.1959,296.49524,244309,244495,186
101,0,blank,0,345.2113,296.93766,244495,244682,187
101,20,{,127,353.3051,293.24556,244682,244871,189
101,20,{,127,353.80764,298.01296,244871,245052,181
101,0,blank,0,330.7438,298.63876,245052,245235,183
101,20,26,124,294.33774,308.09438,245235,245426,191
101,0,blank,0,283.961925,286.79875,245426,245591,165
101,0,blank,0,362.97685,289.1334,245591,245756,165
101,20,0,133,373.248,292.339675,245756,245928,172
101,0,blank,0,389.33455,291.39085,245928,246103,175
101,0,blank,0,383.670625,291.8652,246103,246272,169
101,20,{,127,357.85904,293.43498,246272,246457,185
101,0,blank,0,407.36814,289.71162,246457,246639,182
101,0,blank,0,363.75274,289.20418,246639,246816,177
101,0,blank,0,340.82802,290.17126,246816,246999,183
101,20,num2,122,256.2495,298.9169,246999,247035,36
101,0,blank,0,79.40414,305.79182,247071,247249,178
101,20,int,112,54.08986,309.01148,247249,247428,179
101,21,while,135,82.66858,319.33692,247428,247606,178
101,21,array1,137,119.56842,326.1743,247606,247781,175
101,21,array1,137,146.5506,323.64098,247781,247959,178
101,21,array1,137,144.81614,323.51758,247959,248137,178
101,21,[,138,181.56236,323.87764,248137,248314,177
101,21,!=,141,223.74764,321.8143,248314,248487,173
101,21,!=,141,227.67186,320.6099,248487,248665,178
101,21,!=,141,230.8675,316.4473,248665,248700,35
101,23,num1,145,96.834,366.93986,248735,248918,183
101,23,num1,145,95.89222,366.2912,248918,249098,180
101,23,num1,145,84.52684,374.9863,249098,249276,178
101,0,blank,0,81.08362,383.18472,249276,249452,176
101,27,(,165,105.6885,448.21002,249452,249630,178
101,27,array2,166,117.6571,457.9713,249630,249805,175
101,27,array2,166,149.35834,451.22468,249805,249978,173
101,0,blank,0,201.38792,443.3235,249978,250154,176
101,0,blank,0,228.2127,443.77398,250154,250331,177
101,27,i,168,188.31128,447.24586,250331,250508,177
101,27,i,168,191.79588,448.9882,250508,250687,179
101,0,blank,0,204.28486,409.89348,250687,250866,179
101,23,i,149,208.5164,361.79848,250866,251042,176
101,0,blank,0,224.87802,355.44682,251042,251222,180
101,0,blank,0,173.45558,336.91754,251222,251403,181
101,21,[,138,176.07534,318.28568,251403,251580,177
101,21,],140,197.746966666667,325.383766666667,251580,251685,105
101,29,[,177,201.70832,497.17298,251720,251898,178
101,0,blank,0,202.00094,474.54694,251898,252069,171
101,0,blank,0,190.48994,469.14866,252069,252241,172
101,29,array2,176,149.78074,495.43206,252241,252414,173
101,29,num2,174,119.74714,506.15468,252414,252590,176
101,30,i,185,89.31488,517.60406,252590,252760,170
101,29,num2,174,92.41812,502.21494,252760,252930,170
101,0,blank,0,116.23045,510.1578,252930,252997,67
101,0,blank,0,254.64588,485.76392,253032,253205,173
101,0,blank,0,245.32336,493.61168,253205,253377,172
101,0,blank,0,113.11182,541.08128,253412,253584,172
101,0,blank,0,133.98006,547.29598,253584,253756,172
101,0,blank,0,136.90724,545.83402,253756,253929,173
101,32,0,193,133.5271,556.82272,253929,254104,175
101,0,blank,0,156.82554,556.57324,254104,254280,176
101,0,blank,0,177.17056,554.61738,254280,254454,174
101,0,blank,0,205.01948,552.91416,254454,254628,174
101,0,blank,0,223.0626,545.66692,254628,254804,176
101,0,blank,0,232.538833333333,548.347533333333,254804,254939,135
101,0,blank,0,210.3461,594.5779,254939,255060,121
101,34,[,211,167.0189,603.0012,255060,255189,129
101,0,blank,0,173.35145,596.61895,255189,255385,196
101,0,blank,0,184.3267,597.50496,255385,255561,176
101,0,blank,0,221.35764,597.905,255561,255737,176
101,0,blank,0,249.1316,598.9092,255737,255913,176
101,0,blank,0,164.62374,620.03542,255913,256089,176
101,34,num1,205,158.27642,619.65368,256089,256264,175
101,35,return,215,152.40844,630.29182,256264,256440,176
101,0,blank,0,96.53816,664.63298,256440,256617,177
101,0,blank,0,92.57076,663.1452,256617,256790,173
101,0,blank,0,93.92002,666.24914,256790,256969,179
101,37,1,220,115.6768,681.061166666667,256969,257073,104
101,0,blank,0,-350,-105,257108,257288,180
101,0,blank,0,-350,-105,257288,257405,117
101,13,"%sand%sareanagrams.\n",77,205.65445,153.3908,258003,258094,91
101,13,"%sand%sareanagrams.\n",77,362.42994,143.53418,258132,258301,169
101,0,blank,0,442.24396,143.71896,258301,258472,171
101,0,blank,0,438.115366666667,147.068433333333,258472,258572,100
101,11,comma,65,308.85785,95.74505,258605,258804,199
101,11,comma,65,308.6392,96.2503,258804,258839,35
101,0,blank,0,832.952,382.483,258908,258942,34
101,0,blank,0,965.9394,374.97142,258981,259161,180
101,0,blank,0,1013.4536,399.59704,259161,259339,178
101,0,blank,0,1014.8154,397.2253,259339,259521,182
101,0,blank,0,1015.561,400.3706,259521,259664,143
101,0,blank,0,406.772533333333,92.5508333333333,259737,259847,110
102,0,blank,0,233.4426,120.687,260427,260536,109
102,5,],35,198.6169,100.68765,260609,260683,74
102,0,blank,0,225.120566666667,208.972133333333,260723,260835,112
102,5,[,33,161.11036,99.4095,260869,261051,182
102,5,100,34,182.60698,108.46024,261051,261225,174
102,0,blank,0,215.945683333333,113.951,261225,261424,199
102,0,blank,0,216.584333333333,125.887316666667,261424,261622,198
102,0,blank,0,215.56468,119.63908,261622,261792,170
102,0,blank,0,210.18424,118.99986,261792,261961,169
102,0,blank,0,210.40182,125.88734,261961,262130,169
102,0,blank,0,220.14874,125.82764,262130,262299,169
102,0,blank,0,256.05008,124.18612,262299,262465,166
102,5,array2,32,241.691,106.1916,262465,262633,168
102,5,array2,32,225.70322,99.27694,262633,262809,176
102,0,blank,0,219.53928,103.0484,262809,262980,171
102,5,100,34,192.14394,101.01544,262980,263161,181
102,5,100,34,192.91384,103.81552,263161,263344,183
102,5,],35,194.3256,109.08258,263344,263527,183
102,5,array2,32,251.96338,103.29762,263527,263707,180
102,5,array2,32,250.51154,96.02044,263707,263890,183
102,5,array2,32,227.62184,93.07454,263890,264072,182
102,5,comma,31,209.79362,98.05354,264072,264252,180
102,5,],35,197.79848,102.66208,264252,264436,184
102,0,blank,0,219.3807,100.12932,264436,264625,189
102,5,array2,32,236.80716,105.15934,264625,264811,186
102,5,100,34,323.45358,98.96084,264811,264991,180
102,5,],35,331.1384,99.06018,264991,265171,180
102,0,blank,0,332.96182,95.61196,265171,265350,179
102,0,blank,0,357.3141,98.22602,265350,265530,180
102,0,blank,0,355.10914,94.8573,265530,265707,177
102,5,],35,324.82064,95.75558,265707,265885,178
102,0,blank,0,357.86072,91.20644,265885,266065,180
102,0,blank,0,342.81652,99.01946,266065,266246,181
102,0,blank,0,344.56386,94.91664,266246,266425,179
102,0,blank,0,359.2096,88.72892,266425,266603,178
102,5,array2,32,277.25028,92.57124,266603,266781,178
102,5,array2,32,235.39326,97.75484,266781,266960,179
102,0,blank,0,185.78648,132.13394,266960,267139,179
102,9,"Enteranotherstring\n",52,224.47495,183.527575,267139,267282,143
102,0,blank,0,139.67876,130.15112,267316,267486,170
102,0,blank,0,193.18755,173.956225,267486,267622,136
102,0,blank,0,216.20728,164.24102,267655,267848,193
102,0,blank,0,189.63974,158.61048,267848,268015,167
102,0,blank,0,204.54828,161.62262,268015,268182,167
102,9,"Enteranotherstring\n",52,296.44554,181.96746,268182,268353,171
102,0,blank,0,262.1303,156.281,268353,268529,176
102,0,blank,0,247.60826,169.45116,268529,268700,171
102,0,blank,0,322.86816,151.43214,268700,268870,170
102,7,;,44,331.25736,149.16386,268870,269041,171
102,0,blank,0,297.89966,157.06626,269041,269211,170
102,9,"Enteranotherstring\n",52,224.10932,194.5344,269211,269380,169
102,9,"Enteranotherstring\n",52,219.61346,187.89942,269380,269553,173
102,8,),48,158.84206,170.24094,269553,269724,171
102,8,),48,157.9441,172.91714,269724,269895,171
102,9,"Enteranotherstring\n",52,159.08666,182.83882,269895,270067,172
102,8,array1,47,152.61866,172.5686,270067,270241,174
102,8,;,49,169.7273,172.21248,270241,270413,172
102,0,blank,0,175.58258,166.16786,270413,270587,174
102,0,blank,0,163.64616,167.21572,270587,270761,174
102,8,;,49,165.91092,163.67006,270761,270937,176
102,0,blank,0,199.29014,164.08926,270937,271113,176
102,0,blank,0,190.87214,158.13004,271113,271286,173
102,0,blank,0,177.53192,160.37888,271286,271461,175
102,0,blank,0,196.59672,171.37298,271461,271637,176
102,9,"Enteranotherstring\n",52,215.75132,179.70832,271637,271817,180
102,0,blank,0,217.97298,178.7682,271817,271996,179
102,0,blank,0,234.97096,203.06328,271996,272169,173
102,9,"Enteranotherstring\n",52,235.15856,196.19974,272169,272339,170
102,9,"Enteranotherstring\n",52,232.3186,189.199433333333,272339,272439,100
102,0,blank,0,947.94025,760.73445,272579,272741,162
102,0,blank,0,1000.2864,758.15168,272867,273037,170
102,0,blank,0,963.94,728.2377,273037,273106,69
102,0,blank,0,-350,-105,273141,273330,189
102,0,blank,0,-350,-105,273330,273405,75
102,13,"%sand%sareanagrams.\n",77,377.7366,276.7097,273443,273470,27
102,9,"Enteranotherstring\n",52,210.40498,187.35232,273506,273675,169
102,9,"Enteranotherstring\n",52,190.6389,180.50272,273675,273848,173
102,9,"Enteranotherstring\n",52,215.18892,186.93782,273848,274022,174
102,9,"Enteranotherstring\n",52,213.26244,191.58386,274022,274193,171
102,0,blank,0,219.35522,178.4139,274193,274366,173
102,0,blank,0,220.20022,178.54742,274366,274539,173
102,9,"Enteranotherstring\n",52,236.29846,187.46794,274539,274715,176
102,9,"Enteranotherstring\n",52,232.67426,180.60434,274715,274890,175
102,0,blank,0,211.2535,171.0248,274890,275066,176
102,0,blank,0,209.64472,173.21222,275066,275243,177
102,9,"Enteranotherstring\n",52,238.69815,189.81985,275243,275420,177
102,9,"Enteranotherstring\n",52,236.9643,190.3853,275420,275547,127
102,0,blank,0,213.262766666667,174.066733333333,275547,275739,192
102,0,blank,0,216.27964,171.22764,275739,275914,175
102,0,blank,0,213.7228,173.37572,275914,276088,174
102,0,blank,0,212.21492,171.48352,276088,276263,175
102,0,blank,0,213.42562,171.64706,276263,276438,175
102,0,blank,0,209.9466,171.3144,276438,276614,176
102,0,blank,0,207.25006,169.28964,276614,276791,177
102,0,blank,0,204.1216,165.81094,276791,276965,174
102,0,blank,0,202.86108,162.95746,276965,277144,179
102,0,blank,0,207.48746,162.67544,277144,277326,182
102,0,blank,0,209.2024,161.89162,277326,277505,179
102,0,blank,0,200.48104,159.55782,277505,277687,182
102,0,blank,0,197.69646,163.29078,277687,277867,180
102,0,blank,0,195.5707,167.25086,277867,278045,178
102,0,blank,0,199.20048,170.70626,278045,278221,176
102,9,"Enteranotherstring\n",52,209.72994,187.30914,278221,278396,175
102,0,blank,0,205.42078,171.90784,278396,278575,179
102,0,blank,0,199.10784,163.47892,278575,278752,177
102,0,blank,0,217.35954,171.0158,278752,278929,177
102,9,"Enteranotherstring\n",52,218.78518,181.87406,278929,279106,177
102,11,array1,64,251.5585,232.7945,279106,279179,73
102,0,blank,0,213.4093,176.4102,279212,279285,73
102,9,"Enteranotherstring\n",52,229.388825,199.34065,279364,279517,153
102,13,"%sand%sareanagrams.\n",77,260.7208,276.3824,279590,279629,39
102,9,"Enteranotherstring\n",52,227.67334,197.70578,279663,279840,177
102,0,blank,0,210.310625,174.67485,279840,280013,173
102,0,blank,0,198.64526,161.85374,280013,280192,179
102,0,blank,0,200.13036,166.0495,280192,280367,175
102,0,blank,0,203.12188,169.90744,280367,280545,178
102,0,blank,0,206.80928,175.70428,280545,280719,174
102,0,blank,0,201.05398,162.54696,280719,280895,176
102,0,blank,0,197.14226,159.2503,280895,281071,176
102,0,blank,0,195.81874,160.5854,281071,281252,181
102,0,blank,0,195.27672,162.58984,281252,281435,183
102,0,blank,0,186.24838,162.77494,281435,281619,184
102,0,blank,0,182.15246,164.47022,281619,281802,183
102,0,blank,0,194.59924,160.92108,281802,281985,183
102,8,),48,158.67584,166.68534,281985,282169,184
102,8,),48,156.78734,165.4767,282169,282351,182
102,0,blank,0,184.9369,170.6388,282351,282529,178
102,9,"Enteranotherstring\n",52,190.19374,180.84516,282529,282704,175
102,9,"Enteranotherstring\n",52,193.42204,185.3694,282704,282877,173
102,11,find_anagram,62,215.6026,226.4875,282877,283014,137
102,9,"Enteranotherstring\n",52,203.7165,192.90305,283014,283192,178
102,9,"Enteranotherstring\n",52,201.54356,195.45714,283192,283380,188
102,9,"Enteranotherstring\n",52,196.58298,187.55526,283380,283550,170
102,9,"Enteranotherstring\n",52,192.64844,182.19148,283550,283727,177
102,9,"Enteranotherstring\n",52,186.13526,184.82558,283727,283901,174
102,9,"Enteranotherstring\n",52,187.98362,180.47564,283901,284077,176
102,9,"Enteranotherstring\n",52,171.95816,185.38526,284077,284250,173
102,9,"Enteranotherstring\n",52,158.54584,187.34132,284250,284426,176
102,9,"Enteranotherstring\n",52,163.55932,185.98164,284426,284605,179
102,9,"Enteranotherstring\n",52,205.53158,184.59026,284605,284784,179
102,9,"Enteranotherstring\n",52,246.42258,193.8819,284784,284962,178
102,9,"Enteranotherstring\n",52,263.1547,195.05668,284962,285141,179
102,9,"Enteranotherstring\n",52,310.99502,191.12846,285141,285320,179
102,9,"Enteranotherstring\n",52,299.13072,198.00458,285320,285494,174
102,9,"Enteranotherstring\n",52,302.82736,197.4622,285494,285667,173
102,9,),53,358.72814,194.64558,285667,285839,172
102,0,blank,0,192.787,213.97526,285839,286010,171
102,0,blank,0,195.49712,221.99878,286010,286181,171
102,11,find_anagram,62,211.36528,228.03352,286181,286349,168
102,11,find_anagram,62,182.7545,232.62536,286349,286520,171
102,11,find_anagram,62,172.90404,230.35248,286520,286688,168
102,11,find_anagram,62,195.83868,230.73676,286688,286859,171
102,11,find_anagram,62,213.10128,235.24218,286859,287030,171
102,11,find_anagram,62,229.69198,233.66108,287030,287197,167
102,0,blank,0,242.2999,249.8922,287197,287236,39
102,0,blank,0,307.8198,337.0991,287275,287313,38
102,11,(,63,235.7377,241.9985,287346,287380,34
102,0,blank,0,306.75866,250.97368,287460,287628,168
102,0,blank,0,354.09078,247.75386,287628,287796,168
102,11,array2,66,351.36698,238.07608,287796,287965,169
102,0,blank,0,351.97336,246.23626,287965,288135,170
102,0,blank,0,408.62088,234.66364,288135,288306,171
102,0,blank,0,429.4169,233.405325,288306,288442,136
102,13,"%sand%sareanagrams.\n",77,242.4864,277.0384,288518,288587,69
102,0,blank,0,292.9297,364.9863,288617,288656,39
102,11,comma,65,309.87844,237.12076,288689,288861,172
102,11,array2,66,366.72586,239.25686,288861,289032,171
102,0,blank,0,405.880633333333,241.199266666667,289032,289132,100
102,0,blank,0,242.83615,299.911733333333,289169,289366,197
102,0,blank,0,266.10646,305.34628,289366,289538,172
102,0,blank,0,289.11602,305.3998,289538,289704,166
102,13,array1,79,489.7104,267.069,289737,289770,33
102,0,blank,0,485.7151,477.6752,289876,289913,37
102,0,blank,0,545.73848,295.43888,290037,290210,173
102,0,blank,0,523.05552,308.36194,290210,290391,181
102,15,array1,89,480.176675,321.5055,290391,290524,133
102,15,"%sand%sarenotanagrams.\n",87,291.9987,324.93646,290556,290721,165
102,15,array2,91,601.21174,319.0987,290786,290952,166
102,15,array2,91,578.67332,325.92188,290952,291118,166
102,15,array2,91,559.0387,330.750166666667,291118,291221,103
102,0,blank,0,221.30648,380.78074,291424,291605,181
102,0,blank,0,-350,-105,291643,291751,108
102,0,blank,0,-350,-105,291846,291880,34
102,18,array1,102,229.18106,378.26424,291910,292085,175
102,18,array1,102,271.34978,396.2074,292085,292253,168
102,0,blank,0,317.394616666667,404.084916666667,292253,292451,198
102,18,char,106,330.190183333333,397.194566666667,292451,292649,198
102,0,blank,0,325.19005,404.121016666667,292649,292847,198
102,18,char,106,326.887033333333,397.43155,292847,293040,193
102,18,char,106,328.12305,395.027966666667,293040,293232,192
102,18,char,106,323.932116666667,397.23075,293232,293426,194
102,0,blank,0,328.177975,404.346125,293426,293557,131
102,18,],109,450.390633333333,397.817416666667,293590,293786,196
102,18,array2,107,410.17586,393.92856,293786,293954,168
102,18,array2,107,406.50962,391.38678,293954,294123,169
102,0,blank,0,376.15742,398.12506,294123,294293,170
102,0,blank,0,338.28996,399.86028,294293,294463,170
102,18,char,106,355.89302,395.80118,294463,294632,169
102,0,blank,0,435.47426,402.7651,294632,294803,171
102,18,array2,107,431.96034,391.20018,294803,294973,170
102,18,array2,107,398.22934,397.12008,294973,295141,168
102,18,array2,107,393.89346,395.56854,295141,295309,168
102,18,char,106,362.361416666667,394.517416666667,295309,295508,199
102,0,blank,0,365.465675,395.45435,295508,295651,143
102,0,blank,0,367.1199,405.63525,295651,295845,194
102,0,blank,0,375.9889,415.52995,295845,296040,195
102,0,blank,0,380.14436,412.42282,296040,296213,173
102,0,blank,0,362.94098,405.05038,296213,296380,167
102,18,array2,107,386.65398,385.92272,296380,296549,169
102,18,),110,461.54112,390.54484,296549,296718,169
102,20,{,127,359.37405,441.84485,296752,296951,199
102,0,blank,0,348.28964,445.10476,296951,297123,172
102,0,blank,0,302.61008,458.9323,297123,297291,168
102,0,blank,0,304.26645,452.335575,297291,297428,137
102,21,0,142,259.0498,462.2845,297428,297871,443
102,0,blank,0,261.084333333333,468.259666666667,297871,298054,183
102,21,0,142,272.9796,462.530233333333,298054,298243,189
102,21,0,142,259.7108,445.0657,298243,298274,31
102,0,blank,0,303.0317,478.8102,298274,298621,347
102,0,blank,0,316.9764,476.5821,298621,298797,176
102,0,blank,0,290.768416666667,482.937266666667,298797,298984,187
102,0,blank,0,279.330766666667,515.089333333333,298984,299174,190
102,0,blank,0,252.656525,513.915475,299174,299306,132
102,0,blank,0,206.0759,586.1196,299306,300460,1154
102,27,],169,199.88514,591.58672,300460,300629,169
102,0,blank,0,195.853383333333,600.7173,300629,300828,199
102,27,0,171,268.31264,581.16652,300828,300996,168
102,0,blank,0,293.30864,580.81576,300996,301164,168
102,0,blank,0,287.81888,572.48242,301164,301335,171
102,27,==,170,221.49524,581.3442,301335,301505,170
102,27,array2,166,157.00452,581.45228,301505,301674,169
102,27,array2,166,165.5127,582.43738,301674,301846,172
102,0,blank,0,236.72416,563.47938,301846,302014,168
102,0,blank,0,199.805516666667,573.0311,302014,302213,199
102,0,blank,0,165.362966666667,568.161133333333,302213,302313,100
102,0,blank,0,357.572683333333,506.13155,302346,302545,199
102,0,blank,0,356.7091,498.6247,302545,302612,67
102,0,blank,0,959.670166666667,423.559983333333,302680,302878,198
102,0,blank,0,1021.80633333333,398.074466666667,302878,303073,195
102,0,blank,0,1003.3858,384.44388,303073,303240,167
102,0,blank,0,996.7166,408.22184,303240,303411,171
102,0,blank,0,995.438666666667,401.6607,303411,303512,101
102,0,blank,0,-350,-105,303581,303769,188
102,0,blank,0,-350,-105,303769,303820,51
102,20,0,133,209.35614,435.32208,303854,304042,188
102,0,blank,0,271.9109,401.502166666667,304042,304238,196
102,18,comma,105,308.691316666667,392.311066666667,304238,304431,193
102,0,blank,0,368.72845,404.294516666667,304431,304624,193
102,0,blank,0,343.04145,454.467366666667,304624,304812,188
102,0,blank,0,345.42965,432.138233333333,304812,305002,190
102,0,blank,0,350.149466666667,435.160383333333,305002,305195,193
102,20,0,133,368.038883333333,441.1116,305195,305387,192
102,20,0,133,364.8663,438.1067,305387,305582,195
102,20,26,124,294.64465,435.45685,305582,305777,195
102,20,num2,122,283.831833333333,436.084016666667,305777,305972,195
102,20,num2,122,273.484583333333,440.619016666667,305972,306169,197
102,0,blank,0,248.29535,470.687683333333,306169,306366,197
102,21,0,142,272.917633333333,460.966633333333,306366,306562,196
102,0,blank,0,319.63672,465.42704,306562,306727,165
102,13,"%sand%sareanagrams.\n",77,272.45595,276.500983333333,306760,306957,197
102,13,"%sand%sareanagrams.\n",77,251.03335,280.121033333333,306957,307154,197
102,13,"%sand%sareanagrams.\n",77,268.354466666667,278.5609,307154,307348,194
102,13,"%sand%sareanagrams.\n",77,359.5555,274.81928,307348,307516,168
102,13,"%sand%sareanagrams.\n",77,356.70916,273.02618,307516,307683,167
102,13,"%sand%sareanagrams.\n",77,359.14365,275.174666666667,307683,307882,199
102,13,"%sand%sareanagrams.\n",77,372.80308,277.47976,307882,308049,167
102,13,"%sand%sareanagrams.\n",77,300.4102,280.08382,308049,308217,168
102,13,"%sand%sareanagrams.\n",77,295.41442,277.98134,308217,308388,171
102,13,"%sand%sareanagrams.\n",77,290.56765,282.242516666667,308388,308587,199
102,13,"%sand%sareanagrams.\n",77,249.63132,287.86838,308587,308755,168
102,13,"%sand%sareanagrams.\n",77,244.9826,285.9536,308755,308789,34
102,13,array2,81,526.440483333333,276.459733333333,308823,309021,198
102,13,array2,81,534.620766666667,281.183133333333,309021,309220,199
102,0,blank,0,593.584033333333,280.490183333333,309220,309414,194
102,13,;,83,595.1458,273.2431,309414,309447,33
102,15,array1,89,485.336683333333,316.376116666667,309479,309674,195
102,15,array1,89,531.448466666667,330.699883333333,309674,309870,196
102,15,array2,91,565.44816,331.43176,309870,310039,169
102,15,array2,91,574.7641,327.46014,310039,310206,167
102,15,),92,621.28858,329.7652,310206,310374,168
102,0,blank,0,228.8729,294.422116666667,310440,310638,198
102,13,"%sand%sareanagrams.\n",77,215.077683333333,274.137483333333,310638,310837,199
102,0,blank,0,206.19828,259.2712,310837,311008,171
102,0,blank,0,200.77812,258.38082,311008,311180,172
102,0,blank,0,200.62084,261.19842,311180,311351,171
102,12,),74,176.92588,258.03958,311351,311518,167
102,12,1,73,164.0548,255.33046,311518,311686,168
102,13,"%sand%sareanagrams.\n",77,165.80542,284.8021,311686,311855,169
102,0,blank,0,163.4945,302.658583333333,311855,312053,198
102,0,blank,0,172.716,308.186116666667,312053,312251,198
102,15,"%sand%sarenotanagrams.\n",87,178.342116666667,325.558933333333,312251,312450,199
102,0,blank,0,168.04072,346.55908,312450,312617,167
102,0,blank,0,173.80562,354.83428,312617,312787,170
102,0,blank,0,185.94562,355.71852,312787,312954,167
102,0,blank,0,187.95212,354.80874,312954,313121,167
102,0,blank,0,215.2715,382.28328,313121,313291,170
102,0,blank,0,200.31034,365.25966,313291,313458,167
102,0,blank,0,187.09578,350.08142,313458,313625,167
102,0,blank,0,208.4924,350.9744,313625,313659,34
102,0,blank,0,953.7725,370.257233333333,313726,313925,199
102,0,blank,0,985.262166666667,412.1869,313925,314123,198
102,0,blank,0,982.372833333333,420.572933333333,314123,314316,193
102,0,blank,0,982.4756,429.70226,314316,314482,166
102,0,blank,0,999.836,424.4552,314482,314516,34
102,0,blank,0,183.0575,119.07688,314618,314790,172
102,0,blank,0,141.66404,85.31418,314790,314963,173
102,0,blank,0,129.25588,69.72252,314963,315133,170
102,0,blank,0,126.6207,68.01314,315133,315305,172
102,5,[,33,158.188,94.76984,315305,315480,175
102,0,blank,0,177.40666,472.87886,315547,315716,169
102,21,array1,137,156.28978,459.79172,315716,315883,167
102,0,blank,0,135.135,414.719675,315883,316023,140
102,0,blank,0,170.90765,416.5727,316023,316204,181
102,0,blank,0,201.7557,412.3492,316204,316324,120
102,0,blank,0,373.56922,502.18564,316407,316586,179
102,0,blank,0,316.54365,518.222933333333,316586,316785,199
102,0,blank,0,292.223433333333,515.564433333333,316785,316983,198
103,0,blank,0,224.1305,533.9961,317146,317180,34
103,0,blank,0,173.509933333333,681.4292,317213,317409,196
103,0,blank,0,187.52245,682.190166666667,317409,317603,194
103,0,blank,0,186.404116666667,686.43125,317603,317796,193
103,0,blank,0,173.954133333333,686.858233333333,317796,317988,192
103,0,blank,0,172.111033333333,695.497616666667,317988,318182,194
103,0,blank,0,195.395183333333,700.5701,318182,318373,191
103,35,return,215,180.628816666667,634.042766666667,318373,318567,194
103,32,i,199,168.7539,562.02275,318567,318765,198
103,0,blank,0,161.2283,480.51158,318765,318932,167
103,0,blank,0,164.4821,483.04915,318932,319001,69
103,0,blank,0,217.679566666667,642.352383333333,319035,319232,197
103,0,blank,0,270.330516666667,647.79505,319232,319428,196
103,0,blank,0,267.144833333333,653.23365,319428,319625,197
103,0,blank,0,214.227016666667,630.15195,319625,319820,195
103,0,blank,0,219.7648,625.9563,319820,320013,193
103,0,blank,0,257.784366666667,623.914516666667,320013,320207,194
103,0,blank,0,286.9289,622.928466666667,320207,320401,194
103,0,blank,0,331.08514,618.8905,320401,320567,166
103,0,blank,0,329.90554,612.51294,320567,320733,166
103,0,blank,0,229.65506,615.76982,320733,320899,166
103,0,blank,0,228.82786,601.8545,320899,321067,168
103,32,i,199,249.37688,573.71632,321067,321239,172
103,0,blank,0,233.36488,570.17958,321239,321408,169
103,32,;,198,226.90406,569.4115,321408,321578,170
103,32,i,199,244.4824,571.02814,321578,321744,166
103,0,blank,0,321.02724,567.28108,321744,321913,169
103,0,blank,0,322.78572,565.1178,321913,322079,166
103,0,blank,0,319.12996,566.28302,322079,322248,169
103,0,blank,0,289.525183333333,564.24675,322248,322443,195
103,0,blank,0,226.01372,537.90084,322443,322609,166
103,0,blank,0,195.94006,528.73816,322609,322779,170
103,0,blank,0,191.25508,530.96074,322779,322950,171
103,0,blank,0,210.27548,526.51806,322950,323121,171
103,0,blank,0,233.22008,507.7985,323121,323291,170
103,29,],182,280.28016,506.2895,323291,323458,167
103,0,blank,0,336.35122,509.20386,323458,323627,169
103,0,blank,0,349.726533333333,506.393333333333,323627,323826,199
103,0,blank,0,335.588883333333,500.4607,323826,324024,198
103,0,blank,0,340.968766666667,492.289633333333,324024,324221,197
103,0,blank,0,317.266416666667,462.06795,324221,324418,197
103,27,0,171,246.769616666667,455.2849,324418,324615,197
103,0,blank,0,243.77074,455.0025,324615,324782,167
103,27,0,171,273.928,465.75624,324782,324949,167
103,0,blank,0,291.522133333333,468.4935,324949,325144,195
103,0,blank,0,305.210133333333,437.2674,325144,325339,195
103,23,++,154,308.897566666667,366.782716666667,325339,325532,193
103,27,),172,286.09265,459.82795,325532,325727,195
103,27,),172,287.645983333333,458.657783333333,325727,325920,193
103,0,blank,0,316.540166666667,396.751283333333,325920,326115,195
103,0,blank,0,337.031183333333,354.9985,326115,326310,195
103,23,++,154,296.780783333333,365.684466666667,326310,326505,195
103,23,++,154,298.856366666667,371.572066666667,326505,326699,194
103,0,blank,0,300.256066666667,346.615466666667,326699,326895,196
103,0,blank,0,297.288683333333,322.831816666667,326895,327091,196
103,21,),143,290.649483333333,322.46115,327091,327286,195
103,21,),143,289.674683333333,314.540216666667,327286,327484,198
103,0,blank,0,293.43665,333.9464,327484,327680,196
103,27,),172,286.65935,456.416183333333,327680,327878,198
103,27,),172,290.44905,461.646416666667,327878,328075,197
103,27,),172,289.723066666667,456.771516666667,328075,328269,194
103,27,),172,287.9257,459.047166666667,328269,328462,193
103,27,),172,286.681883333333,464.74075,328462,328655,193
103,0,blank,0,298.78625,379.471366666667,328655,328850,195
103,0,blank,0,306.911433333333,356.2633,328850,329047,197
103,23,],153,285.193166666667,361.3019,329047,329246,199
103,0,blank,0,298.79832,322.47714,329246,329415,169
103,0,blank,0,301.39485,321.373816666667,329415,329614,199
103,0,blank,0,300.3163,328.89354,329614,329780,166
103,21,),143,287.68832,328.60798,329780,329948,168
103,21,0,142,249.519783333333,330.560233333333,329948,330147,199
103,0,blank,0,300.13694,322.41662,330147,330315,168
103,0,blank,0,335.2439,320.36758,330315,330482,167
103,0,blank,0,337.4924,319.6458,330482,330649,167
103,0,blank,0,337.13908,317.04208,330649,330817,168
103,0,blank,0,337.293916666667,335.240416666667,330817,331014,197
103,0,blank,0,347.767716666667,351.70955,331014,331211,197
103,0,blank,0,331.480133333333,311.581866666667,331211,331408,197
103,20,=,132,333.401333333333,309.952316666667,331408,331606,198
103,21,),143,290.4185,322.78365,331606,331802,196
103,21,0,142,276.80595,326.53965,331802,331995,193
103,23,a,152,266.60725,373.159133333333,331995,332188,193
103,0,blank,0,272.974133333333,396.965533333333,332188,332379,191
103,0,blank,0,262.465066666667,429.344183333333,332379,332571,192
103,27,0,171,263.146833333333,459.914583333333,332571,332769,198
103,27,),172,288.007,461.32525,332769,332834,65
103,27,array2,166,164.4954,465.36098,332868,333036,168
103,27,array2,166,166.36834,458.12478,333036,333205,169
103,27,],169,201.93934,462.07202,333205,333374,169
103,29,[,177,199.51588,495.3699,333374,333542,168
103,0,blank,0,194.9733,508.02376,333542,333714,172
103,0,blank,0,227.64456,490.21938,333714,333884,170
103,0,blank,0,277.5329,467.2577,333884,334058,174
103,27,),172,290.24036,461.95452,334058,334231,173
103,0,blank,0,270.13982,466.01516,334231,334404,173
103,27,0,171,267.3894,462.31518,334404,334576,172
103,0,blank,0,296.55184,466.87388,334576,334747,171
103,27,),172,287.40028,464.28138,334747,334916,169
103,0,blank,0,282.10756,468.38642,334916,335085,169
103,0,blank,0,283.53884,461.09084,335085,335254,169
103,27,),172,287.05966,463.23966,335254,335420,166
103,27,),172,286.74014,460.21372,335420,335588,168
103,0,blank,0,282.72252,460.85272,335588,335755,167
103,27,),172,285.23018,453.8099,335755,335923,168
103,27,0,171,275.3336,461.81906,335923,336094,171
103,27,i,168,185.61862,451.3654,336094,336264,170
103,0,blank,0,204.9284,457.33832,336264,336438,174
103,27,==,170,227.38405,465.171,336438,336637,199
103,0,blank,0,273.9537,471.18535,336637,336829,192
103,0,blank,0,307.54698,465.60648,336829,337001,172
103,0,blank,0,301.63358,467.66464,337001,337169,168
103,0,blank,0,312.72532,458.90122,337169,337336,167
103,0,blank,0,334.108833333333,461.913033333333,337336,337532,196
103,0,blank,0,303.34705,462.576733333333,337532,337726,194
103,27,0,171,260.066816666667,460.421533333333,337726,337925,199
103,27,0,171,262.109583333333,456.469166666667,337925,338123,198
103,0,blank,0,285.80565,466.22995,338123,338319,196
103,0,blank,0,310.03415,459.912516666667,338319,338517,198
103,27,),172,288.21802,454.87098,338517,338684,167
103,0,blank,0,282.5819,454.389333333333,338684,338883,199
103,27,0,171,250.566483333333,461.3432,338883,339082,199
103,27,0,171,266.271933333333,453.375783333333,339082,339281,199
103,0,blank,0,299.125683333333,462.792766666667,339281,339477,196
103,0,blank,0,315.31065,456.801533333333,339477,339674,197
103,0,blank,0,305.2959,453.735616666667,339674,339869,195
103,27,),172,291.590983333333,455.784666666667,339869,340065,196
103,27,0,171,280.6909,457.554666666667,340065,340259,194
103,27,0,171,273.048833333333,452.75695,340259,340457,198
103,27,i,168,185.586466666667,457.915116666667,340457,340654,197
103,0,blank,0,174.536466666667,461.069166666667,340654,340851,197
103,27,[,167,176.2674,465.454266666667,340851,341049,198
103,0,blank,0,240.761016666667,458.60305,341049,341245,196
103,0,blank,0,245.611733333333,462.3719,341245,341440,195
103,27,0,171,248.7022,462.57095,341440,341636,196
103,27,0,171,246.7198,459.340133333333,341636,341831,195
103,27,0,171,271.046133333333,459.492416666667,341831,342025,194
103,0,blank,0,307.039866666667,455.201716666667,342025,342224,199
103,27,),172,286.8964,452.99038,342224,342391,167
103,0,blank,0,295.0059,464.02034,342391,342556,165
103,27,0,171,270.29664,457.39144,342556,342728,172
103,27,0,171,247.20548,464.5876,342728,342895,167
103,0,blank,0,277.1075,467.62192,342895,343062,167
103,0,blank,0,275.82882,477.87186,343062,343230,168
103,29,a,181,251.58562,494.74148,343230,343399,169
103,29,-,180,235.56682,503.32716,343399,343567,168
103,0,blank,0,203.6043,521.14434,343567,343733,166
103,0,blank,0,209.56126,511.04472,343733,343900,167
103,0,blank,0,251.47245,469.471816666667,343900,344097,197
103,27,0,171,258.187733333333,462.23945,344097,344291,194
103,0,blank,0,273.728083333333,471.8427,344291,344486,195
103,0,blank,0,247.32135,469.868983333333,344486,344681,195
103,0,blank,0,246.43174,470.58012,344681,344847,166
103,0,blank,0,304.648566666667,469.008266666667,344847,345041,194
103,0,blank,0,306.785,463.685466666667,345041,345234,193
103,0,blank,0,298.257316666667,460.376616666667,345234,345431,197
103,0,blank,0,293.493583333333,459.849883333333,345431,345628,197
103,27,),172,286.86395,461.154733333333,345628,345823,195
103,27,0,171,273.95555,465.454483333333,345823,346018,195
103,0,blank,0,237.89364,465.23206,346018,346187,169
103,0,blank,0,241.89566,466.93322,346187,346357,170
103,27,0,171,277.953883333333,463.18375,346357,346556,199
103,0,blank,0,300.09652,462.25884,346556,346722,166
103,0,blank,0,310.41936,458.05294,346722,346891,169
103,0,blank,0,318.90312,459.01222,346891,347058,167
103,0,blank,0,297.31994,456.31758,347058,347232,174
103,27,),172,284.34488,464.77552,347232,347404,172
103,0,blank,0,293.41664,467.38852,347404,347573,169
103,27,0,171,255.08044,464.87206,347573,347742,169
103,27,==,170,217.28898,462.42368,347742,347912,170
103,0,blank,0,164.04068,470.54284,347912,348082,170
103,27,i,168,186.72508,463.0594,348082,348254,172
103,27,0,171,266.1529,464.68164,348254,348425,171
103,0,blank,0,282.70202,465.69098,348425,348593,168
103,0,blank,0,299.5647,467.24818,348593,348760,167
103,27,),172,286.35958,460.75788,348760,348929,169
103,27,),172,285.5298,461.7077,348929,349126,197
103,0,blank,0,294.09432,459.33246,349126,349293,167
103,0,blank,0,317.238083333333,441.62385,349293,349491,198
103,0,blank,0,309.9457,470.360766666667,349491,349686,195
103,29,a,181,263.87374,490.39446,349686,349855,169
103,0,blank,0,188.92036,524.87044,349855,350027,172
103,0,blank,0,185.4151,519.25428,350027,350197,170
103,0,blank,0,183.83638,472.76294,350197,350371,174
103,0,blank,0,212.70068,467.22964,350371,350542,171
103,27,==,170,227.38906,464.52794,350542,350714,172
103,0,blank,0,233.34772,471.25856,350714,350885,171
103,0,blank,0,314.097466666667,459.190066666667,350885,351082,197
103,0,blank,0,303.422733333333,469.556,351082,351275,193
103,0,blank,0,288.682233333333,470.538083333333,351275,351471,196
103,0,blank,0,276.8046,357.406916666667,351471,351669,198
103,0,blank,0,291.208266666667,384.6077,351669,351868,199
103,0,blank,0,319.14,445.74624,351868,352035,167
103,0,blank,0,328.52602,466.55516,352035,352205,170
103,29,++,183,299.4881,493.864383333333,352205,352404,199
103,0,blank,0,292.008833333333,518.491716666667,352404,352599,195
103,0,blank,0,321.831083333333,509.64565,352599,352795,196
103,0,blank,0,322.91855,510.2157,352795,352992,197
103,29,a,181,262.983583333333,506.190483333333,352992,353191,199
103,29,a,181,262.815483333333,504.426683333333,353191,353388,197
103,0,blank,0,296.6824,478.596383333333,353388,353585,197
103,0,blank,0,313.559733333333,466.19725,353585,353782,197
103,0,blank,0,306.147783333333,465.486733333333,353782,353978,196
103,0,blank,0,294.66705,468.6046,353978,354175,197
103,0,blank,0,289.182366666667,468.475766666667,354175,354371,196
103,29,++,183,304.752183333333,508.987583333333,354371,354568,197
103,29,array2,176,188.46868,499.5398,354568,354736,168
103,0,blank,0,194.709,476.4431,354736,354934,198
103,0,blank,0,282.1628,459.242816666667,354934,355133,199
103,0,blank,0,308.552416666667,465.359166666667,355133,355327,194
103,0,blank,0,328.998716666667,461.718866666667,355327,355522,195
103,0,blank,0,329.164933333333,465.565616666667,355522,355721,199
103,0,blank,0,297.26068,460.88584,355721,355887,166
103,0,blank,0,285.09535,466.282466666667,355887,356086,199
103,27,),172,284.9558,464.8497,356086,356252,166
103,0,blank,0,210.45084,463.6066,356252,356419,167
103,27,],169,198.42482,452.74686,356419,356587,168
103,0,blank,0,170.1508,469.55882,356587,356753,166
103,29,],182,221.108733333333,509.8967,356753,356888,135
103,0,blank,0,212.55205,535.366,356888,357086,198
103,0,blank,0,188.45045,551.5702,357086,357249,163
103,0,blank,0,237.23708,551.5026,357249,357421,172
103,32,++,200,265.141366666667,555.739783333333,357421,357617,196
103,0,blank,0,355.880533333333,533.062633333333,357617,357812,195
103,0,blank,0,357.722433333333,518.286333333333,357812,358011,199
103,0,blank,0,356.6129,506.116716666667,358011,358207,196
103,0,blank,0,357.269916666667,518.972383333333,358207,358405,198
103,0,blank,0,324.231483333333,539.029416666667,358405,358600,195
103,0,blank,0,330.3049,562.3339,358600,358794,194
103,0,blank,0,249.369433333333,580.89415,358794,358992,198
103,34,num2,210,254.15994,606.3582,358992,359159,167
103,0,blank,0,257.418416666667,620.198833333333,359159,359355,196
103,34,num2,210,256.1959,619.672416666667,359355,359552,197
103,0,blank,0,281.452483333333,622.47465,359552,359749,197
103,34,num2,210,268.9092,619.123966666667,359749,359943,194
103,35,;,217,211.407916666667,629.463033333333,359943,360140,197
103,0,blank,0,264.7459,630.2032,360140,360307,167
103,0,blank,0,261.36056,628.6187,360307,360473,166
103,0,blank,0,250.34234,641.59914,360473,360641,168
103,0,blank,0,247.36528,641.46386,360641,360812,171
103,0,blank,0,274.835466666667,625.27445,360812,361011,199
103,0,blank,0,269.396833333333,593.2259,361011,361210,199
103,32,;,198,231.201633333333,573.857433333333,361210,361408,198
103,0,blank,0,186.5244,553.96152,361408,361578,170
103,0,blank,0,195.5194,567.5779,361578,361610,32
103,0,blank,0,295.05386,631.32798,361644,361812,168
103,0,blank,0,268.76012,627.00796,361812,361980,168
103,0,blank,0,271.647,633.75152,361980,362151,171
103,0,blank,0,251.6727,633.68266,362151,362321,170
103,0,blank,0,277.08044,620.491,362321,362490,169
103,0,blank,0,332.1419,614.649433333333,362490,362688,198
103,0,blank,0,300.814366666667,573.75545,362688,362887,199
103,0,blank,0,263.8763,514.6121,362887,363085,198
103,0,blank,0,206.3106,513.22954,363085,363253,168
103,0,blank,0,194.712133333333,513.9121,363253,363450,197
103,0,blank,0,214.39906,527.19634,363450,363618,168
103,0,blank,0,256.444283333333,513.8853,363618,363817,199
103,0,blank,0,246.11415,510.259,363817,364016,199
103,0,blank,0,206.65862,516.73974,364016,364185,169
103,0,blank,0,199.1235,526.1742,364185,364219,34
103,0,blank,0,317.56905,511.569916666667,364252,364449,197
103,0,blank,0,316.2823,502.19672,364449,364617,168
103,0,blank,0,340.63182,500.65428,364617,364784,167
103,0,blank,0,349.718616666667,502.97495,364784,364983,199
103,0,blank,0,340.197966666667,505.2921,364983,365181,198
103,0,blank,0,324.130583333333,502.260933333333,365181,365377,196
103,0,blank,0,322.365733333333,494.94555,365377,365570,193
103,0,blank,0,337.49305,503.855133333333,365570,365767,197
103,0,blank,0,347.724075,507.3035,365767,365898,131
103,0,blank,0,186.563783333333,527.2159,365930,366128,198
103,0,blank,0,186.130233333333,529.2673,366128,366322,194
103,0,blank,0,190.251825,532.4088,366322,366454,132
103,0,blank,0,-350,-105,366554,366669,115
103,0,blank,0,1006.36,493.828675,366945,367078,133
103,0,blank,0,916.384,489.6357,367112,367148,36
103,0,blank,0,984.106166666667,482.582033333333,367209,367398,189
103,0,blank,0,1022.251,476.2547,367398,367429,31
103,0,blank,0,179.6893,535.664883333333,367496,367695,199
103,0,blank,0,196.805116666667,522.100233333333,367695,367890,195
103,29,i,178,208.327283333333,496.259833333333,367890,368089,199
103,0,blank,0,240.36525,478.972566666667,368089,368281,192
103,0,blank,0,307.011416666667,486.228066666667,368281,368476,195
103,0,blank,0,312.575533333333,511.519533333333,368476,368673,197
103,0,blank,0,236.765316666667,515.61375,368673,368869,196
103,0,blank,0,192.1136,526.59788,368869,369031,162
103,0,blank,0,306.485966666667,343.198216666667,369064,369262,198
103,20,0,133,367.11765,304.536716666667,369262,369459,197
103,0,blank,0,414.08712,284.98198,369459,369625,166
103,18,],109,451.42352,252.92382,369692,369855,163
103,0,blank,0,263.46935,216.52055,369888,370086,198
103,0,blank,0,269.85896,207.3211,370086,370254,168
103,0,blank,0,256.25806,634.46844,370320,370486,166
103,0,blank,0,250.3219,638.11354,370486,370656,170
103,0,blank,0,234.0248,632.72902,370656,370824,168
103,34,[,211,280.425466666667,606.161883333333,370824,371018,194
103,0,blank,0,313.169766666667,604.4393,371018,371214,196
103,34,num2,210,262.154,611.694683333333,371214,371410,196
103,34,num2,210,245.3052,616.70974,371410,371578,168
103,34,num2,210,239.41942,619.67108,371578,371744,166
103,0,blank,0,305.30432,620.76246,371744,371913,169
103,0,blank,0,343.0701,613.299683333333,371913,372108,195
103,0,blank,0,341.4896,609.899033333333,372108,372301,193
103,0,blank,0,328.678516666667,607.740716666667,372301,372495,194
103,0,blank,0,334.008266666667,606.470733333333,372495,372685,190
103,0,blank,0,345.1009,607.17505,372685,372877,192
103,0,blank,0,346.78095,615.305816666667,372877,373067,190
103,0,blank,0,339.574983333333,607.772516666667,373067,373258,191
103,0,blank,0,260.044833333333,642.1614,373258,373449,191
103,0,blank,0,254.26585,638.746816666667,373449,373644,195
103,0,blank,0,262.085316666667,647.531766666667,373644,373842,198
103,34,num2,210,246.50776,612.04966,373842,374008,166
103,0,blank,0,215.16938,546.28592,374008,374177,169
103,0,blank,0,196.653966666667,533.230666666667,374177,374376,199
103,0,blank,0,207.94,474.725983333333,374376,374574,198
103,0,blank,0,187.427116666667,419.555033333333,374574,374772,198
103,0,blank,0,254.368,291.594,374805,374839,34
103,15,"%sand%sarenotanagrams.\n",87,201.02036,192.20096,374871,375047,176
103,15,"%sand%sarenotanagrams.\n",87,229.15534,193.56464,375047,375220,173
103,15,"%sand%sarenotanagrams.\n",87,237.2721,199.8867,375220,375258,38
103,18,array1,102,253.95592,249.07646,375289,375462,173
103,0,blank,0,249.69105,275.1192,375462,375595,133
103,0,blank,0,216.415,243.3693,375628,375661,33
103,15,array2,91,557.37572,189.28414,375726,375892,166
103,15,array2,91,553.595966666667,181.8577,375892,375992,100
103,0,blank,0,200.903,212.7285,376026,376059,33
103,0,blank,0,197.144975,221.03065,376131,376260,129
103,0,blank,0,521.208866666667,151.722316666667,376323,376518,195
103,13,array2,81,551.004333333333,156.11495,376518,376713,195
103,0,blank,0,601.72535,172.69255,376713,376911,198
103,0,blank,0,473.63525,171.140583333333,376911,377107,196
103,0,blank,0,426.88485,135.54515,377107,377249,142
103,11,),67,385.51655,101.3311,377249,377434,185
103,0,blank,0,383.592,92.9016,377434,377550,116
103,0,blank,0,318.194675,108.210175,377550,377742,192
103,11,array1,64,281.88045,104.853283333333,377742,377941,199
103,11,array1,64,262.22936,108.47544,377941,378110,169
103,0,blank,0,234.80794,114.15196,378110,378279,169
103,11,find_anagram,62,216.92234,113.11968,378279,378448,169
103,0,blank,0,205.8328,124.10082,378448,378615,167
103,13,"%sand%sareanagrams.\n",77,199.7939,138.16,378615,378648,33
103,0,blank,0,942.987,416.0802,378748,378785,37
103,0,blank,0,964.1116,423.29806,378819,379003,184
103,0,blank,0,982.0962,430.07782,379003,379179,176
103,0,blank,0,994.075,431.80034,379179,379353,174
103,0,blank,0,1010.636,415.9338,379353,379387,34
103,9,"Enteranotherstring\n",52,233.2959,59.24608,379491,379664,173
103,9,"Enteranotherstring\n",52,229.8952,52.8558,379664,379699,35
104,0,blank,0,227.75535,112.6167,380070,380137,67
104,0,blank,0,216.2515,121.1528,380204,380280,76
104,0,blank,0,344.025333333333,98.7014333333333,380313,380511,198
104,0,blank,0,347.754166666667,101.270416666667,380511,380708,197
104,5,;,36,341.661616666667,98.7147166666667,380708,380904,196
104,5,array2,32,263.445533333333,106.478366666667,380904,381100,196
104,0,blank,0,226.827883333333,71.9753,381100,381298,198
104,0,blank,0,208.091566666667,48.73615,381298,381495,197
104,0,blank,0,168.9892,53.8005833333333,381495,381693,198
104,0,blank,0,149.265333333333,54.8443333333333,381693,381892,199
104,0,blank,0,148.5293,64.65358,381892,382060,168
104,5,100,34,170.05358,103.66898,382060,382230,170
104,7,"Enterthestring\n",42,198.811716666667,143.606316666667,382230,382429,199
104,0,blank,0,217.292183333333,382.481233333333,382464,382659,195
104,0,blank,0,128.327533333333,403.738883333333,382659,382857,198
104,0,blank,0,165.9547,407.10645,382857,383054,197
104,0,blank,0,177.087316666667,406.7308,383054,383251,197
104,18,char,106,180.02655,395.559183333333,383251,383445,194
104,18,char,106,206.38985,394.444725,383445,383576,131
104,9,"Enteranotherstring\n",52,275.095483333333,187.5158,383608,383800,192
104,0,blank,0,210.70892,52.03126,383831,384002,171
104,0,blank,0,213.594975,71.096325,384002,384131,129
104,0,blank,0,252.34914,260.76592,384164,384329,165
104,0,blank,0,257.42202,219.53796,384329,384498,169
104,9,"Enteranotherstring\n",52,244.67748,196.997,384498,384668,170
104,0,blank,0,229.21568,264.05758,384668,384835,167
104,0,blank,0,230.39658,260.89078,384835,385003,168
104,0,blank,0,247.0825,249.08388,385003,385169,166
104,0,blank,0,227.31084,355.75088,385169,385336,167
104,0,blank,0,248.67484,406.43148,385336,385506,170
104,0,blank,0,399.80364,399.46102,385506,385674,168
104,0,blank,0,467.1109,401.38364,385674,385844,170
104,0,blank,0,468.46655,401.0908,385844,385984,140
104,0,blank,0,152.76038,407.36808,386018,386188,170
104,0,blank,0,222.9911,207.75642,386222,386389,167
104,0,blank,0,232.46928,169.30614,386389,386555,166
104,0,blank,0,237.63114,161.60516,386555,386725,170
104,11,array1,64,292.9067,229.42182,386725,386892,167
104,11,array1,64,288.95178,225.53846,386892,387059,167
104,11,array1,64,256.15432,233.88432,387059,387227,168
104,11,array1,64,254.1988,231.272633333333,387227,387327,100
104,18,],109,295.85442,377.96236,387362,387532,170
104,18,(,100,171.64024,382.2157,387532,387702,170
104,18,(,100,172.4315,389.274,387702,387737,35
104,0,blank,0,188.40268,112.18686,387771,387940,169
104,0,blank,0,165.84426,84.28454,387940,388108,168
104,0,blank,0,151.35778,67.60578,388108,388275,167
104,0,blank,0,159.03075,53.266925,388275,388413,138
104,18,],109,296.59314,382.36104,388482,388654,172
104,0,blank,0,193.1341,403.06618,388654,388824,170
104,0,blank,0,169.79772,404.77058,388824,388991,167
104,0,blank,0,125.86938,411.10428,388991,389159,168
104,0,blank,0,131.48704,409.87354,389159,389329,170
104,0,blank,0,220.069333333333,362.757033333333,389329,389528,199
104,0,blank,0,179.71512,360.90514,389528,389696,168
104,0,blank,0,167.17935,363.36465,389696,389761,65
104,0,blank,0,491.46858,332.8844,389829,389998,169
104,0,blank,0,490.9142,335.23238,389998,390171,173
104,0,blank,0,402.8497,398.65138,390171,390340,169
104,0,blank,0,432.93808,405.7087,390340,390508,168
104,0,blank,0,450.9508,403.87955,390508,390575,67
104,0,blank,0,309.52502,410.14016,390608,390775,167
104,0,blank,0,258.340716666667,412.173966666667,390775,390973,198
104,0,blank,0,201.5198,407.199716666667,390973,391171,198
104,0,blank,0,180.0449,407.06405,391171,391369,198
104,0,blank,0,154.3816,410.281366666667,391369,391568,199
104,0,blank,0,159.385616666667,408.451016666667,391568,391767,199
104,0,blank,0,219.148983333333,416.95785,391767,391965,198
104,0,blank,0,218.25315,408.97125,391965,392162,197
104,0,blank,0,223.36055,412.585983333333,392162,392356,194
104,0,blank,0,200.22035,410.33535,392356,392555,199
104,0,blank,0,189.39642,410.2202,392555,392724,169
104,0,blank,0,214.23405,410.937616666667,392724,392922,198
104,0,blank,0,193.310316666667,398.5027,392922,393121,199
104,18,char,106,180.314066666667,387.533316666667,393121,393317,196
104,18,char,106,206.643266666667,390.901566666667,393317,393515,198
104,18,char,106,213.08634,387.51724,393515,393681,166
104,18,char,106,213.60195,391.0394,393681,393748,67
104,7,"Enterthestring\n",42,193.8214,154.92384,393813,393982,169
104,7,"Enterthestring\n",42,193.25365,155.855366666667,393982,394180,198
104,0,blank,0,227.39185,121.816783333333,394180,394378,198
104,0,blank,0,215.02128,119.84902,394378,394546,168
104,7,"Enterthestring\n",42,179.80408,144.34036,394546,394713,167
104,0,blank,0,158.50112,81.88978,394713,394881,168
104,0,blank,0,156.59126,59.898,394881,395046,165
104,0,blank,0,148.79448,63.08128,395046,395217,171
104,0,blank,0,175.15808,75.54702,395217,395386,169
104,18,char,106,196.46362,385.03016,395419,395586,167
104,18,char,106,199.681833333333,391.766883333333,395586,395785,199
104,18,array2,107,430.37744,386.65414,395818,395985,167
104,0,blank,0,462.19708,384.91684,395985,396151,166
104,0,blank,0,472.8964,379.6143,396151,396318,167
104,18,[,108,435.176483333333,391.519066666667,396318,396517,199
104,18,array2,107,422.2352,392.113333333333,396517,396713,196
104,15,"%sand%sarenotanagrams.\n",87,344.6094,322.1524,396713,396746,33
104,0,blank,0,305.353,219.915666666667,396779,396974,195
104,0,blank,0,300.742283333333,221.079,396974,397170,196
104,0,blank,0,278.0228,253.132183333333,397170,397364,194
104,11,find_anagram,62,229.57615,241.589983333333,397364,397563,199
104,11,find_anagram,62,218.97355,233.7724,397563,397636,73
104,11,;,68,396.165,232.7263,397712,397832,120
104,0,blank,0,435.6306,238.89535,397832,398023,191
104,0,blank,0,434.18212,235.65646,398023,398191,168
104,0,blank,0,438.9752,239.3665,398191,398389,198
104,0,blank,0,446.8444,238.113683333333,398389,398586,197
104,0,blank,0,446.960166666667,236.607966666667,398586,398784,198
104,0,blank,0,445.523183333333,232.946633333333,398784,398982,198
104,0,blank,0,425.4877,231.70175,398982,399180,198
104,0,blank,0,441.70895,239.010716666667,399180,399377,197
104,11,find_anagram,62,196.45162,233.12522,399411,399579,168
104,0,blank,0,146.50476,44.88938,399613,399784,171
104,2,stdio,17,145.0532,35.45366,399784,399955,171
104,2,stdio,17,145.6652,41.86,399955,400024,69
104,0,blank,0,-350,-105,400058,400116,58
104,0,blank,0,998.689,609.1193,400144,400170,26
104,0,blank,0,146.189833333333,52.4741,400249,400440,191
104,0,blank,0,153.318266666667,58.5133666666667,400440,400543,103
104,0,blank,0,-350,-105,400579,400664,85
104,0,blank,0,170.061333333333,401.894983333333,400789,400983,194
104,0,blank,0,144.85935,398.9931,400983,401180,197
104,0,blank,0,105.7196,408.28075,401180,401369,189
104,0,blank,0,97.5502666666667,403.292033333333,401369,401457,88
104,18,array1,102,234.67665,397.6965,401489,401685,196
104,18,array1,102,226.284416666667,394.120316666667,401685,401880,195
104,18,array1,102,229.092766666667,393.108283333333,401880,402076,196
104,18,array1,102,226.0357,393.9751,402076,402141,65
104,18,array2,107,398.84646,397.73938,402174,402342,168
104,18,array2,107,395.448666666667,395.4533,402342,402540,198
104,18,),110,455.37804,383.81918,402540,402707,167
104,0,blank,0,468.99722,383.68134,402707,402877,170
104,0,blank,0,477.9143,375.803,402877,403045,168
104,0,blank,0,492.27142,385.9183,403045,403213,168
104,0,blank,0,489.83754,384.00046,403213,403381,168
104,0,blank,0,487.19472,379.09424,403381,403548,167
104,0,blank,0,492.15206,383.05266,403548,403715,167
104,18,],109,445.292966666667,378.004266666667,403715,403913,198
104,18,array2,107,421.702533333333,386.162883333333,403913,404112,199
104,18,array2,107,419.81692,382.48976,404112,404280,168
104,18,array2,107,400.02624,391.62948,404280,404448,168
104,0,blank,0,278.53656,401.52478,404448,404616,168
104,18,array1,102,236.83652,393.759,404616,404785,169
104,0,blank,0,204.71974,400.63182,404785,404957,172
104,0,blank,0,196.9762,402.17685,404957,405025,68
104,0,blank,0,177.31388,85.1333,405058,405226,168
104,0,blank,0,166.230366666667,81.2226166666667,405226,405424,198
104,0,blank,0,149.21734,73.41884,405424,405589,165
104,0,blank,0,161.0839,66.0155,405589,405756,167
104,0,blank,0,160.340816666667,56.5145,405756,405955,199
104,0,blank,0,119.98624,52.33294,405955,406123,168
104,0,blank,0,136.841133333333,44.7732666666667,406123,406226,103
104,1,Strings,9,343.89664,18.39036,406261,406430,169
104,1,Strings,9,365.754766666667,19.3662333333333,406430,406530,100
104,0,blank,0,535.1528,3.7405,406564,406731,167
104,1,are,10,432.59212,8.88562,406731,406900,169
104,1,are,10,421.7411,11.12396,406900,407066,166
104,1,are,10,421.812525,12.213775,407066,407201,135
104,0,blank,0,374.60992,288.32246,407268,407438,170
104,0,blank,0,374.69462,292.49116,407438,407607,169
104,0,blank,0,416.65636,340.6059,407607,407777,170
104,0,blank,0,427.46684,361.93882,407777,407946,169
104,0,blank,0,425.53178,402.1982,407946,408113,167
104,0,blank,0,303.4579,401.43402,408113,408280,167
104,0,blank,0,328.92995,421.271366666667,408280,408479,199
104,20,[,123,285.289816666667,433.785433333333,408479,408678,199
104,0,blank,0,186.024366666667,414.218933333333,408678,408876,198
104,0,blank,0,223.736083333333,376.739816666667,408876,409075,199
104,0,blank,0,210.66488,352.73366,409075,409241,166
104,15,"%sand%sarenotanagrams.\n",87,263.96578,329.32852,409241,409409,168
104,15,"%sand%sarenotanagrams.\n",87,348.7278,322.02485,409409,409544,135
104,0,blank,0,584.861233333333,306.59635,409577,409773,196
104,15,array2,91,581.230216666666,317.978066666667,409773,409972,199
104,15,array2,91,576.34056,317.85144,409972,410140,168
104,15,),92,621.97282,319.89834,410140,410309,169
104,0,blank,0,643.212,327.03788,410309,410477,168
104,0,blank,0,644.3068,326.75448,410477,410646,169
104,0,blank,0,650.7198,325.04074,410646,410815,169
104,0,blank,0,646.48934,326.48712,410815,410984,169
104,0,blank,0,653.41228,324.01464,410984,411155,171
104,0,blank,0,653.1051,322.81426,411155,411326,171
104,0,blank,0,654.2098,326.58888,411326,411496,170
104,0,blank,0,657.6962,319.39448,411496,411669,173
104,0,blank,0,656.5,324.730766666667,411669,411770,101
104,0,blank,0,401.18556,351.9637,411805,411978,173
104,0,blank,0,405.22518,352.50158,411978,412152,174
104,0,blank,0,391.29446,367.10104,412152,412323,171
104,18,array2,107,376.63174,386.2025,412323,412494,171
104,0,blank,0,308.8131,399.87418,412494,412666,172
104,0,blank,0,234.1558,405.791325,412666,412806,140
105,0,blank,0,126.02072,406.71966,412878,413051,173
105,0,blank,0,131.4289,402.12396,413051,413223,172
105,0,blank,0,123.01134,406.3593,413223,413396,173
105,0,blank,0,118.8151,406.35345,413396,413463,67
105,18,array1,102,243.13842,395.743,413496,413667,171
105,18,array1,102,258.782833333333,391.5632,413667,413770,103
105,0,blank,0,473.791566666667,384.668266666667,413804,414002,198
105,0,blank,0,474.8953,381.106233333333,414002,414200,198
105,0,blank,0,486.46135,394.580833333333,414200,414398,198
105,0,blank,0,484.49285,385.999533333333,414398,414594,196
105,0,blank,0,486.37594,391.15776,414594,414763,169
105,0,blank,0,491.3059,393.57298,414763,414930,167
105,0,blank,0,489.2841,389.30605,414930,414998,68
105,0,blank,0,344.2572,405.8451,415031,415229,198
105,0,blank,0,334.36908,400.87312,415229,415397,168
105,18,char,106,323.89388,396.90612,415397,415563,166
105,18,char,106,323.6326,395.879766666667,415563,415666,103
105,0,blank,0,472.34702,385.4273,415700,415869,169
105,0,blank,0,478.25824,391.682,415869,416038,169
105,0,blank,0,477.58716,394.03272,416038,416204,166
105,0,blank,0,313.147466666667,213.512433333333,416238,416436,198
105,5,array2,32,278.462966666667,95.9892833333333,416436,416635,199
105,5,array2,32,233.2831,102.01955,416635,416701,66
105,0,blank,0,-350,-105,417223,417408,185
105,11,array2,66,386.80858,242.16582,417445,417632,187
105,11,comma,65,329.123,234.1728,417632,417799,167
105,11,(,63,243.85212,230.44718,417799,417969,170
105,11,find_anagram,62,197.3295,237.4101,417969,418058,89
105,11,find_anagram,62,191.3182,238.9605,418058,418175,117
105,11,find_anagram,62,154.3861,236.9759,418175,418284,109
105,0,blank,0,188.759066666667,245.535733333333,418284,418470,186
105,11,find_anagram,62,242.5849,239.131533333333,418470,418669,199
105,11,array1,64,274.5088,234.147716666667,418669,418867,198
105,0,blank,0,318.2987,223.178533333333,418867,419064,197
105,11,array2,66,372.167066666667,223.140983333333,419064,419258,194
105,11,array2,66,337.818683333333,236.469516666667,419258,419450,192
105,11,comma,65,326.5573,235.009675,419450,419582,132
105,0,blank,0,228.54915,79.7026333333333,419615,419813,198
105,5,array2,32,244.5986,93.03464,419813,419981,168
105,5,array2,32,259.29998,97.57756,419981,420151,170
105,0,blank,0,264.98372,78.3959,420151,420318,167
105,0,blank,0,227.79218,47.45284,420318,420486,168
105,0,blank,0,201.646983333333,37.3148666666667,420486,420684,198
105,0,blank,0,207.69305,34.20925,420684,420751,67
105,1,Anagrams,11,483.892783333333,9.36668333333333,420784,420981,197
105,1,Anagrams,11,455.8507,16.5870333333333,420981,421179,198
105,0,blank,0,409.07306,24.64892,421179,421346,167
105,0,blank,0,473.206033333333,-17.2444166666667,421346,421545,199
105,0,blank,0,462.204183333333,-12.4803666666667,421545,421743,198
105,0,blank,0,444.849225,-2.6491,421743,421878,135
105,0,blank,0,331.23432,401.97448,421946,422119,173
105,0,blank,0,332.9864,408.26326,422119,422290,171
105,0,blank,0,347.20394,459.9048,422290,422462,172
105,0,blank,0,347.67878,454.0263,422462,422633,171
105,29,a,181,255.71254,622.07476,422666,422837,171
105,0,blank,0,235.08418,604.74296,422837,423006,169
105,0,blank,0,224.82942,598.4204,423006,423174,168
105,0,blank,0,261.63766,598.3295,423174,423344,170
105,0,blank,0,270.56378,603.541,423344,423511,167
105,27,0,171,269.043183333333,590.395166666667,423511,423709,198
105,27,0,171,265.02128,583.12992,423709,423875,166
105,0,blank,0,190.03258,483.77766,423875,424044,169
105,0,blank,0,197.977925,485.63665,424044,424183,139
105,0,blank,0,354.3444,691.12818,424218,424388,170
105,0,blank,0,319.43082,718.86802,424388,424557,169
105,0,blank,0,317.50265,720.30755,424557,424623,66
105,0,blank,0,274.5524,605.18112,424656,424825,169
105,27,0,171,277.14738,594.75774,424825,424992,167
105,0,blank,0,294.71068,601.00168,424992,425161,169
105,0,blank,0,289.712975,597.2871,425161,425299,138
105,0,blank,0,561.19206,741.74232,425334,425502,168
105,0,blank,0,567.17835,733.2996,425502,425638,136
105,0,blank,0,282.65686,634.30594,425672,425841,169
105,29,++,183,285.58026,620.59806,425841,426010,169
105,27,),172,288.96038,585.83074,426010,426183,173
105,0,blank,0,278.76572,597.68076,426183,426355,172
105,27,0,171,277.1762,592.3876,426355,426528,173
105,27,0,171,276.36068,591.42702,426528,426697,169
105,0,blank,0,283.27982,589.46166,426697,426866,169
105,27,0,171,277.7419,592.67472,426866,427035,169
105,27,0,171,279.64046,595.6061,427035,427206,171
105,27,0,171,273.75648,588.51468,427206,427377,171
105,0,blank,0,282.36236,586.37882,427377,427551,174
105,27,),172,291.21526,578.39976,427551,427722,171
105,27,0,171,279.6787,585.75706,427722,427895,173
105,27,0,171,280.46246,588.42278,427895,428069,174
105,0,blank,0,281.45442,591.35042,428069,428241,172
105,27,0,171,279.98938,588.82458,428241,428413,172
105,27,0,171,272.95834,577.26396,428413,428579,166
105,27,0,171,279.68764,578.20964,428579,428748,169
105,27,),172,291.65684,592.3956,428748,428917,169
105,0,blank,0,318.94804,584.36976,428917,429088,171
105,0,blank,0,318.97996,588.02598,429088,429261,173
105,0,blank,0,306.75608,583.92518,429261,429432,171
105,0,blank,0,301.8204,588.77068,429432,429600,168
105,0,blank,0,315.11596,586.42256,429600,429768,168
105,0,blank,0,313.24818,580.80486,429768,429937,169
105,0,blank,0,295.07204,586.4401,429937,430105,168
105,0,blank,0,293.77082,386.80816,430139,430305,166
105,18,],109,296.6297,383.29105,430305,430373,68
105,0,blank,0,466.04232,367.50366,430407,430573,166
105,0,blank,0,465.8812,378.21965,430573,430707,134
105,0,blank,0,216.949033333333,392.441083333333,430740,430939,199
105,18,char,106,190.35984,391.2751,430939,431107,168
105,18,(,100,171.09022,386.97462,431107,431274,167
105,0,blank,0,180.33568,349.87758,431274,431441,167
105,0,blank,0,202.23274,339.22068,431441,431610,169
105,0,blank,0,415.069933333333,306.950016666667,431643,431836,193
105,13,array1,79,483.151733333333,282.8868,431836,432028,192
105,13,array2,81,525.983575,274.46065,432028,432158,130
105,11,array2,66,340.04265,236.285216666667,432190,432385,195
105,11,array1,64,288.287433333333,238.315133333333,432385,432583,198
105,11,find_anagram,62,238.08014,239.68376,432583,432757,174
105,0,blank,0,256.9218,253.85174,432757,432929,172
105,0,blank,0,244.79896,250.97726,432929,433097,168
105,11,find_anagram,62,212.92784,226.4399,433097,433271,174
105,11,find_anagram,62,238.819,226.817,433271,433445,174
105,0,blank,0,267.30904,220.27042,433445,433618,173
105,0,blank,0,267.4463,221.30985,433618,433758,140
105,11,),67,398.68018,223.93444,433793,433961,168
105,0,blank,0,429.42936,217.60276,433961,434132,171
105,0,blank,0,443.5884,224.7224,434132,434165,33
105,11,array1,64,279.93264,225.684,434199,434369,170
105,11,(,63,251.09112,227.96826,434369,434545,176
105,11,find_anagram,62,198.26136,229.23872,434545,434718,173
105,10,array2,57,150.85696,219.7122,434718,434891,173
105,11,find_anagram,62,148.16294,224.35472,434891,435063,172
105,11,find_anagram,62,220.9854,224.64706,435063,435241,178
105,0,blank,0,231.53038,210.343,435241,435415,174
105,0,blank,0,198.42766,212.13504,435415,435588,173
105,0,blank,0,238.05992,201.12366,435588,435761,173
105,9,"Enteranotherstring\n",52,263.39086,190.18124,435761,435937,176
105,0,blank,0,290.06646,222.97456,435937,436110,173
105,11,array1,64,265.10406,225.44866,436110,436282,172
105,11,(,63,247.43338,231.0759,436282,436454,172
105,11,find_anagram,62,232.60496,231.69364,436454,436625,171
105,11,find_anagram,62,229.86972,228.78974,436625,436797,172
105,11,array1,64,284.90126,225.23296,436797,436966,169
105,0,blank,0,281.76356,221.62042,436966,437134,168
105,0,blank,0,356.5888,220.152166666667,437134,437332,198
105,11,array2,66,373.8793,225.7085,437332,437499,167
105,11,comma,65,329.12296,231.59262,437499,437667,168
105,11,array1,64,282.364116666667,223.954716666667,437667,437863,196
105,11,find_anagram,62,225.809616666667,224.855366666667,437863,438057,194
105,11,array1,64,258.665183333333,231.8595,438057,438255,198
105,11,array1,64,264.191425,225.496575,438255,438386,131
105,0,blank,0,425.1123,225.886,438446,438571,125
105,0,blank,0,416.0018,221.791,438571,438671,100
105,0,blank,0,432.855933333333,221.175933333333,438671,438848,177
105,0,blank,0,350.926316666667,210.586066666667,438848,439038,190
105,0,blank,0,305.336966666667,221.8681,439038,439230,192
105,11,(,63,243.813183333333,225.544033333333,439230,439429,199
105,11,(,63,245.50405,232.646783333333,439429,439626,197
105,11,find_anagram,62,214.666266666667,228.10905,439626,439821,195
105,11,find_anagram,62,179.8133,232.98535,439821,440017,196
105,11,find_anagram,62,167.47024,236.16598,440017,440184,167
105,11,array1,64,259.89608,233.20942,440184,440351,167
105,11,array1,64,264.25184,230.08522,440351,440522,171
105,0,blank,0,229.463966666667,418.000866666667,440556,440753,197
105,0,blank,0,221.269366666667,413.528966666667,440753,440950,197
105,18,comma,105,309.336066666667,397.400983333333,440950,441147,197
105,0,blank,0,321.2601,391.20655,441147,441277,130
105,0,blank,0,256.4677,116.000783333333,441309,441506,197
105,5,array2,32,250.82906,104.58166,441506,441672,166
105,5,array2,32,247.5558,101.145,441672,441740,68
105,13,"%sand%sareanagrams.\n",77,349.5166,281.12152,441774,441944,170
105,0,blank,0,417.48098,248.52086,441944,442112,168
105,0,blank,0,440.74725,241.44165,442112,442310,198
105,0,blank,0,417.622983333333,225.111466666667,442310,442509,199
105,0,blank,0,372.558875,190.306525,442509,442640,131
105,0,blank,0,193.66964,44.73724,442673,442843,170
105,0,blank,0,187.7995,43.43444,442843,443015,172
105,0,blank,0,142.65448,49.4514,443015,443188,173
105,0,blank,0,145.84226,50.46518,443188,443360,172
105,0,blank,0,150.26878,55.58726,443360,443531,171
105,0,blank,0,149.84408,51.86732,443531,443707,176
105,0,blank,0,155.17062,55.6495,443707,443880,173
105,0,blank,0,153.71854,51.33106,443880,444056,176
105,0,blank,0,193.53822,45.34948,444056,444229,173
105,0,blank,0,218.43748,35.2796,444229,444401,172
105,0,blank,0,239.90916,24.96018,444401,444575,174
105,0,blank,0,239.48446,27.67,444575,444749,174
105,0,blank,0,224.10534,26.5028,444749,444924,175
105,0,blank,0,227.7475,26.03868,444924,445098,174
105,0,blank,0,227.31092,30.3822,445098,445274,176
105,0,blank,0,242.99428,27.32196,445274,445449,175
105,0,blank,0,234.44888,29.64666,445449,445624,175
105,0,blank,0,226.0941,34.76928,445624,445797,173
105,0,blank,0,226.95132,28.80788,445797,445973,176
105,0,blank,0,229.67845,33.59455,445973,446113,140
105,0,blank,0,318.1334,120.42424,446149,446319,170
105,0,blank,0,349.51146,169.2736,446319,446486,167
105,0,blank,0,377.62212,217.63448,446486,446655,169
105,0,blank,0,396.4816,247.69256,446655,446823,168
105,11,),67,401.250166666667,234.73695,446823,447022,199
105,0,blank,0,421.91222,243.53866,447022,447190,168
105,0,blank,0,424.64595,243.104033333333,447190,447389,199
105,18,array1,102,238.51614,395.66896,447423,447590,167
105,0,blank,0,253.61114,414.36738,447590,447757,167
105,18,array1,102,263.27874,397.57714,447757,447924,167
105,0,blank,0,159.14286,412.57768,447924,448091,167
105,0,blank,0,184.18186,413.08174,448091,448258,167
105,0,blank,0,234.41466,399.55864,448258,448426,168
105,18,array1,102,242.0851,395.54785,448426,448492,66
105,0,blank,0,474.392016666667,396.791583333333,448525,448718,193
105,0,blank,0,472.832016666667,399.7123,448718,448915,197
105,0,blank,0,472.464316666667,393.901533333333,448915,449111,196
105,18,array2,107,422.27072,386.89972,449111,449277,166
105,0,blank,0,317.95536,376.7435,449277,449445,168
105,0,blank,0,419.77454,306.27702,449445,449614,169
105,0,blank,0,439.53286,303.55754,449614,449783,169
105,0,blank,0,435.4196,302.0526,449783,449816,33
105,13,array2,81,541.31912,284.36614,449850,450023,173
105,13,array2,81,543.111,283.7625,450023,450058,35
105,0,blank,0,253.0465,157.13354,450094,450264,170
105,2,>,20,181.03878,27.91032,450298,450470,172
105,0,blank,0,184.18792,25.86142,450470,450643,173
105,0,blank,0,210.44244,28.73818,450643,450815,172
105,0,blank,0,206.78388,26.904,450815,450986,171
105,1,Check,6,180.85108,18.9304,450986,451158,172
105,1,Anagrams,11,454.87222,11.50142,451193,451361,168
105,1,are,10,419.13746,10.172,451361,451527,166
105,1,are,10,432.26916,10.12124,451527,451696,169
105,1,Anagrams,11,472.96868,22.443,451696,451867,171
105,1,Strings,9,375.37266,10.24696,451867,452034,167
105,1,Strings,9,374.289666666667,9.6315,452034,452134,100
105,0,blank,0,181.14646,64.61568,452168,452342,174
105,0,blank,0,184.42358,72.283,452342,452516,174
105,5,array2,32,238.23358,102.14138,452516,452688,172
105,5,array2,32,235.557233333333,99.5378,452688,452791,103
105,9,"Enteranotherstring\n",52,332.86364,180.29932,452825,452994,169
105,9,;,54,369.05616,196.06532,452994,453163,169
105,0,blank,0,394.308816666667,203.357866666667,453163,453360,197
105,0,blank,0,411.9894,194.58645,453360,453558,198
105,0,blank,0,415.286266666667,192.585533333333,453558,453756,198
105,9,"Enteranotherstring\n",52,345.9944,187.248733333333,453756,453953,197
105,9,"Enteranotherstring\n",52,264.261266666667,193.853966666667,453953,454151,198
105,9,"Enteranotherstring\n",52,233.475725,196.836575,454151,454282,131
105,5,100,34,183.03084,96.5882,454314,454483,169
105,0,blank,0,171.55568,84.24736,454483,454654,171
105,0,blank,0,149.10182,64.23786,454654,454828,174
105,0,blank,0,147.4964,71.78345,454828,454898,70
105,0,blank,0,376.24962,190.69798,454933,455100,167
105,0,blank,0,392.6473,184.96938,455100,455269,169
105,0,blank,0,410.3467,190.41335,455269,455335,66
105,9,"Enteranotherstring\n",52,262.6778,199.0445,455369,455536,167
105,9,"Enteranotherstring\n",52,216.38186,195.45574,455536,455706,170
105,9,"Enteranotherstring\n",52,204.61546,195.3191,455706,455876,170
105,0,blank,0,265.95512,212.69008,455876,456045,169
105,11,array2,66,345.9039,227.6672,456045,456244,199
105,0,blank,0,418.785633333333,226.98935,456244,456442,198
105,0,blank,0,431.06502,232.87346,456442,456608,166
105,0,blank,0,430.8438,233.81444,456608,456775,167
105,0,blank,0,432.94344,240.25714,456775,456942,167
105,0,blank,0,431.532025,238.8892,456942,457077,135
105,0,blank,0,398.85982,365.58528,457111,457279,168
105,18,array1,102,277.49418,391.70952,457279,457447,168
105,18,array1,102,226.99132,397.95178,457447,457619,172
105,20,num2,122,259.24942,424.87268,457619,457788,169
105,0,blank,0,262.4054,482.02892,457788,457957,169
105,23,a,152,261.27286,490.06178,457957,458125,168
105,0,blank,0,295.78974,451.21802,458125,458294,169
105,20,],125,319.5018,439.77416,458294,458461,167
105,20,=,132,333.8541,440.16722,458461,458629,168
105,0,blank,0,482.90492,400.8597,458629,458796,167
105,0,blank,0,479.27965,404.2325,458796,458980,184
105,0,blank,0,302.58515,575.9387,459099,459294,195
105,0,blank,0,238.10154,584.1,459294,459462,168
105,27,==,170,234.9399,588.331016666667,459462,459661,199
105,0,blank,0,279.62872,596.28214,459661,459834,173
105,0,blank,0,294.73168,592.96904,459834,460009,175
105,0,blank,0,305.64355,583.9746,460009,460075,66
105,0,blank,0,476.08988,420.06658,460108,460278,170
105,0,blank,0,482.04292,424.16736,460278,460451,173
105,0,blank,0,500.54134,390.5956,460451,460620,169
105,0,blank,0,462.1294,365.57434,460620,460795,175
105,0,blank,0,363.56972,248.55364,460795,460974,179
105,11,array2,66,360.2556,232.1023,460974,461046,72
105,0,blank,0,312.65268,667.81896,461083,461258,175
105,0,blank,0,332.11738,628.6379,461258,461428,170
105,0,blank,0,329.61404,600.46414,461428,461595,167
105,0,blank,0,325.74716,611.58102,461595,461763,168
105,13,array1,79,448.09668,271.36134,461797,461965,168
105,0,blank,0,474.7895,211.23584,461965,462135,170
105,0,blank,0,484.41168,257.81988,462135,462307,172
105,0,blank,0,491.49782,288.41742,462307,462483,176
105,0,blank,0,466.49155,319.5873,462483,462555,72
105,0,blank,0,314.72526,610.35892,462626,462802,176
105,0,blank,0,315.05084,607.34736,462802,462978,176
105,0,blank,0,319.1758,608.00272,462978,463152,174
105,0,blank,0,329.9698,607.16028,463152,463325,173
105,0,blank,0,348.1049,538.9345,463325,463360,35
105,0,blank,0,412.24884,374.45526,463394,463568,174
105,18,array2,107,411.80116,380.21748,463568,463741,173
105,18,array2,107,414.65994,377.56194,463741,463919,178
105,15,"%sand%sarenotanagrams.\n",87,406.704225,314.7873,463919,464066,147
105,0,blank,0,359.43448,141.0968,464101,464277,176
105,0,blank,0,360.58378,143.01106,464277,464450,173
105,0,blank,0,204.05894,50.6327,464486,464657,171
105,0,blank,0,234.34485,38.62115,464657,464727,70
105,0,blank,0,376.9394,25.83656,464762,464938,176
105,0,blank,0,563.42852,0.401259999999996,464972,465149,177
105,1,/,13,561.78182,4.81912,465149,465319,170
105,1,/,13,556.23685,12.36685,465319,465458,139
105,13,"%sand%sareanagrams.\n",77,406.47416,271.0842,465490,465666,176
105,13,"%sand%sareanagrams.\n",77,401.6827,270.8876,465666,465700,34
105,0,blank,0,335.4641,447.8912,465735,465915,180
105,0,blank,0,337.28722,416.00738,465915,466097,182
105,18,array2,107,398.88068,389.0363,466097,466278,181
105,0,blank,0,463.917025,398.7195,466278,466422,144
105,0,blank,0,161.96192,401.07434,466457,466632,175
105,0,blank,0,164.3156,411.55374,466632,466805,173
105,0,blank,0,163.2715,403.9884,466805,466874,69
105,0,blank,0,353.06322,307.65896,466907,467077,170
105,0,blank,0,356.611833333333,294.664833333333,467077,467181,104
105,0,blank,0,473.6459,198.1813,467216,467383,167
105,0,blank,0,478.1548,190.4914,467383,467416,33
105,0,blank,0,247.40354,38.55756,467449,467617,168
105,0,blank,0,246.24906,44.2384,467617,467787,170
105,0,blank,0,225.32492,41.1923,467787,467961,174
105,0,blank,0,207.70154,43.22092,467961,468130,169
105,0,blank,0,212.6292,45.5553,468130,468301,171
105,0,blank,0,175.59278,57.47812,468301,468473,172
105,0,blank,0,160.03304,55.12066,468473,468641,168
105,0,blank,0,159.9326,53.4167,468641,468812,171
105,0,blank,0,215.83216,62.0973,468812,468984,172
105,0,blank,0,259.63356,67.91466,468984,469160,176
105,0,blank,0,260.42854,73.04212,469160,469331,171
105,0,blank,0,297.763,114.2916,469331,469502,171
105,0,blank,0,196.74638,71.7391,469502,469676,174
105,0,blank,0,150.65422,55.96122,469676,469853,177
105,0,blank,0,153.87116,60.10214,469853,470031,178
105,0,blank,0,164.22446,58.65052,470031,470207,176
105,0,blank,0,177.3692,65.3677,470207,470276,69
105,0,blank,0,251.04918,413.6815,470344,470519,175
105,0,blank,0,237.28306,412.22044,470519,470695,176
105,0,blank,0,183.4656,398.32406,470695,470870,175
105,0,blank,0,194.10028,399.37578,470870,471048,178
105,18,char,106,187.50178,392.64572,471048,471225,177
105,0,blank,0,470.47606,65.48656,471294,471470,176
105,0,blank,0,467.882475,78.378325,471470,471606,136
105,0,blank,0,-350,-105,471641,471778,137
105,0,blank,0,535.2823,260.6616,471804,471833,29
105,0,blank,0,526.59445,263.671283333333,471905,472100,195
105,0,blank,0,521.9561,263.45755,472100,472168,68
105,0,blank,0,393.54178,474.82924,472202,472371,169
105,0,blank,0,395.74024,477.47976,472371,472541,170
105,0,blank,0,709.2864,770.03384,472575,472743,168
105,0,blank,0,709.1572,769.64942,472743,472909,166
105,0,blank,0,674.3059,767.5126,472909,473008,99
105,0,blank,0,236.16618,616.01158,473041,473209,168
105,0,blank,0,223.0018,618.43295,473209,473276,67
105,0,blank,0,266.2852,419.8473,473310,473481,171
105,0,blank,0,216.64118,411.31324,473481,473650,169
105,0,blank,0,214.32134,408.07556,473650,473818,168
105,0,blank,0,163.56226,413.74102,473818,473989,171
105,0,blank,0,204.138366666667,412.79325,473989,474184,195
105,0,blank,0,204.410966666667,407.20405,474184,474380,196
105,18,char,106,211.38545,397.733,474380,474575,195
105,15,"%sand%sarenotanagrams.\n",87,208.711266666667,321.891716666667,474575,474769,194
105,15,"%sand%sarenotanagrams.\n",87,214.4861,322.11415,474769,474833,64
105,5,comma,31,206.229516666667,93.3136166666667,474865,475058,193
105,5,comma,31,209.1484,101.470383333333,475058,475254,196
105,0,blank,0,155.24015,83.1461666666667,475254,475448,194
105,0,blank,0,141.4891,84.658,475448,475480,32
105,21,0,142,273.8219,463.392525,475634,475818,184
105,0,blank,0,242.4539,446.494975,475818,475987,169
105,21,!=,141,227.270683333333,444.892116666667,475987,476183,196
105,0,blank,0,209.742783333333,400.061933333333,476183,476377,194
105,0,blank,0,202.78716,414.91366,476377,476564,187
