Frameno_fix,lineno_fix,Tokenname_fix,tokens_id,gaze_X_fix,gaze_Y_fix,timestamp_fix_start,timestamp_fix_end,time_duration
100,0,blank,0,-323,-105,3504,3558,54
100,0,blank,0,-323,-105,3558,3830,272
100,0,blank,0,-323,-105,3830,4264,434
100,0,blank,0,-323,-105,4264,4319,55
100,0,blank,0,-323,-105,4561,4723,162
100,0,blank,0,-323,-105,4723,4764,41
100,0,blank,0,-323,-105,4764,4975,211
100,0,blank,0,-323,-105,4975,5093,118
100,0,blank,0,295.32028,116.17372,5429,5580,151
100,0,blank,0,305.86565,136.74535,5729,5849,120
100,0,blank,0,283.78235,75.4253,6036,6092,56
100,16,"\nDisplayingthealternatenodes\n",84,217.29575,341.42035,6214,6271,57
100,0,blank,0,133.7029,135.8433,6637,6665,28
100,11,(,57,121.91705,230.1751,6851,6907,56
100,0,blank,0,104.48295,271.1907,6936,6992,56
100,11,delete,56,107.3129,225.9112,7018,7130,112
100,0,blank,0,161.090175,-27.31695,7159,7271,112
100,4,node,26,95.0194666666666,84.0533333333333,7271,7444,173
100,6,int,28,71.0069833333333,131.339266666667,7444,7619,175
100,0,blank,0,91.12212,110.12654,7619,7765,146
100,0,blank,0,100.49372,156.56682,7765,7940,175
100,0,blank,0,165.617,108.4691,7940,7970,30
100,0,blank,0,194.7055,72.9978,8059,8090,31
100,0,blank,0,199.066633333333,109.316966666667,8120,8291,171
100,0,blank,0,195.101671428571,124.1857,8291,8490,199
100,0,blank,0,90.0728333333333,175.8885,8490,8671,181
100,0,blank,0,79.4124666666667,167.744666666667,8671,8845,174
100,0,blank,0,101.949416666667,160.75075,8845,9019,174
100,0,blank,0,-323,-105,9102,9279,177
100,0,blank,0,-323,-105,9279,9476,197
100,0,blank,0,-323,-105,9476,9625,149
100,0,blank,0,-323,-105,9625,9757,132
100,0,blank,0,50.3118,222.8061,9808,9916,108
100,0,blank,0,36.7278,252.0282,9916,10026,110
100,11,delete,56,59.61235,242.18515,10026,10176,150
100,10,void,47,38.1632666666667,221.5113,10176,10289,113
100,10,display,48,58.9938,214.1624,10319,10348,29
100,0,blank,0,40.9282,91.9079,10433,10463,30
100,10,(,49,127.14195,208.68795,10493,10552,59
100,11,*,61,245.08575,234.632566666667,10610,10794,184
100,0,blank,0,160.665266666667,153.3582,10794,10883,89
100,0,blank,0,256.0437,119.31885,10913,10972,59
100,10,node,51,230.5536,206.28635,11001,11057,56
100,10,struct,50,154.8397,210.4328,11085,11114,29
100,10,struct,50,175.9032,208.1403,11200,11230,30
100,9,struct,41,143.285028571429,198.633414285714,11315,11508,193
100,11,delete,56,109.376957142857,240.5438,11508,11704,196
100,0,blank,0,111.4669,261.2269,11704,11787,83
100,0,blank,0,234.2625,314.0988,11939,11968,29
100,0,blank,0,271.230533333333,162.551266666667,12165,12340,175
100,0,blank,0,388.3605,163.057266666667,12412,12534,122
100,10,*,52,259.14395,213.0961,12568,12630,62
100,16,"\nDisplayingthealternatenodes\n",84,338.0457,339.0642,12659,12689,30
100,0,blank,0,512.2001,357.3382,12806,12874,68
100,0,blank,0,-323,-105,12904,12937,33
100,10,display,48,59.4278333333333,217.481566666667,13167,13315,148
100,0,blank,0,304.9625,272.856,14017,14042,25
100,10,node,51,215.374925,204.171825,15663,15842,179
100,10,struct,50,142.39575,218.868,15842,15892,50
100,10,),53,269.04,214.3364,16077,16102,25
100,0,blank,0,42.74095,257.6707,16555,16655,100
100,0,blank,0,61.7103,271.3535,16859,17040,181
100,16,printf,82,44.17835,343.38955,17040,17218,178
100,17,display,87,54.4809,373.20795,17218,17318,100
100,14,node,70,143.8338,290.5425,17772,18102,330
100,18,&,94,121.0994,395.9261,18128,18180,52
100,0,blank,0,-323,-105,18428,18609,181
100,0,blank,0,-323,-105,18609,18784,175
100,0,blank,0,-323,-105,18784,18816,32
100,0,blank,0,-323,-105,18816,19205,389
100,0,blank,0,-323,-105,19205,19506,301
100,0,blank,0,-323,-105,19506,19714,208
100,0,blank,0,-323,-105,19714,19846,132
100,0,blank,0,-323,-105,19846,20017,171
100,0,blank,0,-323,-105,20017,20185,168
100,0,blank,0,-323,-105,20185,20436,251
100,0,blank,0,-323,-105,20436,20786,350
100,0,blank,0,-323,-105,20786,20849,63
100,0,blank,0,-323,-105,20849,21083,234
100,0,blank,0,-323,-105,21083,21279,196
100,0,blank,0,-323,-105,21279,21548,269
100,0,blank,0,-323,-105,21548,21699,151
100,15,generate,76,49.0393,328.3442,21828,21862,34
100,0,blank,0,-323,-105,22153,22332,179
100,0,blank,0,-323,-105,22332,22510,178
100,0,blank,0,-323,-105,22510,22549,39
100,0,blank,0,-323,-105,22737,22928,191
100,0,blank,0,-323,-105,22928,23022,94
100,17,display,87,94.0673,367.1227,23077,23102,25
100,0,blank,0,-323,-105,23131,23219,88
100,0,blank,0,-8.79430000000002,203.394,23252,23277,25
100,0,blank,0,-323,-105,23372,23549,177
100,0,blank,0,-323,-105,23549,23729,180
100,0,blank,0,-323,-105,23729,23915,186
100,0,blank,0,-323,-105,23915,24347,432
100,0,blank,0,-323,-105,24347,24377,30
100,0,blank,0,-323,-105,24377,24811,434
100,0,blank,0,-323,-105,24811,25311,500
100,0,blank,0,-323,-105,25311,25386,75
100,0,blank,0,-323,-105,25386,25641,255
100,0,blank,0,-323,-105,25641,25896,255
100,0,blank,0,-323,-105,25896,26069,173
100,0,blank,0,-323,-105,26069,26163,94
100,0,blank,0,-323,-105,26163,26535,372
100,0,blank,0,-323,-105,26535,26895,360
100,0,blank,0,-323,-105,26895,27391,496
100,0,blank,0,-323,-105,27391,27576,185
100,0,blank,0,-323,-105,27576,27805,229
100,0,blank,0,-323,-105,27805,27830,25
100,0,blank,0,-323,-105,27830,28123,293
100,0,blank,0,-323,-105,28123,28219,96
100,0,blank,0,-323,-105,28219,28437,218
100,0,blank,0,-323,-105,28437,28475,38
100,0,blank,0,-323,-105,28475,28730,255
100,0,blank,0,-323,-105,28730,28985,255
100,0,blank,0,-323,-105,28985,29161,176
100,0,blank,0,-323,-105,29161,29351,190
100,0,blank,0,-323,-105,29351,29377,26
100,0,blank,0,-323,-105,29377,29876,499
100,0,blank,0,-323,-105,29876,30610,734
100,0,blank,0,-323,-105,30610,30809,199
100,0,blank,0,-323,-105,30809,31002,193
100,0,blank,0,-323,-105,31002,31247,245
100,0,blank,0,-323,-105,31247,31616,369
100,0,blank,0,-323,-105,31616,32009,393
100,0,blank,0,-323,-105,32009,32033,24
100,0,blank,0,-323,-105,32033,32896,863
100,0,blank,0,-323,-105,32896,33061,165
100,0,blank,0,-323,-105,33061,33215,154
100,0,blank,0,-323,-105,33215,33368,153
100,0,blank,0,-323,-105,33368,33541,173
100,0,blank,0,-323,-105,33541,34056,515
100,0,blank,0,-323,-105,34056,34310,254
100,0,blank,0,-323,-105,34310,34486,176
100,0,blank,0,-323,-105,34486,34582,96
100,0,blank,0,-323,-105,34582,34744,162
100,0,blank,0,-323,-105,34744,34970,226
100,0,blank,0,-323,-105,34970,35219,249
100,0,blank,0,-323,-105,35219,35430,211
100,0,blank,0,-323,-105,35430,35650,220
100,0,blank,0,-323,-105,35650,35868,218
100,0,blank,0,-323,-105,35868,36087,219
100,0,blank,0,-323,-105,36087,36232,145
100,0,blank,0,-323,-105,36232,36784,552
100,0,blank,0,-323,-105,36784,37470,686
100,0,blank,0,-323,-105,37470,37625,155
100,0,blank,0,-323,-105,37625,37731,106
100,0,blank,0,-323,-105,37731,38031,300
100,0,blank,0,-323,-105,38031,38339,308
100,0,blank,0,-323,-105,38339,38529,190
100,0,blank,0,-323,-105,38529,38643,114
100,0,blank,0,-323,-105,38643,38821,178
100,0,blank,0,-323,-105,38821,38917,96
100,0,blank,0,-323,-105,38917,39101,184
100,0,blank,0,-323,-105,39101,39608,507
100,0,blank,0,-323,-105,39608,40104,496
100,0,blank,0,-323,-105,40104,40795,691
100,0,blank,0,-323,-105,40795,40993,198
100,0,blank,0,-323,-105,40993,41154,161
100,0,blank,0,-323,-105,41154,41314,160
100,0,blank,0,-323,-105,41314,41480,166
100,0,blank,0,-323,-105,41480,42014,534
100,0,blank,0,-323,-105,42014,42201,187
100,0,blank,0,-323,-105,42201,42321,120
100,0,blank,0,-323,-105,42321,42765,444
100,0,blank,0,-323,-105,42765,43181,416
100,0,blank,0,-323,-105,43181,43361,180
100,0,blank,0,-323,-105,43361,43479,118
100,0,blank,0,-323,-105,43479,43597,118
100,0,blank,0,-323,-105,43597,43702,105
100,0,blank,0,-323,-105,43702,43916,214
100,0,blank,0,-323,-105,43916,44297,381
100,0,blank,0,-323,-105,44297,44495,198
100,0,blank,0,-323,-105,44495,44645,150
100,0,blank,0,-323,-105,44645,44879,234
100,0,blank,0,-323,-105,44879,44911,32
100,0,blank,0,-323,-105,44911,45376,465
100,0,blank,0,-323,-105,45376,45854,478
100,0,blank,0,-323,-105,45854,45923,69
100,0,blank,0,-323,-105,45923,46409,486
100,0,blank,0,-323,-105,46409,46478,69
100,0,blank,0,-323,-105,46478,46807,329
100,0,blank,0,-323,-105,46807,46839,32
100,0,blank,0,-323,-105,46839,47089,250
100,0,blank,0,-323,-105,47089,47136,47
101,0,blank,0,-323,-105,47622,47867,245
101,0,blank,0,-323,-105,47867,47940,73
101,0,blank,0,-323,-105,47940,48107,167
101,0,blank,0,-323,-105,48107,48150,43
101,0,blank,0,-323,-105,48150,48349,199
101,0,blank,0,-323,-105,48349,48403,54
101,0,blank,0,-323,-105,48403,48616,213
101,0,blank,0,-323,-105,48616,48663,47
101,0,blank,0,-323,-105,48663,48853,190
101,0,blank,0,-323,-105,48853,49121,268
101,0,blank,0,-323,-105,49121,49146,25
101,0,blank,0,-323,-105,49146,49431,285
101,0,blank,0,-323,-105,49431,49708,277
101,0,blank,0,-323,-105,49708,49779,71
101,0,blank,0,-323,-105,49779,50190,411
101,0,blank,0,-323,-105,50190,50350,160
101,0,blank,0,-323,-105,50350,50925,575
101,0,blank,0,-323,-105,50925,51124,199
101,0,blank,0,-323,-105,51124,51288,164
101,0,blank,0,-323,-105,51288,51594,306
101,0,blank,0,-323,-105,51594,51622,28
101,0,blank,0,-323,-105,51622,51883,261
101,0,blank,0,-323,-105,51883,52133,250
101,0,blank,0,-323,-105,52312,52616,304
101,0,blank,0,-323,-105,52616,52725,109
101,0,blank,0,-323,-105,52725,52958,233
101,0,blank,0,-323,-105,52958,53137,179
101,0,blank,0,-323,-105,53137,53323,186
101,0,blank,0,-323,-105,53323,53491,168
101,0,blank,0,-323,-105,53491,53721,230
101,0,blank,0,-323,-105,53721,53800,79
101,0,blank,0,-323,-105,53800,53970,170
101,0,blank,0,-323,-105,53970,54147,177
101,0,blank,0,-323,-105,54147,54341,194
101,0,blank,0,-323,-105,54341,54540,199
101,0,blank,0,-323,-105,54540,54684,144
101,0,blank,0,-323,-105,55053,55236,183
101,0,blank,0,-323,-105,55236,55418,182
101,0,blank,0,-323,-105,55418,55601,183
101,0,blank,0,-323,-105,55601,55781,180
101,0,blank,0,-323,-105,55781,55955,174
101,0,blank,0,-323,-105,55955,56125,170
101,0,blank,0,-323,-105,56125,56350,225
101,0,blank,0,-323,-105,56350,56574,224
101,0,blank,0,-323,-105,56574,56751,177
101,0,blank,0,-323,-105,56751,56944,193
101,0,blank,0,-323,-105,56944,57098,154
101,0,blank,0,-323,-105,57098,57283,185
101,0,blank,0,-323,-105,57283,57362,79
101,0,blank,0,-323,-105,57362,57822,460
101,0,blank,0,-323,-105,57822,57994,172
101,0,blank,0,-323,-105,57994,58190,196
101,0,blank,0,-323,-105,58190,58410,220
101,0,blank,0,-323,-105,58410,58520,110
101,0,blank,0,-323,-105,58520,58617,97
101,0,blank,0,-323,-105,58617,58767,150
101,0,blank,0,-323,-105,58767,58893,126
101,0,blank,0,-323,-105,58893,59049,156
101,0,blank,0,-323,-105,59049,59149,100
101,0,blank,0,-323,-105,59149,59322,173
101,0,blank,0,-323,-105,59322,59790,468
101,0,blank,0,-323,-105,59790,59960,170
101,0,blank,0,-323,-105,59960,60195,235
101,0,blank,0,-323,-105,60195,60226,31
101,0,blank,0,-323,-105,60226,60450,224
101,0,blank,0,-323,-105,60450,60475,25
101,0,blank,0,-323,-105,60475,60690,215
101,0,blank,0,-323,-105,60690,60715,25
101,0,blank,0,-323,-105,60715,60982,267
101,0,blank,0,-323,-105,60982,61169,187
101,0,blank,0,-323,-105,61169,61433,264
101,0,blank,0,-323,-105,61433,61736,303
101,0,blank,0,-323,-105,61736,61927,191
101,0,blank,0,-323,-105,61927,62022,95
101,0,blank,0,-323,-105,62022,62387,365
101,0,blank,0,-323,-105,62387,62772,385
101,0,blank,0,-323,-105,62772,62837,65
101,0,blank,0,-323,-105,62837,63227,390
101,0,blank,0,-323,-105,63227,63605,378
101,0,blank,0,-323,-105,63605,63723,118
101,0,blank,0,-323,-105,63723,63976,253
101,0,blank,0,-323,-105,63976,64008,32
101,0,blank,0,-323,-105,64008,64426,418
101,0,blank,0,-323,-105,64426,64841,415
101,0,blank,0,-323,-105,64841,65023,182
101,0,blank,0,-323,-105,65023,65201,178
101,0,blank,0,-323,-105,65201,65387,186
101,0,blank,0,-323,-105,65387,65654,267
101,0,blank,0,-323,-105,65654,65949,295
101,0,blank,0,-323,-105,65949,66242,293
101,0,blank,0,-323,-105,66242,66294,52
102,0,blank,0,-323,-105,67010,67155,145
102,0,blank,0,-323,-105,67155,67221,66
102,0,blank,0,-323,-105,67221,67407,186
102,0,blank,0,-323,-105,67407,67592,185
102,0,blank,0,-323,-105,67592,67724,132
102,0,blank,0,-323,-105,67724,67919,195
102,0,blank,0,-323,-105,67919,68118,199
102,0,blank,0,-323,-105,68118,68288,170
102,0,blank,0,-323,-105,68288,68456,168
102,0,blank,0,-323,-105,68456,68626,170
102,0,blank,0,-323,-105,68626,68811,185
102,0,blank,0,-323,-105,68811,68944,133
102,0,blank,0,-323,-105,68944,69136,192
102,0,blank,0,-323,-105,69136,69273,137
102,0,blank,0,-323,-105,69273,69464,191
102,0,blank,0,-323,-105,69464,69586,122
102,0,blank,0,-323,-105,69586,69944,358
102,0,blank,0,-323,-105,69944,69985,41
102,0,blank,0,-323,-105,69985,70160,175
102,0,blank,0,-323,-105,70160,70508,348
102,0,blank,0,-323,-105,70508,70655,147
102,0,blank,0,-323,-105,70655,70911,256
102,0,blank,0,-323,-105,70911,71168,257
102,0,blank,0,-323,-105,71168,71327,159
102,0,blank,0,-323,-105,71327,71466,139
102,0,blank,0,-323,-105,71466,71635,169
102,0,blank,0,-323,-105,71635,71813,178
102,0,blank,0,-323,-105,71813,71995,182
102,0,blank,0,-323,-105,71995,72174,179
102,0,blank,0,-323,-105,72174,72372,198
102,0,blank,0,-323,-105,72372,72559,187
102,0,blank,0,-323,-105,72559,72712,153
102,0,blank,0,-323,-105,72712,72820,108
102,0,blank,0,-323,-105,72820,73012,192
102,0,blank,0,-323,-105,73012,73188,176
102,0,blank,0,-323,-105,73188,73384,196
102,0,blank,0,-323,-105,73384,73549,165
102,0,blank,0,-323,-105,73549,73977,428
102,0,blank,0,-323,-105,73977,74337,360
102,0,blank,0,-323,-105,74337,74401,64
102,0,blank,0,-323,-105,74401,75069,668
102,0,blank,0,-323,-105,75069,75268,199
102,0,blank,0,-323,-105,75268,75472,204
102,0,blank,0,-323,-105,75472,75497,25
102,0,blank,0,-323,-105,75497,75968,471
102,0,blank,0,-323,-105,75968,76433,465
102,0,blank,0,-323,-105,76433,76480,47
102,0,blank,0,-323,-105,76480,77055,575
102,0,blank,0,-323,-105,77055,77251,196
102,0,blank,0,-323,-105,77251,77404,153
102,0,blank,0,-323,-105,77404,77518,114
102,0,blank,0,-323,-105,77518,77716,198
102,0,blank,0,-323,-105,77716,77893,177
102,0,blank,0,-323,-105,77893,78082,189
102,0,blank,0,-323,-105,78082,78280,198
102,0,blank,0,-323,-105,78280,78432,152
102,0,blank,0,-323,-105,78432,78548,116
102,0,blank,0,-323,-105,78548,78657,109
102,0,blank,0,-323,-105,78657,78768,111
102,0,blank,0,-323,-105,78768,78977,209
102,0,blank,0,-323,-105,78977,79219,242
102,0,blank,0,-323,-105,79219,79389,170
103,0,blank,0,-323,-105,80152,80726,574
103,0,blank,0,-323,-105,80726,80922,196
103,0,blank,0,-323,-105,80922,81203,281
103,0,blank,0,-323,-105,81203,81477,274
103,0,blank,0,-323,-105,81477,81797,320
103,0,blank,0,-323,-105,81797,81975,178
103,0,blank,0,-323,-105,81975,82152,177
103,0,blank,0,-323,-105,82152,82321,169
103,0,blank,0,-323,-105,82321,82455,134
103,0,blank,0,-323,-105,82455,82653,198
103,0,blank,0,-323,-105,82653,82774,121
103,0,blank,0,-323,-105,82774,82955,181
103,0,blank,0,-323,-105,82955,83131,176
103,0,blank,0,-323,-105,83131,83234,103
103,0,blank,0,-323,-105,83234,83425,191
103,0,blank,0,-323,-105,83425,83563,138
103,0,blank,0,-323,-105,83563,83888,325
103,0,blank,0,-323,-105,83888,83913,25
103,0,blank,0,-323,-105,83913,84210,297
103,0,blank,0,-323,-105,84210,84341,131
103,0,blank,0,-323,-105,84341,84515,174
103,0,blank,0,-323,-105,84515,84703,188
103,0,blank,0,-323,-105,84703,84881,178
103,0,blank,0,-323,-105,84881,85062,181
103,0,blank,0,-323,-105,85062,85205,143
103,0,blank,0,-323,-105,85205,85410,205
103,0,blank,0,-323,-105,85410,85641,231
103,0,blank,0,-323,-105,85641,85671,30
103,0,blank,0,-323,-105,85671,85932,261
103,0,blank,0,-323,-105,85932,86187,255
103,0,blank,0,-323,-105,86187,86321,134
103,0,blank,0,-323,-105,86321,86450,129
103,0,blank,0,-323,-105,86450,86729,279
103,0,blank,0,-323,-105,86729,86800,71
103,0,blank,0,-323,-105,86800,87040,240
103,0,blank,0,-323,-105,87040,87085,45
103,0,blank,0,-323,-105,87085,87275,190
103,0,blank,0,-323,-105,87275,87457,182
103,0,blank,0,-323,-105,87457,87584,127
103,0,blank,0,-323,-105,87584,87726,142
103,0,blank,0,-323,-105,87726,88020,294
103,0,blank,0,-323,-105,88020,88338,318
103,0,blank,0,-323,-105,88338,88605,267
103,0,blank,0,-323,-105,88605,88742,137
103,0,blank,0,-323,-105,88742,88924,182
103,0,blank,0,-323,-105,88924,88965,41
103,0,blank,0,-323,-105,88965,89215,250
103,0,blank,0,-323,-105,89215,89363,148
103,0,blank,0,-323,-105,89363,89473,110
103,0,blank,0,-323,-105,89473,89644,171
103,0,blank,0,-323,-105,89644,89789,145
103,0,blank,0,-323,-105,89789,89974,185
103,0,blank,0,-323,-105,89974,90352,378
103,0,blank,0,-323,-105,90352,90588,236
103,0,blank,0,-323,-105,90588,90711,123
103,0,blank,0,-323,-105,90711,90921,210
103,0,blank,0,-323,-105,90921,90951,30
103,0,blank,0,-323,-105,90951,91618,667
103,0,blank,0,-277.6241,-105.1762,91618,91748,130
103,0,blank,0,-323,-105,92044,92226,182
103,0,blank,0,-323,-105,92226,92407,181
103,0,blank,0,-323,-105,92407,92588,181
103,0,blank,0,-323,-105,92588,92730,142
103,0,blank,0,-323,-105,92730,92854,124
103,0,blank,0,-323,-105,92854,93013,159
103,0,blank,0,-323,-105,93013,93320,307
103,0,blank,0,-323,-105,93320,93575,255
103,0,blank,0,-323,-105,93575,93642,67
103,0,blank,0,-323,-105,93642,94048,406
103,0,blank,0,-323,-105,94048,94134,86
103,0,blank,0,-323,-105,94134,94309,175
103,0,blank,0,-323,-105,94309,94441,132
103,0,blank,0,-323,-105,94441,94767,326
103,0,blank,0,-323,-105,94767,95244,477
103,0,blank,0,-323,-105,95244,95437,193
103,0,blank,0,-323,-105,95437,95572,135
103,0,blank,0,-323,-105,95572,95769,197
103,0,blank,0,-323,-105,95769,95968,199
103,0,blank,0,-323,-105,95968,96154,186
103,0,blank,0,-323,-105,96154,96341,187
103,0,blank,0,-323,-105,96341,96400,59
103,0,blank,0,-323,-105,96400,96672,272
103,0,blank,0,-323,-105,96672,96933,261
103,0,blank,0,-323,-105,96933,97065,132
103,0,blank,0,-323,-105,97065,97298,233
103,0,blank,0,-323,-105,97298,97363,65
103,0,blank,0,-323,-105,97363,97697,334
103,0,blank,0,-323,-105,97697,97870,173
103,0,blank,0,-323,-105,97870,97902,32
103,0,blank,0,-323,-105,97902,98304,402
103,0,blank,0,-323,-105,98304,98698,394
103,0,blank,0,-323,-105,98698,98828,130
103,0,blank,0,-323,-105,98828,99117,289
103,0,blank,0,-323,-105,99117,99166,49
103,0,blank,0,-323,-105,99166,99560,394
103,0,blank,0,-323,-105,99560,99747,187
103,0,blank,0,-323,-105,99747,99928,181
103,0,blank,0,-323,-105,99928,100113,185
103,0,blank,0,-323,-105,100113,100262,149
103,0,blank,0,-323,-105,100262,100376,114
103,0,blank,0,-323,-105,100376,100556,180
103,0,blank,0,-323,-105,100556,100675,119
103,0,blank,0,-323,-105,100675,100820,145
103,0,blank,0,-323,-105,100820,100985,165
103,0,blank,0,-323,-105,100985,101168,183
103,0,blank,0,-323,-105,101168,101321,153
103,0,blank,0,-323,-105,101321,101490,169
103,0,blank,0,-323,-105,101490,101648,158
103,0,blank,0,-323,-105,101648,101778,130
103,0,blank,0,-323,-105,101778,101872,94
103,0,blank,0,-323,-105,101872,102019,147
103,0,blank,0,-323,-105,102019,102140,121
103,0,blank,0,-323,-105,102140,102329,189
103,0,blank,0,-323,-105,102329,102503,174
103,0,blank,0,-323,-105,102503,102627,124
103,0,blank,0,-323,-105,102627,102770,143
103,0,blank,0,-323,-105,102770,102857,87
103,0,blank,0,-323,-105,102857,103054,197
103,0,blank,0,-323,-105,103054,103247,193
103,0,blank,0,-323,-105,103247,103338,91
103,0,blank,0,-323,-105,103338,103460,122
103,0,blank,0,-323,-105,103460,103557,97
103,0,blank,0,-323,-105,103557,103720,163
103,0,blank,0,-323,-105,103720,103824,104
103,0,blank,0,-323,-105,103824,103962,138
103,0,blank,0,-323,-105,103962,104157,195
103,0,blank,0,-323,-105,104157,104345,188
103,0,blank,0,-323,-105,104345,104524,179
103,0,blank,0,-323,-105,104524,104708,184
103,0,blank,0,-323,-105,104708,104775,67
103,0,blank,0,-323,-105,104775,105034,259
103,0,blank,0,-323,-105,105034,105286,252
103,0,blank,0,-323,-105,105286,105410,124
103,0,blank,0,-323,-105,105410,105566,156
103,0,blank,0,-323,-105,105566,105690,124
103,0,blank,0,-323,-105,105690,105805,115
103,0,blank,0,-323,-105,105805,105955,150
103,0,blank,0,-323,-105,105955,106123,168
103,0,blank,0,-323,-105,106123,106304,181
103,0,blank,0,-323,-105,106304,106354,50
103,0,blank,0,-323,-105,106354,106523,169
103,0,blank,0,-323,-105,106523,106687,164
103,0,blank,0,-323,-105,106687,107126,439
103,0,blank,0,-323,-105,107126,107565,439
103,0,blank,0,-323,-105,107565,107638,73
103,0,blank,0,-323,-105,107638,107895,257
103,0,blank,0,-323,-105,107895,108150,255
103,0,blank,0,-323,-105,108150,108405,255
103,0,blank,0,-323,-105,108405,108585,180
103,0,blank,0,-323,-105,108585,108757,172
103,0,blank,0,-323,-105,108757,109182,425
103,0,blank,0,-323,-105,109182,109624,442
103,0,blank,0,-323,-105,109624,110088,464
103,0,blank,0,-323,-105,110088,110245,157
103,0,blank,0,-323,-105,110245,110363,118
103,0,blank,0,-323,-105,110363,110508,145
103,0,blank,0,-323,-105,110508,110600,92
103,0,blank,0,-323,-105,110600,110754,154
103,0,blank,0,-323,-105,110754,110951,197
103,0,blank,0,-323,-105,110951,111131,180
103,0,blank,0,-323,-105,111131,111294,163
103,0,blank,0,-323,-105,111294,111406,112
103,0,blank,0,-323,-105,111406,111801,395
103,0,blank,0,-323,-105,111801,111983,182
103,0,blank,0,-323,-105,111983,112161,178
103,0,blank,0,-323,-105,112161,112509,348
103,0,blank,0,-323,-105,112509,112663,154
103,0,blank,0,-323,-105,112663,112890,227
103,0,blank,0,-323,-105,112890,113225,335
103,0,blank,0,-323,-105,113225,113400,175
103,0,blank,0,-323,-105,113400,113430,30
103,0,blank,0,-323,-105,113430,113638,208
103,0,blank,0,-323,-105,113638,113846,208
103,0,blank,0,-323,-105,113846,114232,386
103,0,blank,0,-323,-105,114232,114565,333
103,0,blank,0,-323,-105,114565,114638,73
103,0,blank,0,-323,-105,114638,114894,256
103,0,blank,0,-323,-105,114894,115149,255
103,0,blank,0,-323,-105,115149,115404,255
103,0,blank,0,-323,-105,115404,115582,178
103,0,blank,0,-323,-105,115582,115734,152
103,0,blank,0,-323,-105,115734,115915,181
103,0,blank,0,-323,-105,115915,116036,121
103,0,blank,0,-323,-105,116036,116125,89
103,0,blank,0,-323,-105,116125,116263,138
103,0,blank,0,-323,-105,116263,116353,90
103,0,blank,0,-323,-105,116353,116500,147
103,0,blank,0,-323,-105,116500,116627,127
103,0,blank,0,-323,-105,116627,117040,413
103,0,blank,0,-323,-105,117040,117237,197
103,0,blank,0,-323,-105,117237,117425,188
103,0,blank,0,-323,-105,117425,117584,159
103,0,blank,0,-323,-105,117584,117843,259
103,0,blank,0,-323,-105,117843,117876,33
103,0,blank,0,-323,-105,117876,118501,625
103,0,blank,0,-323,-105,118501,119123,622
103,0,blank,0,-323,-105,119123,119301,178
103,0,blank,0,-323,-105,119301,119457,156
103,0,blank,0,-323,-105,119457,119588,131
103,0,blank,0,-323,-105,119588,119758,170
103,0,blank,0,-323,-105,119758,119836,78
103,0,blank,0,-323,-105,119836,120026,190
103,0,blank,0,-323,-105,120026,120201,175
103,0,blank,0,-323,-105,120201,120374,173
103,0,blank,0,-323,-105,120374,120551,177
103,0,blank,0,-323,-105,120551,120675,124
103,0,blank,0,-323,-105,120675,120869,194
103,0,blank,0,-323,-105,120869,121249,380
103,0,blank,0,-323,-105,121249,121402,153
103,0,blank,0,-323,-105,121402,121675,273
103,0,blank,0,-323,-105,121675,121911,236
103,0,blank,0,-323,-105,121911,122051,140
103,0,blank,0,-323,-105,122051,122174,123
103,0,blank,0,-323,-105,122174,122293,119
103,0,blank,0,-323,-105,122293,122807,514
103,0,blank,0,-323,-105,122807,123109,302
103,0,blank,0,-323,-105,123109,123176,67
103,0,blank,0,-323,-105,123176,123475,299
103,0,blank,0,-323,-105,123475,123764,289
103,0,blank,0,-323,-105,123764,123943,179
103,0,blank,0,-323,-105,123943,124103,160
103,0,blank,0,-323,-105,124103,124400,297
103,0,blank,0,-323,-105,124400,124539,139
103,0,blank,0,-323,-105,124539,124750,211
103,0,blank,0,-323,-105,124750,124779,29
103,0,blank,0,-323,-105,124779,125008,229
103,0,blank,0,-323,-105,125008,125192,184
103,0,blank,0,-323,-105,125192,125405,213
103,0,blank,0,-323,-105,125405,125592,187
103,0,blank,0,-323,-105,125592,125957,365
103,0,blank,0,-323,-105,125957,126188,231
103,0,blank,0,-323,-105,126188,126316,128
103,0,blank,0,-323,-105,126316,126647,331
103,0,blank,0,-323,-105,126647,126676,29
103,0,blank,0,-323,-105,126676,126952,276
103,0,blank,0,-323,-105,126952,127232,280
103,0,blank,0,-323,-105,127232,127326,94
103,0,blank,0,-323,-105,127326,127606,280
103,0,blank,0,-323,-105,127606,127887,281
103,0,blank,0,-323,-105,127887,128053,166
103,0,blank,0,-323,-105,128053,128423,370
103,0,blank,0,-323,-105,128423,128785,362
103,0,blank,0,-323,-105,128785,128950,165
103,0,blank,0,-323,-105,128950,129185,235
103,0,blank,0,-323,-105,129185,129217,32
103,0,blank,0,-323,-105,129217,129714,497
103,0,blank,0,-323,-105,129714,130207,493
103,0,blank,0,-323,-105,130207,130370,163
103,0,blank,0,-323,-105,130370,130553,183
103,0,blank,0,-323,-105,130553,130640,87
103,0,blank,0,-323,-105,130640,130883,243
103,0,blank,0,-323,-105,130883,130916,33
103,0,blank,0,-323,-105,130916,131452,536
103,0,blank,0,-323,-105,131452,132227,775
103,0,blank,0,-323,-105,132227,132423,196
103,0,blank,0,-323,-105,132423,132503,80
103,0,blank,0,-323,-105,132503,132711,208
103,0,blank,0,-323,-105,132711,132759,48
103,0,blank,0,-323,-105,132759,133176,417
103,0,blank,0,-323,-105,133176,133557,381
103,0,blank,0,-323,-105,133557,133755,198
103,0,blank,0,-323,-105,133755,133997,242
103,0,blank,0,-323,-105,133997,134029,32
103,0,blank,0,-323,-105,134029,134479,450
103,0,blank,0,-323,-105,134479,134928,449
103,0,blank,0,-323,-105,134928,135108,180
103,0,blank,0,-323,-105,135108,135240,132
103,0,blank,0,-323,-105,135240,135436,196
103,0,blank,0,-323,-105,135436,135648,212
103,0,blank,0,-323,-105,135648,136044,396
103,0,blank,0,-323,-105,136044,136229,185
103,0,blank,0,-323,-105,136229,136365,136
103,0,blank,0,-323,-105,136365,136563,198
103,0,blank,0,-323,-105,136563,136762,199
103,0,blank,0,-323,-105,136762,136935,173
103,0,blank,0,-323,-105,136935,137294,359
103,0,blank,0,-323,-105,137294,137360,66
103,0,blank,0,-323,-105,137360,137759,399
103,0,blank,0,-323,-105,137759,137786,27
103,0,blank,0,-323,-105,137786,137964,178
103,0,blank,0,-323,-105,137964,138130,166
103,0,blank,0,-323,-105,138130,138290,160
103,0,blank,0,-323,-105,138290,138398,108
103,0,blank,0,-323,-105,138398,138920,522
103,0,blank,0,-323,-105,138920,139102,182
103,0,blank,0,-323,-105,139102,139195,93
103,0,blank,0,-323,-105,139195,139361,166
103,0,blank,0,-323,-105,139361,139596,235
103,0,blank,0,-323,-105,139596,139661,65
103,0,blank,0,-323,-105,139661,139864,203
103,0,blank,0,-323,-105,139864,140040,176
103,0,blank,0,-323,-105,140040,140256,216
103,0,blank,0,-323,-105,140256,140690,434
103,0,blank,0,-323,-105,140690,140831,141
103,0,blank,0,-323,-105,140831,141087,256
103,0,blank,0,-323,-105,141087,141343,256
103,0,blank,0,-323,-105,141343,141761,418
103,0,blank,0,-323,-105,141761,141957,196
103,0,blank,0,-323,-105,141957,142195,238
103,0,blank,0,-323,-105,142195,142226,31
103,0,blank,0,-323,-105,142226,142717,491
103,0,blank,0,-323,-105,142717,143225,508
103,0,blank,0,-323,-105,143225,143282,57
103,0,blank,0,-323,-105,143282,143634,352
103,0,blank,0,-323,-105,143634,143996,362
103,0,blank,0,-323,-105,143996,144210,214
103,0,blank,0,-323,-105,144210,144338,128
103,0,blank,0,-323,-105,144338,144497,159
103,0,blank,0,-323,-105,144497,144628,131
103,0,blank,0,-323,-105,144628,144791,163
103,0,blank,0,-323,-105,144791,144975,184
103,0,blank,0,-323,-105,144975,145115,140
103,0,blank,0,-323,-105,145115,145448,333
103,0,blank,0,-323,-105,145448,145572,124
103,0,blank,0,-323,-105,145572,145921,349
103,0,blank,0,-323,-105,145921,146048,127
103,0,blank,0,-323,-105,146048,146440,392
103,0,blank,0,-323,-105,146440,146513,73
103,0,blank,0,-323,-105,146513,146768,255
103,0,blank,0,-323,-105,146768,147023,255
103,0,blank,0,-323,-105,147023,147188,165
103,0,blank,0,-323,-105,147188,147359,171
103,0,blank,0,-323,-105,147359,147538,179
103,0,blank,0,-323,-105,147538,147723,185
103,0,blank,0,-323,-105,147723,147828,105
103,0,blank,0,-323,-105,147828,148084,256
103,0,blank,0,-323,-105,148084,148339,255
103,0,blank,0,-323,-105,148339,148594,255
103,0,blank,0,-323,-105,148594,148773,179
103,0,blank,0,-323,-105,148773,148951,178
103,0,blank,0,-323,-105,148951,149076,125
103,0,blank,0,-323,-105,149076,149238,162
103,0,blank,0,-323,-105,149238,149365,127
103,0,blank,0,-323,-105,149365,149570,205
103,0,blank,0,-323,-105,149570,149750,180
103,0,blank,0,-323,-105,149750,149928,178
103,0,blank,0,-323,-105,149928,150124,196
103,0,blank,0,-323,-105,150124,150301,177
103,0,blank,0,-323,-105,150301,150448,147
103,0,blank,0,-323,-105,150448,150654,206
103,0,blank,0,-323,-105,150654,150828,174
103,0,blank,0,-323,-105,150828,150862,34
103,0,blank,0,-323,-105,150862,151222,360
103,0,blank,0,-323,-105,151222,151411,189
103,0,blank,0,-323,-105,151411,151591,180
103,0,blank,0,-323,-105,151591,151825,234
103,0,blank,0,-323,-105,151825,151857,32
103,0,blank,0,-323,-105,151857,152566,709
103,0,blank,0,-323,-105,152566,153097,531
103,0,blank,0,-323,-105,153097,153270,173
103,0,blank,0,-323,-105,153270,153297,27
103,0,blank,0,-323,-105,153297,153693,396
103,0,blank,0,-323,-105,153693,154098,405
103,0,blank,0,-323,-105,154098,154480,382
103,0,blank,0,-323,-105,154480,154671,191
103,0,blank,0,-323,-105,154671,154899,228
103,0,blank,0,-323,-105,154899,154930,31
103,0,blank,0,-323,-105,154930,155400,470
103,0,blank,0,-323,-105,155400,155867,467
103,0,blank,0,-323,-105,155867,155943,76
103,0,blank,0,-323,-105,155943,156415,472
103,0,blank,0,-323,-105,156415,156896,481
103,0,blank,0,-323,-105,156896,157075,179
103,0,blank,0,-323,-105,157075,157274,199
103,0,blank,0,-323,-105,157274,157308,34
103,0,blank,0,-323,-105,157308,157493,185
103,0,blank,0,-323,-105,157493,157781,288
103,0,blank,0,-323,-105,157781,157882,101
103,0,blank,0,-323,-105,157882,158073,191
103,0,blank,0,-323,-105,158073,158104,31
103,0,blank,0,-323,-105,158104,158428,324
103,0,blank,0,-323,-105,158428,158482,54
103,0,blank,0,-323,-105,158482,158680,198
103,0,blank,0,-323,-105,158680,158751,71
103,0,blank,0,-323,-105,158751,158964,213
103,0,blank,0,-323,-105,158964,159026,62
103,0,blank,0,-323,-105,159026,159409,383
103,0,blank,0,-323,-105,159409,159469,60
103,0,blank,0,-323,-105,159469,159653,184
103,0,blank,0,-323,-105,159653,159848,195
103,0,blank,0,-323,-105,159848,160005,157
103,0,blank,0,-323,-105,160005,160201,196
103,0,blank,0,-323,-105,160201,160397,196
103,0,blank,0,-323,-105,160397,160574,177
103,0,blank,0,-323,-105,160574,160712,138
103,0,blank,0,-323,-105,160712,160904,192
103,0,blank,0,-323,-105,160904,161072,168
103,0,blank,0,-323,-105,161072,161236,164
103,0,blank,0,-323,-105,161236,161424,188
103,0,blank,0,-323,-105,161424,161584,160
103,0,blank,0,-323,-105,161584,161767,183
103,0,blank,0,-323,-105,161767,161965,198
103,0,blank,0,-323,-105,161965,162138,173
103,0,blank,0,-323,-105,162138,162309,171
103,0,blank,0,-323,-105,162309,162495,186
103,0,blank,0,-323,-105,162495,162670,175
103,0,blank,0,-323,-105,162670,162846,176
103,0,blank,0,-323,-105,162846,163026,180
103,0,blank,0,-323,-105,163026,163206,180
103,0,blank,0,-323,-105,163206,163390,184
103,0,blank,0,-323,-105,163390,163575,185
103,0,blank,0,-323,-105,163575,163761,186
103,0,blank,0,-323,-105,163761,163957,196
103,0,blank,0,-323,-105,163957,164137,180
103,0,blank,0,-323,-105,164137,164323,186
103,0,blank,0,-323,-105,164323,164503,180
103,0,blank,0,-323,-105,164503,164699,196
103,0,blank,0,-323,-105,164699,164883,184
103,0,blank,0,-323,-105,164883,165065,182
103,0,blank,0,-323,-105,165065,165258,193
103,0,blank,0,-323,-105,165258,165446,188
103,0,blank,0,-323,-105,165446,165621,175
103,0,blank,0,-323,-105,165621,165757,136
103,0,blank,0,-323,-105,165894,166075,181
103,0,blank,0,-323,-105,166075,166256,181
103,0,blank,0,-323,-105,166256,166432,176
103,0,blank,0,-323,-105,166432,166596,164
103,0,blank,0,-323,-105,166596,166769,173
103,0,blank,0,-323,-105,166769,166947,178
103,0,blank,0,-323,-105,166947,167127,180
103,0,blank,0,-323,-105,167127,167320,193
103,0,blank,0,-323,-105,167320,167495,175
103,0,blank,0,-323,-105,167495,167664,169
103,0,blank,0,-323,-105,167664,167818,154
103,0,blank,0,-323,-105,167818,168005,187
103,0,blank,0,-323,-105,168005,168162,157
103,0,blank,0,-323,-105,168162,168348,186
103,0,blank,0,-323,-105,168348,168540,192
103,0,blank,0,-323,-105,168540,168749,209
103,0,blank,0,-323,-105,168749,168878,129
103,0,blank,0,-323,-105,168878,169115,237
103,0,blank,0,-323,-105,169115,169147,32
103,0,blank,0,-323,-105,169147,169660,513
103,0,blank,0,-323,-105,169660,169834,174
103,0,blank,0,-323,-105,169834,170029,195
103,0,blank,0,-323,-105,170029,170067,38
103,0,blank,0,-323,-105,170067,170352,285
103,0,blank,0,-323,-105,170352,170400,48
103,0,blank,0,-323,-105,170400,170600,200
103,0,blank,0,-323,-105,170600,170794,194
103,0,blank,0,-323,-105,170794,170822,28
103,0,blank,0,-323,-105,170822,171200,378
103,0,blank,0,-323,-105,171200,171582,382
103,0,blank,0,-323,-105,171582,171678,96
103,0,blank,0,-323,-105,171678,171954,276
103,0,blank,0,-323,-105,171954,172083,129
103,0,blank,0,-323,-105,172083,172418,335
103,0,blank,0,-323,-105,172418,173097,679
103,0,blank,0,-323,-105,173097,173278,181
103,0,blank,0,-323,-105,173278,173396,118
103,0,blank,0,-323,-105,173396,173487,91
103,0,blank,0,-323,-105,173487,173786,299
103,0,blank,0,-323,-105,173786,173974,188
103,0,blank,0,-323,-105,173974,174268,294
103,0,blank,0,-323,-105,174268,174398,130
103,0,blank,0,-323,-105,174398,174581,183
103,0,blank,0,-323,-105,174581,174674,93
103,0,blank,0,-323,-105,174674,174849,175
103,0,blank,0,-323,-105,174849,175050,201
103,0,blank,0,-323,-105,175050,175371,321
103,0,blank,0,-323,-105,175371,175634,263
103,0,blank,0,-323,-105,175634,175699,65
103,0,blank,0,-323,-105,175699,176376,677
103,0,blank,0,-323,-105,176376,176555,179
103,0,blank,0,-323,-105,176555,176609,54
103,0,blank,0,-323,-105,176609,176798,189
103,0,blank,0,-323,-105,176798,177197,399
103,0,blank,0,-323,-105,177197,177591,394
103,0,blank,0,-323,-105,177591,177644,53
103,0,blank,0,-323,-105,177644,177853,209
103,0,blank,0,-323,-105,177853,178080,227
103,0,blank,0,-323,-105,178080,178257,177
103,0,blank,0,-323,-105,178257,178461,204
103,0,blank,0,-323,-105,178461,178491,30
103,0,blank,0,-323,-105,178491,178923,432
103,0,blank,0,-323,-105,178923,178970,47
103,0,blank,0,-323,-105,178970,179182,212
103,0,blank,0,-323,-105,179182,179267,85
103,0,blank,0,-323,-105,179267,179860,593
103,0,blank,0,-323,-105,179860,180021,161
103,0,blank,0,-323,-105,180021,180176,155
103,0,blank,0,-323,-105,180176,180506,330
103,0,blank,0,-323,-105,180506,180667,161
103,0,blank,0,-323,-105,180667,180977,310
103,0,blank,0,-323,-105,180977,181090,113
103,0,blank,0,-323,-105,181090,181272,182
103,0,blank,0,-323,-105,181272,181330,58
103,0,blank,0,-323,-105,181330,181670,340
103,0,blank,0,-323,-105,181670,181717,47
103,0,blank,0,-323,-105,181717,181933,216
103,0,blank,0,-323,-105,181933,181972,39
103,0,blank,0,-323,-105,181972,182509,537
103,0,blank,0,-323,-105,182509,182643,134
103,0,blank,0,-323,-105,182643,182774,131
103,0,blank,0,-323,-105,182774,182905,131
103,0,blank,0,-323,-105,182905,183312,407
103,0,blank,0,-323,-105,183312,183717,405
103,0,blank,0,-323,-105,183717,183899,182
103,0,blank,0,-323,-105,183899,184198,299
103,0,blank,0,-323,-105,184198,184251,53
103,0,blank,0,-323,-105,184251,184477,226
103,0,blank,0,-323,-105,184477,184675,198
103,0,blank,0,-323,-105,184675,184853,178
103,0,blank,0,-323,-105,184853,185041,188
103,0,blank,0,-323,-105,185041,185218,177
103,0,blank,0,-323,-105,185218,185284,66
103,0,blank,0,-323,-105,185284,185492,208
103,0,blank,0,-323,-105,185492,185789,297
103,0,blank,0,-323,-105,185789,186331,542
103,0,blank,0,-323,-105,186331,186529,198
103,0,blank,0,-323,-105,186529,186699,170
103,0,blank,0,-323,-105,186699,186985,286
103,0,blank,0,-323,-105,186985,187155,170
103,0,blank,0,-323,-105,187155,187648,493
103,0,blank,0,-323,-105,187648,187842,194
103,0,blank,0,-323,-105,187842,188086,244
103,0,blank,0,-323,-105,188086,188118,32
103,0,blank,0,-323,-105,188118,188673,555
103,0,blank,0,-323,-105,188673,189012,339
103,0,blank,0,-323,-105,189012,189049,37
104,0,blank,0,-323,-105,189668,189775,107
104,0,blank,0,-323,-105,189775,190267,492
104,0,blank,0,-323,-105,190267,190713,446
104,0,blank,0,-323,-105,190713,190885,172
104,0,blank,0,-323,-105,190885,190946,61
104,0,blank,0,-323,-105,190946,191092,146
104,0,blank,0,-323,-105,191092,191191,99
104,0,blank,0,-323,-105,191191,191459,268
104,0,blank,0,-323,-105,191459,191745,286
104,0,blank,0,-323,-105,191745,192004,259
104,0,blank,0,-323,-105,192004,192136,132
104,0,blank,0,-323,-105,192136,192279,143
104,0,blank,0,-323,-105,192279,192437,158
104,0,blank,0,-323,-105,192437,192627,190
104,0,blank,0,-323,-105,192627,192794,167
104,0,blank,0,-323,-105,192794,193242,448
104,0,blank,0,-323,-105,193242,193424,182
104,0,blank,0,-323,-105,193424,193459,35
104,0,blank,0,-323,-105,193459,193644,185
104,0,blank,0,-323,-105,193644,193818,174
104,0,blank,0,-323,-105,193818,194163,345
104,0,blank,0,-323,-105,194163,194749,586
104,0,blank,0,-323,-105,194749,194894,145
104,0,blank,0,-323,-105,194894,195150,256
104,0,blank,0,-323,-105,195150,195405,255
104,0,blank,0,-323,-105,195405,195660,255
104,0,blank,0,-323,-105,195660,195802,142
104,0,blank,0,-323,-105,195802,195919,117
104,0,blank,0,-323,-105,195919,196098,179
104,0,blank,0,-323,-105,196098,196427,329
104,0,blank,0,-323,-105,196427,196641,214
104,0,blank,0,-323,-105,196641,196714,73
105,0,blank,0,-323,-105,200486,200742,256
105,0,blank,0,-323,-105,200742,200957,215
105,0,blank,0,-323,-105,200957,201081,124
105,0,blank,0,-323,-105,201081,201335,254
105,0,blank,0,-323,-105,201335,201485,150
105,0,blank,0,-323,-105,201485,201843,358
105,0,blank,0,-323,-105,201843,202338,495
105,0,blank,0,-323,-105,202338,202521,183
105,0,blank,0,-323,-105,202521,202698,177
105,0,blank,0,-323,-105,202698,202862,164
105,0,blank,0,-323,-105,202862,203149,287
105,0,blank,0,-323,-105,203149,203310,161
105,0,blank,0,-323,-105,203310,203504,194
105,0,blank,0,-323,-105,203504,203695,191
105,0,blank,0,-323,-105,203695,203827,132
105,0,blank,0,-323,-105,203827,203996,169
105,0,blank,0,-323,-105,203996,204424,428
105,0,blank,0,-323,-105,204424,204536,112
105,0,blank,0,-323,-105,204536,204712,176
105,0,blank,0,-323,-105,204712,204854,142
105,0,blank,0,-323,-105,204854,205035,181
105,0,blank,0,-323,-105,205035,205068,33
105,0,blank,0,-323,-105,205068,205286,218
105,0,blank,0,-323,-105,205286,205502,216
105,0,blank,0,-323,-105,205502,205705,203
105,0,blank,0,-323,-105,205705,205864,159
105,0,blank,0,-323,-105,205864,206003,139
105,0,blank,0,-323,-105,206003,206181,178
105,0,blank,0,-323,-105,206181,206351,170
105,0,blank,0,-323,-105,206351,206533,182
105,0,blank,0,-323,-105,206533,206721,188
105,0,blank,0,-323,-105,206721,206899,178
105,0,blank,0,-323,-105,206899,207066,167
105,0,blank,0,-323,-105,207066,207163,97
105,0,blank,0,-323,-105,207163,207400,237
105,0,blank,0,-323,-105,207400,207432,32
105,0,blank,0,-323,-105,207432,207795,363
105,0,blank,0,-323,-105,207795,208081,286
105,0,blank,0,-323,-105,208081,208181,100
105,0,blank,0,-323,-105,208181,208367,186
105,0,blank,0,-323,-105,208367,208552,185
105,0,blank,0,-323,-105,208552,208902,350
105,0,blank,0,-323,-105,208902,209039,137
105,0,blank,0,-323,-105,209039,209401,362
105,0,blank,0,-323,-105,209401,209760,359
105,0,blank,0,-323,-105,209760,209930,170
105,0,blank,0,-323,-105,209930,210044,114
105,0,blank,0,-323,-105,210044,210158,114
105,0,blank,0,-323,-105,210158,210405,247
105,0,blank,0,-323,-105,210405,210689,284
105,0,blank,0,-323,-105,210689,210862,173
105,0,blank,0,-323,-105,210862,210987,125
105,0,blank,0,-323,-105,210987,211134,147
105,0,blank,0,-323,-105,211134,211468,334
105,0,blank,0,-323,-105,211468,211809,341
105,0,blank,0,-323,-105,211809,211956,147
105,0,blank,0,-323,-105,211956,212090,134
105,0,blank,0,-323,-105,212090,212232,142
105,0,blank,0,-323,-105,212232,212339,107
105,0,blank,0,-323,-105,212339,212537,198
105,0,blank,0,-323,-105,212537,212713,176
105,0,blank,0,-323,-105,212713,212889,176
105,0,blank,0,-323,-105,212889,213059,170
105,0,blank,0,-323,-105,213059,213241,182
105,0,blank,0,-323,-105,213241,213380,139
105,0,blank,0,-323,-105,213380,213581,201
105,0,blank,0,-323,-105,213581,213770,189
105,0,blank,0,-323,-105,213770,213871,101
105,0,blank,0,-323,-105,213871,214050,179
105,0,blank,0,-323,-105,214050,214233,183
105,0,blank,0,-323,-105,214233,214390,157
105,0,blank,0,-323,-105,214390,214531,141
105,0,blank,0,-323,-105,214531,214662,131
105,0,blank,0,-323,-105,214662,215074,412
105,0,blank,0,-323,-105,215074,215259,185
105,0,blank,0,-323,-105,215259,215388,129
105,0,blank,0,-323,-105,215388,215634,246
105,0,blank,0,-323,-105,215634,215915,281
105,0,blank,0,-323,-105,215915,216132,217
105,0,blank,0,-323,-105,216132,216195,63
105,0,blank,0,-323,-105,216195,216595,400
105,0,blank,0,-323,-105,216595,216999,404
105,0,blank,0,-323,-105,216999,217164,165
105,0,blank,0,-323,-105,217164,217395,231
105,0,blank,0,-323,-105,217395,217637,242
105,0,blank,0,-323,-105,217637,217784,147
105,0,blank,0,-323,-105,217784,218067,283
105,0,blank,0,-323,-105,218067,218201,134
105,0,blank,0,-323,-105,218201,218310,109
105,0,blank,0,-323,-105,218310,218420,110
105,0,blank,0,-323,-105,218420,218838,418
105,0,blank,0,-323,-105,218838,219173,335
105,0,blank,0,-323,-105,219173,219761,588
105,0,blank,0,-323,-105,219761,219939,178
105,0,blank,0,-323,-105,219939,219970,31
105,0,blank,0,-323,-105,219970,220338,368
105,0,blank,0,-323,-105,220338,220739,401
105,0,blank,0,-323,-105,220739,221207,468
105,0,blank,0,-323,-105,221207,221331,124
105,0,blank,0,-323,-105,221331,221552,221
105,0,blank,0,-323,-105,221552,221582,30
105,0,blank,0,-323,-105,221582,221943,361
105,0,blank,0,-323,-105,221943,222300,357
105,0,blank,0,-323,-105,222300,222369,69
105,0,blank,0,-323,-105,222369,222614,245
105,0,blank,0,-323,-105,222614,222863,249
105,0,blank,0,-323,-105,222863,223168,305
105,0,blank,0,-323,-105,223168,223288,120
105,0,blank,0,-323,-105,223288,223470,182
105,0,blank,0,-323,-105,223470,223818,348
105,0,blank,0,-323,-105,223818,223918,100
105,0,blank,0,-323,-105,223918,224491,573
105,0,blank,0,-323,-105,224491,224610,119
105,0,blank,0,-323,-105,224610,224784,174
105,0,blank,0,-323,-105,224784,224959,175
105,0,blank,0,-323,-105,224959,225323,364
105,0,blank,0,-323,-105,225323,225993,670
105,0,blank,0,-323,-105,225993,226118,125
105,0,blank,0,-323,-105,226118,226441,323
105,0,blank,0,-323,-105,226441,226478,37
105,0,blank,0,-323,-105,226478,226948,470
105,0,blank,0,-323,-105,226948,227417,469
105,0,blank,0,-323,-105,227417,227566,149
105,0,blank,0,-323,-105,227566,227731,165
105,0,blank,0,-323,-105,227731,227839,108
105,0,blank,0,-323,-105,227839,228005,166
105,0,blank,0,-323,-105,228005,228201,196
105,0,blank,0,-323,-105,228201,228439,238
105,0,blank,0,-323,-105,228439,228688,249
105,0,blank,0,-323,-105,228688,229082,394
105,0,blank,0,-323,-105,229082,229292,210
105,0,blank,0,-323,-105,229292,229474,182
105,0,blank,0,-323,-105,229474,229599,125
105,0,blank,0,-323,-105,229599,229762,163
105,0,blank,0,-323,-105,229762,230060,298
105,0,blank,0,-323,-105,230060,230542,482
105,0,blank,0,-323,-105,230542,230815,273
105,0,blank,0,-323,-105,230815,230935,120
105,0,blank,0,-323,-105,230935,231057,122
105,0,blank,0,-323,-105,231057,231369,312
105,0,blank,0,-323,-105,231369,231692,323
105,0,blank,0,-323,-105,231692,232009,317
105,0,blank,0,-323,-105,232009,232202,193
105,0,blank,0,-323,-105,232202,232417,215
105,0,blank,0,-323,-105,232417,232448,31
105,0,blank,0,-323,-105,232448,234031,1583
105,0,blank,0,-323,-105,234031,234223,192
105,0,blank,0,-323,-105,234223,234365,142
105,0,blank,0,-323,-105,234365,234586,221
105,0,blank,0,-323,-105,234586,234638,52
105,0,blank,0,-323,-105,234638,235155,517
105,0,blank,0,-323,-105,235155,235431,276
105,0,blank,0,-323,-105,235431,235499,68
105,0,blank,0,-323,-105,235499,235907,408
105,0,blank,0,-323,-105,235907,235955,48
105,0,blank,0,-323,-105,235955,236423,468
105,0,blank,0,-323,-105,236423,236604,181
105,0,blank,0,-323,-105,236604,236725,121
105,0,blank,0,-323,-105,236725,236984,259
105,0,blank,0,-323,-105,236984,237879,895
105,0,blank,0,-323,-105,237879,238039,160
105,0,blank,0,-323,-105,238039,238185,146
105,0,blank,0,-323,-105,238185,238327,142
105,0,blank,0,-323,-105,238327,238513,186
105,0,blank,0,-323,-105,238513,238581,68
105,0,blank,0,-323,-105,238581,238901,320
105,0,blank,0,-323,-105,238901,239099,198
105,0,blank,0,-323,-105,239099,239180,81
105,0,blank,0,-323,-105,239180,239329,149
105,0,blank,0,-323,-105,239329,239677,348
105,0,blank,0,-323,-105,239677,240020,343
105,0,blank,0,-323,-105,240020,240088,68
105,0,blank,0,-323,-105,240088,240525,437
105,0,blank,0,-323,-105,240525,240950,425
105,0,blank,0,-323,-105,240950,241130,180
105,0,blank,0,-323,-105,241130,241164,34
105,0,blank,0,-323,-105,241164,241755,591
105,0,blank,0,-323,-105,241755,242339,584
105,0,blank,0,-323,-105,242339,242482,143
105,0,blank,0,-323,-105,242482,242829,347
105,0,blank,0,-323,-105,242829,243019,190
105,0,blank,0,-323,-105,243019,243387,368
105,0,blank,0,-323,-105,243387,243456,69
105,0,blank,0,-323,-105,243456,244040,584
105,0,blank,0,-323,-105,244040,244615,575
105,0,blank,0,-323,-105,244615,244738,123
105,0,blank,0,-323,-105,244738,244968,230
105,0,blank,0,-323,-105,244968,245000,32
105,0,blank,0,-323,-105,245000,245612,612
105,0,blank,0,-323,-105,245612,246240,628
105,0,blank,0,-323,-105,246240,246407,167
105,0,blank,0,-323,-105,246407,246532,125
105,0,blank,0,-323,-105,246532,246694,162
105,0,blank,0,-323,-105,246694,246795,101
105,0,blank,0,-323,-105,246795,247116,321
105,0,blank,0,-323,-105,247116,247375,259
105,0,blank,0,-323,-105,247375,247554,179
105,0,blank,0,-323,-105,247554,247582,28
105,0,blank,0,-323,-105,247582,247775,193
105,0,blank,0,-323,-105,247775,247950,175
105,0,blank,0,-323,-105,247950,248198,248
105,0,blank,0,-323,-105,248198,248319,121
105,0,blank,0,-323,-105,248319,248490,171
105,0,blank,0,-323,-105,248490,248656,166
105,0,blank,0,-323,-105,248656,248833,177
105,0,blank,0,-323,-105,248833,248991,158
105,0,blank,0,-323,-105,248991,249169,178
105,0,blank,0,-323,-105,249169,249309,140
105,0,blank,0,-323,-105,249309,249488,179
105,0,blank,0,-323,-105,249488,249624,136
105,0,blank,0,-323,-105,249624,249834,210
105,0,blank,0,-323,-105,249834,250018,184
105,0,blank,0,-323,-105,250018,250077,59
105,0,blank,0,-323,-105,250077,250266,189
105,0,blank,0,-323,-105,250266,250434,168
105,0,blank,0,-323,-105,250434,250625,191
105,0,blank,0,-323,-105,250625,250772,147
105,0,blank,0,-323,-105,250772,251146,374
105,0,blank,0,-323,-105,251146,251434,288
105,0,blank,0,-323,-105,251434,251633,199
105,0,blank,0,-323,-105,251633,251669,36
105,0,blank,0,-323,-105,251669,251884,215
105,0,blank,0,-323,-105,251884,252034,150
105,0,blank,0,-323,-105,252034,252162,128
105,0,blank,0,-323,-105,252162,252274,112
105,0,blank,0,-323,-105,252274,252470,196
105,0,blank,0,-323,-105,252470,252578,108
105,0,blank,0,-323,-105,252578,252731,153
105,0,blank,0,-323,-105,252731,252905,174
105,0,blank,0,-323,-105,252905,253078,173
105,0,blank,0,-323,-105,253078,253244,166
105,0,blank,0,-323,-105,253244,253463,219
105,0,blank,0,-323,-105,253463,253659,196
105,0,blank,0,-323,-105,253659,253850,191
105,0,blank,0,-323,-105,253850,253992,142
105,0,blank,0,-323,-105,253992,254071,79
105,0,blank,0,-323,-105,254071,254422,351
105,0,blank,0,-323,-105,254422,254678,256
105,0,blank,0,-323,-105,254678,255235,557
105,0,blank,0,-323,-105,255235,255409,174
105,0,blank,0,-323,-105,255409,255529,120
105,0,blank,0,-323,-105,255529,255623,94
105,0,blank,0,-323,-105,255623,255801,178
105,0,blank,0,-323,-105,255801,255910,109
105,0,blank,0,-323,-105,255910,256107,197
105,0,blank,0,-323,-105,256107,256277,170
105,0,blank,0,-323,-105,256277,256795,518
105,0,blank,0,-323,-105,256795,257250,455
105,0,blank,0,-323,-105,257250,257320,70
105,0,blank,0,-323,-105,257320,257741,421
105,0,blank,0,-323,-105,257741,258267,526
105,0,blank,0,-323,-105,258267,258441,174
105,0,blank,0,-323,-105,258441,258575,134
105,0,blank,0,-323,-105,258575,258765,190
105,0,blank,0,-323,-105,258765,259010,245
105,0,blank,0,-323,-105,259010,259422,412
105,0,blank,0,-323,-105,259422,260111,689
105,0,blank,0,-323,-105,260111,260291,180
105,0,blank,0,-323,-105,260291,260391,100
105,0,blank,0,-323,-105,260391,260743,352
105,0,blank,0,-323,-105,260743,261097,354
105,0,blank,0,-323,-105,261097,261268,171
105,0,blank,0,-323,-105,261268,261583,315
105,0,blank,0,-323,-105,261583,261992,409
105,0,blank,0,-323,-105,261992,262172,180
105,0,blank,0,-323,-105,262172,262356,184
105,0,blank,0,-323,-105,262356,262526,170
105,0,blank,0,-323,-105,262526,262736,210
105,0,blank,0,-323,-105,262736,262949,213
105,0,blank,0,-323,-105,262949,263126,177
105,0,blank,0,-323,-105,263126,263309,183
105,0,blank,0,-323,-105,263309,263433,124
105,0,blank,0,-323,-105,263433,263526,93
105,0,blank,0,-323,-105,263526,263665,139
105,0,blank,0,-323,-105,263665,264171,506
105,0,blank,0,-323,-105,264171,264512,341
105,0,blank,0,-323,-105,264512,264637,125
105,0,blank,0,-323,-105,264637,264885,248
105,0,blank,0,-323,-105,264885,264917,32
105,0,blank,0,-323,-105,264917,265202,285
105,0,blank,0,-323,-105,265202,265275,73
105,0,blank,0,-323,-105,265275,265531,256
105,0,blank,0,-323,-105,265531,265717,186
105,0,blank,0,-323,-105,265717,265900,183
105,0,blank,0,-323,-105,265900,266078,178
105,0,blank,0,-323,-105,266078,266254,176
105,0,blank,0,-323,-105,266254,266352,98
105,0,blank,0,-323,-105,266352,266611,259
105,0,blank,0,-323,-105,266611,266801,190
105,0,blank,0,-323,-105,266801,267252,451
105,0,blank,0,-323,-105,267252,267762,510
105,0,blank,0,-323,-105,267762,267941,179
105,0,blank,0,-323,-105,267941,268041,100
105,0,blank,0,-323,-105,268041,268240,199
105,0,blank,0,-323,-105,268240,268699,459
105,0,blank,0,-323,-105,268699,268974,275
105,0,blank,0,-323,-105,268974,269152,178
105,0,blank,0,-323,-105,269152,269321,169
105,0,blank,0,-323,-105,269321,269513,192
105,0,blank,0,-323,-105,269513,269582,69
105,0,blank,0,-323,-105,269582,269905,323
105,0,blank,0,-323,-105,269905,270292,387
105,0,blank,0,-323,-105,270292,270390,98
105,0,blank,0,-323,-105,270390,270777,387
105,0,blank,0,-323,-105,270777,270821,44
105,0,blank,0,-323,-105,270821,271058,237
105,0,blank,0,-323,-105,271058,271143,85
105,0,blank,0,-323,-105,271143,271425,282
105,0,blank,0,-323,-105,271425,271531,106
105,0,blank,0,-323,-105,271531,271808,277
105,0,blank,0,-323,-105,271808,272036,228
105,0,blank,0,-323,-105,272036,272161,125
105,0,blank,0,-323,-105,272161,272389,228
105,0,blank,0,-323,-105,272389,272419,30
105,0,blank,0,-323,-105,272419,272673,254
105,0,blank,0,-323,-105,272673,272864,191
105,0,blank,0,-323,-105,272864,273048,184
105,0,blank,0,-323,-105,273048,273202,154
105,0,blank,0,-323,-105,273202,273683,481
105,0,blank,0,-323,-105,273683,273861,178
105,0,blank,0,-323,-105,273861,274041,180
105,0,blank,0,-323,-105,274041,274131,90
105,0,blank,0,-323,-105,274131,274692,561
105,0,blank,0,-323,-105,274692,274824,132
105,0,blank,0,-323,-105,274824,275092,268
105,0,blank,0,-323,-105,275092,275189,97
105,0,blank,0,-323,-105,275189,275375,186
105,0,blank,0,-323,-105,275375,275405,30
105,0,blank,0,-323,-105,275405,275681,276
105,0,blank,0,-323,-105,275681,275892,211
105,0,blank,0,-323,-105,275892,276017,125
105,0,blank,0,-323,-105,276017,276206,189
105,0,blank,0,-323,-105,276206,276242,36
105,0,blank,0,-323,-105,276242,276499,257
105,0,blank,0,-323,-105,276499,276754,255
105,0,blank,0,-323,-105,276754,277009,255
105,0,blank,0,-323,-105,277009,277143,134
105,0,blank,0,-323,-105,277143,277285,142
105,0,blank,0,-323,-105,277285,277427,142
105,0,blank,0,-323,-105,277427,277710,283
105,0,blank,0,-323,-105,277710,277907,197
105,0,blank,0,-323,-105,277907,277993,86
105,0,blank,0,-323,-105,277993,278180,187
106,0,blank,0,-323,-105,278665,278811,146
106,0,blank,0,-323,-105,278811,278923,112
106,0,blank,0,-323,-105,278923,279121,198
106,0,blank,0,-323,-105,279121,279267,146
106,0,blank,0,-323,-105,279267,279429,162
106,0,blank,0,-323,-105,279429,279618,189
106,0,blank,0,-323,-105,279618,279768,150
106,0,blank,0,-323,-105,279768,279966,198
106,0,blank,0,-323,-105,279966,280155,189
106,0,blank,0,-323,-105,280155,280335,180
106,0,blank,0,-323,-105,280335,280499,164
106,0,blank,0,-323,-105,280499,280679,180
106,0,blank,0,-323,-105,280679,281014,335
106,0,blank,0,-323,-105,281014,281239,225
106,0,blank,0,-323,-105,281239,281314,75
106,0,blank,0,-323,-105,281314,281644,330
106,0,blank,0,-323,-105,281644,281766,122
106,0,blank,0,-323,-105,281766,281971,205
106,0,blank,0,-323,-105,281971,282173,202
106,0,blank,0,-323,-105,282173,282300,127
106,0,blank,0,-323,-105,282300,282456,156
106,0,blank,0,-323,-105,282456,282594,138
106,0,blank,0,-323,-105,282594,282731,137
106,0,blank,0,-323,-105,282731,283086,355
106,0,blank,0,-323,-105,283086,283348,262
106,0,blank,0,-323,-105,283348,283538,190
106,0,blank,0,-323,-105,283538,283621,83
106,0,blank,0,-323,-105,283621,283967,346
106,0,blank,0,-323,-105,283967,284352,385
106,0,blank,0,-323,-105,284352,284704,352
106,0,blank,0,-323,-105,284704,284791,87
106,0,blank,0,-323,-105,284791,284986,195
106,0,blank,0,-323,-105,284986,285161,175
106,0,blank,0,-323,-105,285161,285268,107
106,0,blank,0,-323,-105,285268,285397,129
106,0,blank,0,-323,-105,285397,285743,346
106,0,blank,0,-323,-105,285743,285867,124
106,0,blank,0,-323,-105,285867,286041,174
106,0,blank,0,-323,-105,286041,286236,195
106,0,blank,0,-323,-105,286236,286358,122
106,0,blank,0,-323,-105,286358,286540,182
106,0,blank,0,-323,-105,286540,286779,239
106,0,blank,0,-323,-105,286779,287146,367
106,0,blank,0,-323,-105,287146,287345,199
106,0,blank,0,-323,-105,287345,287372,27
106,0,blank,0,-323,-105,287372,287608,236
106,0,blank,0,-323,-105,287608,287920,312
106,0,blank,0,-323,-105,287920,288378,458
106,0,blank,0,-323,-105,288378,288550,172
106,0,blank,0,-323,-105,288550,288655,105
106,0,blank,0,-323,-105,288655,288759,104
106,0,blank,0,-323,-105,288759,288947,188
106,0,blank,0,-323,-105,288947,289108,161
106,0,blank,0,-323,-105,289108,289295,187
106,0,blank,0,-323,-105,289295,289845,550
106,0,blank,0,-323,-105,289845,290389,544
106,0,blank,0,-323,-105,290389,290559,170
106,0,blank,0,-323,-105,290559,290596,37
106,0,blank,0,-323,-105,290596,290798,202
106,0,blank,0,-323,-105,290798,290821,23
106,0,blank,0,-323,-105,290821,291320,499
106,0,blank,0,-323,-105,291320,291813,493
106,0,blank,0,-323,-105,291813,291879,66
106,0,blank,0,-323,-105,291879,292283,404
106,0,blank,0,-323,-105,292283,292472,189
106,0,blank,0,-323,-105,292472,292655,183
106,0,blank,0,-323,-105,292655,292940,285
106,0,blank,0,-323,-105,292940,293165,225
106,0,blank,0,-323,-105,293165,293427,262
106,0,blank,0,-323,-105,293427,293453,26
106,0,blank,0,-323,-105,293453,293733,280
106,0,blank,0,-323,-105,293733,294102,369
106,0,blank,0,-323,-105,294102,294287,185
106,0,blank,0,-323,-105,294287,294381,94
106,0,blank,0,-323,-105,294381,294569,188
106,0,blank,0,-323,-105,294569,294599,30
106,0,blank,0,-323,-105,294599,295254,655
106,0,blank,0,-323,-105,295254,295416,162
106,0,blank,0,-323,-105,295416,295696,280
106,0,blank,0,-323,-105,295696,296000,304
106,0,blank,0,-323,-105,296000,296276,276
106,0,blank,0,-323,-105,296276,296460,184
106,0,blank,0,-323,-105,296460,296608,148
106,0,blank,0,-323,-105,296608,296823,215
106,0,blank,0,-323,-105,296823,296852,29
106,0,blank,0,-323,-105,296852,297165,313
106,0,blank,0,-323,-105,297165,297299,134
106,0,blank,0,-323,-105,297299,297488,189
106,0,blank,0,-323,-105,297488,297654,166
106,0,blank,0,-323,-105,297654,297770,116
106,0,blank,0,-323,-105,297770,297930,160
106,0,blank,0,-323,-105,297930,297975,45
106,0,blank,0,-323,-105,297975,298135,160
106,0,blank,0,-323,-105,298135,298209,74
106,0,blank,0,-323,-105,298209,298338,129
106,0,blank,0,-323,-105,298338,298649,311
106,0,blank,0,-323,-105,298649,298908,259
106,0,blank,0,-323,-105,298908,299156,248
106,0,blank,0,-323,-105,299156,299292,136
106,0,blank,0,-323,-105,299292,299485,193
106,0,blank,0,-323,-105,299485,299528,43
106,0,blank,0,-323,-105,299528,299833,305
106,0,blank,0,-323,-105,299833,300025,192
106,0,blank,0,-323,-105,300025,300221,196
106,0,blank,0,-323,-105,300221,300402,181
106,0,blank,0,-323,-105,300402,300574,172
106,0,blank,0,-323,-105,300574,300745,171
106,0,blank,0,-323,-105,300745,300937,192
106,0,blank,0,-323,-105,300937,301022,85
106,0,blank,0,-323,-105,301022,301195,173
106,0,blank,0,-323,-105,301195,301380,185
106,0,blank,0,-323,-105,301380,301579,199
106,0,blank,0,-323,-105,301579,301894,315
106,0,blank,0,-323,-105,301894,302041,147
106,0,blank,0,-323,-105,302041,302427,386
106,0,blank,0,-323,-105,302427,302906,479
106,0,blank,0,-323,-105,302906,302998,92
106,0,blank,0,-323,-105,302998,303181,183
106,0,blank,0,-323,-105,303181,303605,424
106,0,blank,0,-323,-105,303605,304022,417
106,0,blank,0,-323,-105,304022,304173,151
106,0,blank,0,-323,-105,304173,304320,147
106,0,blank,0,-323,-105,304320,304453,133
106,0,blank,0,-323,-105,304453,304587,134
106,0,blank,0,-323,-105,304587,304740,153
106,0,blank,0,-323,-105,304740,305091,351
106,0,blank,0,-323,-105,305091,305343,252
106,0,blank,0,-323,-105,305343,305635,292
106,0,blank,0,-323,-105,305635,305776,141
106,0,blank,0,-323,-105,305776,305907,131
106,0,blank,0,-323,-105,305907,306068,161
106,0,blank,0,-323,-105,306068,306562,494
106,0,blank,0,-323,-105,306562,307173,611
106,0,blank,0,-323,-105,307173,307363,190
106,0,blank,0,-323,-105,307363,307586,223
106,0,blank,0,-323,-105,307586,307617,31
106,0,blank,0,-323,-105,307617,307980,363
106,0,blank,0,-323,-105,307980,308170,190
106,0,blank,0,-323,-105,308170,308370,200
106,0,blank,0,-323,-105,308370,308399,29
106,0,blank,0,-323,-105,308399,308586,187
106,0,blank,0,-323,-105,308586,308864,278
106,0,blank,0,-323,-105,308864,309123,259
106,0,blank,0,-323,-105,309123,309290,167
106,0,blank,0,-323,-105,309290,309460,170
106,0,blank,0,-323,-105,309460,309645,185
106,0,blank,0,-323,-105,309645,309816,171
106,0,blank,0,-323,-105,309816,310312,496
106,0,blank,0,-323,-105,310312,310339,27
106,0,blank,0,-323,-105,310339,310696,357
106,0,blank,0,-323,-105,310696,310783,87
106,0,blank,0,-323,-105,310783,311092,309
106,0,blank,0,-323,-105,311092,311301,209
106,0,blank,0,-323,-105,311301,311332,31
106,0,blank,0,-323,-105,311332,311865,533
106,0,blank,0,-323,-105,311865,312328,463
106,0,blank,0,-323,-105,312328,313162,834
106,0,blank,0,-323,-105,313162,313315,153
106,0,blank,0,-323,-105,313315,313506,191
106,0,blank,0,-323,-105,313506,313659,153
106,0,blank,0,-323,-105,313659,313995,336
106,0,blank,0,-323,-105,313995,314472,477
106,0,blank,0,-323,-105,314472,314776,304
106,0,blank,0,-323,-105,314776,314953,177
106,0,blank,0,-323,-105,314953,315078,125
106,0,blank,0,-323,-105,315078,315173,95
106,0,blank,0,-323,-105,315173,315462,289
106,0,blank,0,-323,-105,315462,315518,56
106,0,blank,0,-323,-105,315518,315670,152
106,0,blank,0,-323,-105,315670,315804,134
106,0,blank,0,-323,-105,315804,315978,174
106,0,blank,0,-323,-105,315978,316055,77
106,0,blank,0,-323,-105,316055,316253,198
106,0,blank,0,-323,-105,316253,316424,171
106,0,blank,0,-323,-105,316424,316599,175
106,0,blank,0,-323,-105,316599,316660,61
106,0,blank,0,-323,-105,316660,317112,452
107,0,blank,0,-323,-105,317846,317952,106
107,0,blank,0,-323,-105,317952,318322,370
107,0,blank,0,-323,-105,318322,318731,409
107,0,blank,0,-323,-105,318731,318926,195
107,0,blank,0,-323,-105,318926,319074,148
107,0,blank,0,-323,-105,319074,319445,371
107,0,blank,0,-323,-105,319445,319552,107
107,0,blank,0,-323,-105,319552,319842,290
107,0,blank,0,-323,-105,319842,320137,295
107,0,blank,0,-323,-105,320137,320758,621
107,0,blank,0,-323,-105,320758,320891,133
107,0,blank,0,-323,-105,320891,321094,203
107,0,blank,0,-323,-105,321094,321390,296
107,0,blank,0,-323,-105,321390,321587,197
107,0,blank,0,-323,-105,321587,321684,97
107,0,blank,0,-323,-105,321684,321887,203
107,0,blank,0,-323,-105,321887,321961,74
107,0,blank,0,-323,-105,321961,322135,174
107,0,blank,0,-323,-105,322135,322783,648
107,0,blank,0,-323,-105,322783,323237,454
107,0,blank,0,-323,-105,323237,323410,173
107,0,blank,0,-323,-105,323410,323904,494
107,0,blank,0,-323,-105,323904,324393,489
107,0,blank,0,-323,-105,324393,324576,183
107,0,blank,0,-323,-105,324576,324636,60
107,0,blank,0,-323,-105,324636,325094,458
107,0,blank,0,-323,-105,325094,325518,424
107,0,blank,0,-323,-105,325518,325666,148
107,0,blank,0,-323,-105,325666,325853,187
107,0,blank,0,-323,-105,325853,326235,382
107,0,blank,0,-323,-105,326235,326607,372
107,0,blank,0,-323,-105,326607,326690,83
107,0,blank,0,-323,-105,326690,326916,226
107,0,blank,0,-323,-105,326916,327059,143
107,0,blank,0,-323,-105,327059,327362,303
107,0,blank,0,-323,-105,327362,328117,755
107,0,blank,0,-323,-105,328117,328257,140
107,0,blank,0,-323,-105,328257,328432,175
107,0,blank,0,-323,-105,328432,328603,171
107,0,blank,0,-323,-105,328603,328893,290
107,0,blank,0,-323,-105,328893,329091,198
107,0,blank,0,-323,-105,329091,329286,195
107,0,blank,0,-323,-105,329286,329455,169
107,0,blank,0,-323,-105,329455,329593,138
107,0,blank,0,-323,-105,329593,329714,121
107,0,blank,0,-323,-105,329714,329876,162
107,0,blank,0,-323,-105,329876,329949,73
107,0,blank,0,-323,-105,329949,330218,269
107,0,blank,0,-323,-105,330218,330353,135
107,0,blank,0,-323,-105,330353,330608,255
107,0,blank,0,-323,-105,330608,330867,259
107,0,blank,0,-323,-105,330867,330955,88
107,0,blank,0,-323,-105,330955,331167,212
107,0,blank,0,-323,-105,331167,331193,26
107,0,blank,0,-323,-105,331193,331416,223
107,0,blank,0,-323,-105,331416,331465,49
107,0,blank,0,-323,-105,331465,331632,167
107,0,blank,0,-323,-105,331632,331731,99
107,0,blank,0,-323,-105,331731,331850,119
107,0,blank,0,-323,-105,331850,331958,108
107,0,blank,0,-323,-105,331958,332154,196
107,0,blank,0,-323,-105,332154,332280,126
107,0,blank,0,-323,-105,332280,332467,187
107,0,blank,0,-323,-105,332467,332608,141
107,0,blank,0,-323,-105,332608,332797,189
107,0,blank,0,-323,-105,332797,333101,304
107,0,blank,0,-323,-105,333101,333133,32
107,0,blank,0,-323,-105,333133,333489,356
107,0,blank,0,-323,-105,333489,333851,362
107,0,blank,0,-323,-105,333851,334034,183
107,0,blank,0,-323,-105,334034,334177,143
107,0,blank,0,-323,-105,334177,334336,159
107,0,blank,0,-323,-105,334336,334566,230
107,0,blank,0,-323,-105,334566,335915,1349
107,0,blank,0,-323,-105,335915,336024,109
107,0,blank,0,-323,-105,336024,336162,138
107,0,blank,0,-323,-105,336162,336232,70
107,0,blank,0,-323,-105,336232,336500,268
107,0,blank,0,-323,-105,336500,336656,156
107,0,blank,0,-323,-105,336656,336886,230
107,0,blank,0,-323,-105,336886,336922,36
107,0,blank,0,-323,-105,336922,337135,213
107,0,blank,0,-323,-105,337135,337672,537
107,0,blank,0,-323,-105,337672,337850,178
107,0,blank,0,-323,-105,337850,337975,125
107,0,blank,0,-323,-105,337975,338257,282
107,0,blank,0,-323,-105,338257,338315,58
107,0,blank,0,-323,-105,338315,338719,404
107,0,blank,0,-323,-105,338719,338914,195
107,0,blank,0,-323,-105,338914,339011,97
107,0,blank,0,-323,-105,339011,339183,172
107,0,blank,0,-323,-105,339183,339354,171
107,0,blank,0,-323,-105,339354,339553,199
107,0,blank,0,-323,-105,339553,339750,197
107,0,blank,0,-323,-105,339750,339805,55
107,0,blank,0,-323,-105,339805,340297,492
107,0,blank,0,-323,-105,340297,340423,126
107,0,blank,0,-323,-105,340423,340646,223
107,0,blank,0,-323,-105,340646,340832,186
107,0,blank,0,-323,-105,340832,340981,149
107,0,blank,0,-323,-105,340981,341221,240
107,0,blank,0,-323,-105,341221,341251,30
107,0,blank,0,-323,-105,341251,341489,238
107,0,blank,0,-323,-105,341489,341672,183
107,0,blank,0,-323,-105,341672,341858,186
107,0,blank,0,-323,-105,341858,342004,146
107,0,blank,0,-323,-105,342004,342193,189
107,0,blank,0,-323,-105,342193,342224,31
107,0,blank,0,-323,-105,342224,342586,362
107,0,blank,0,-323,-105,342586,342953,367
107,0,blank,0,-323,-105,342953,343191,238
107,0,blank,0,-323,-105,343191,343350,159
107,0,blank,0,-323,-105,343350,343512,162
107,0,blank,0,-323,-105,343512,343609,97
107,0,blank,0,-323,-105,343609,343776,167
107,0,blank,0,-323,-105,343776,343870,94
107,0,blank,0,-323,-105,343870,344064,194
107,0,blank,0,-323,-105,344064,344242,178
107,0,blank,0,-323,-105,344242,344362,120
107,0,blank,0,-323,-105,344362,344497,135
107,0,blank,0,-323,-105,344497,344754,257
107,0,blank,0,-323,-105,344754,345005,251
107,0,blank,0,-323,-105,345005,345051,46
107,0,blank,0,-323,-105,345051,345330,279
107,0,blank,0,-323,-105,345330,345374,44
107,0,blank,0,-323,-105,345374,345631,257
107,0,blank,0,-323,-105,345631,345687,56
107,0,blank,0,-323,-105,345687,345980,293
107,0,blank,0,-323,-105,345980,346263,283
107,0,blank,0,-323,-105,346263,346350,87
107,0,blank,0,-323,-105,346350,346550,200
107,0,blank,0,-323,-105,346550,346738,188
107,0,blank,0,-323,-105,346738,346769,31
107,0,blank,0,-323,-105,346769,346971,202
107,0,blank,0,-323,-105,346971,347193,222
107,0,blank,0,-323,-105,347193,347308,115
107,0,blank,0,-323,-105,347308,347559,251
107,0,blank,0,-323,-105,347862,347954,92
107,0,blank,0,-161.8249,197.2919,347990,348015,25
107,0,blank,0,-323,-105,348041,348219,178
107,0,blank,0,-323,-105,348219,348324,105
107,0,blank,0,-323,-105,348324,348568,244
107,0,blank,0,-323,-105,348568,348789,221
107,0,blank,0,-323,-105,348789,349057,268
107,0,blank,0,-323,-105,349057,349245,188
107,0,blank,0,-323,-105,349245,349649,404
107,0,blank,0,-323,-105,349649,349921,272
107,0,blank,0,-323,-105,349921,350054,133
107,0,blank,0,-323,-105,350054,350301,247
107,0,blank,0,-323,-105,350301,350546,245
107,0,blank,0,-323,-105,350546,350739,193
107,0,blank,0,-323,-105,350739,350771,32
107,0,blank,0,-323,-105,350771,350941,170
107,0,blank,0,-323,-105,350941,351111,170
107,0,blank,0,-323,-105,351111,351294,183
107,0,blank,0,-323,-105,351294,351337,43
107,16,"\nDisplayingthealternatenodes\n",84,252.7374,314.5042,351502,351528,26
107,0,blank,0,301.9773,240.6723,351528,351749,221
107,0,blank,0,-323,-105,352007,352188,181
107,0,blank,0,-323,-105,352188,352366,178
107,0,blank,0,-323,-105,352366,352563,197
107,0,blank,0,-323,-105,352563,352752,189
107,0,blank,0,-323,-105,352752,353047,295
107,0,blank,0,-323,-105,353047,353147,100
107,0,blank,0,-323,-105,353147,353269,122
107,0,blank,0,-323,-105,353269,353393,124
107,0,blank,0,-323,-105,353393,353578,185
107,0,blank,0,-323,-105,353578,353742,164
107,0,blank,0,-323,-105,353742,353992,250
107,0,blank,0,-323,-105,353992,354347,355
107,0,blank,0,-323,-105,354347,354385,38
107,0,blank,0,-323,-105,354385,354643,258
107,0,blank,0,-323,-105,354643,354898,255
107,0,blank,0,-323,-105,354898,355153,255
107,0,blank,0,-323,-105,355153,355330,177
107,0,blank,0,-323,-105,355330,355412,82
107,0,blank,0,-323,-105,355412,355633,221
107,0,blank,0,-323,-105,355633,355666,33
107,0,blank,0,-323,-105,355666,356146,480
107,0,blank,0,-323,-105,356146,356399,253
107,0,blank,0,-323,-105,356399,356525,126
107,0,blank,0,-323,-105,356525,356858,333
107,0,blank,0,-323,-105,356858,357184,326
107,0,blank,0,-323,-105,357184,357657,473
107,0,blank,0,-323,-105,357657,357833,176
107,0,blank,0,-323,-105,357833,358027,194
107,0,blank,0,-323,-105,358027,358068,41
107,0,blank,0,-323,-105,358068,358329,261
107,0,blank,0,-323,-105,358329,358395,66
107,0,blank,0,-323,-105,358395,358709,314
107,0,blank,0,-323,-105,358709,359188,479
107,0,blank,0,-323,-105,359188,359379,191
107,0,blank,0,-323,-105,359379,359688,309
107,0,blank,0,-323,-105,359688,360029,341
107,0,blank,0,-323,-105,360029,360200,171
107,0,blank,0,-323,-105,360200,360821,621
107,0,blank,0,-323,-105,360821,361519,698
107,0,blank,0,-323,-105,361519,361593,74
107,0,blank,0,-323,-105,361593,361850,257
107,0,blank,0,-323,-105,361850,362105,255
107,0,blank,0,-323,-105,362105,362360,255
107,0,blank,0,-323,-105,362360,362557,197
107,0,blank,0,-323,-105,362557,362744,187
107,0,blank,0,-323,-105,362744,362932,188
107,0,blank,0,-323,-105,362932,363116,184
107,0,blank,0,-323,-105,363116,363141,25
107,0,blank,0,-323,-105,363141,363409,268
107,0,blank,0,-323,-105,363409,363512,103
107,0,blank,0,-323,-105,363512,363890,378
107,0,blank,0,-323,-105,363890,364041,151
107,0,blank,0,-323,-105,364041,364240,199
107,0,blank,0,-323,-105,364240,364475,235
107,0,blank,0,-323,-105,364475,365117,642
107,0,blank,0,-323,-105,365117,365578,461
107,0,blank,0,-323,-105,365578,365750,172
107,0,blank,0,-323,-105,365750,365930,180
107,0,blank,0,-323,-105,365930,366105,175
107,0,blank,0,-323,-105,366105,366286,181
107,0,blank,0,-323,-105,366286,366375,89
107,0,blank,0,-323,-105,366375,366614,239
107,0,blank,0,-323,-105,366614,366645,31
107,0,blank,0,-323,-105,366645,366892,247
107,0,blank,0,-323,-105,366892,367200,308
107,0,blank,0,-323,-105,367200,367455,255
107,0,blank,0,-323,-105,367455,367710,255
107,0,blank,0,-323,-105,367710,367890,180
107,0,blank,0,-323,-105,367890,368067,177
107,0,blank,0,-323,-105,368067,368226,159
107,0,blank,0,-323,-105,368226,368487,261
107,0,blank,0,-323,-105,368487,368518,31
108,0,blank,0,-323,-105,369390,369568,178
108,0,blank,0,-323,-105,370049,370135,86
108,0,blank,0,-323,-105,370135,370307,172
108,0,blank,0,-323,-105,370307,370497,190
108,0,blank,0,-323,-105,370497,370650,153
108,0,blank,0,-323,-105,370650,370735,85
108,0,blank,0,-323,-105,370735,371012,277
108,0,blank,0,-323,-105,371012,371056,44
108,0,blank,0,-323,-105,371056,371358,302
108,0,blank,0,-323,-105,371358,371396,38
108,0,blank,0,-323,-105,371396,371741,345
108,0,blank,0,-323,-105,371741,371925,184
108,0,blank,0,-323,-105,371925,372036,111
108,0,blank,0,-323,-105,372036,372227,191
108,0,blank,0,-323,-105,372227,372406,179
108,0,blank,0,-323,-105,372406,372575,169
108,0,blank,0,-323,-105,372575,372740,165
108,0,blank,0,-323,-105,372740,372866,126
108,0,blank,0,-323,-105,373016,373184,168
108,0,blank,0,-323,-105,373184,373366,182
108,0,blank,0,-323,-105,373366,373494,128
108,0,blank,0,-323,-105,373494,373590,96
108,0,blank,0,-323,-105,373590,373759,169
108,0,blank,0,-323,-105,373759,374029,270
108,0,blank,0,-323,-105,374029,374126,97
108,0,blank,0,-323,-105,374126,374260,134
108,0,blank,0,-323,-105,374260,374394,134
108,0,blank,0,-323,-105,374394,374575,181
108,0,blank,0,-323,-105,374575,374829,254
108,0,blank,0,-323,-105,374829,375013,184
108,0,blank,0,-323,-105,375013,375153,140
108,0,blank,0,-323,-105,375153,375218,65
108,0,blank,0,-323,-105,375218,375558,340
108,0,blank,0,-323,-105,375558,375744,186
108,0,blank,0,-323,-105,375744,376062,318
108,0,blank,0,-323,-105,376062,376219,157
108,0,blank,0,-323,-105,376219,376358,139
108,0,blank,0,-323,-105,376358,376569,211
108,0,blank,0,-323,-105,376569,376768,199
108,0,blank,0,-323,-105,376768,376951,183
108,0,blank,0,-323,-105,376951,377215,264
108,0,blank,0,-323,-105,377215,377334,119
108,0,blank,0,-323,-105,377334,377417,83
108,0,blank,0,-323,-105,377417,377685,268
108,0,blank,0,-323,-105,377685,377776,91
108,0,blank,0,-323,-105,377776,377950,174
108,0,blank,0,-323,-105,377950,378213,263
108,0,blank,0,-323,-105,378213,378245,32
108,0,blank,0,-323,-105,378245,378607,362
108,0,blank,0,-323,-105,378607,378804,197
108,0,blank,0,-323,-105,378804,378907,103
108,0,blank,0,-323,-105,378907,379163,256
108,0,blank,0,-323,-105,379163,379210,47
108,0,blank,0,-323,-105,379210,379401,191
108,0,blank,0,-323,-105,379401,379579,178
108,0,blank,0,-323,-105,379579,379762,183
108,0,blank,0,-323,-105,379762,379922,160
108,0,blank,0,-323,-105,379922,380053,131
108,0,blank,0,-323,-105,380053,380221,168
108,0,blank,0,-323,-105,380221,380363,142
108,0,blank,0,-323,-105,380363,380544,181
108,0,blank,0,-323,-105,380544,380690,146
108,0,blank,0,-323,-105,380690,380856,166
108,0,blank,0,-323,-105,380856,381053,197
108,0,blank,0,-323,-105,381053,381201,148
108,0,blank,0,268.3863,417.9455,381400,381440,40
108,0,blank,0,-323,-105,381613,381705,92
108,0,blank,0,309.5618,421.3003,381872,381984,112
108,0,blank,0,-323,-105,382044,382239,195
108,0,blank,0,-323,-105,382239,382418,179
108,0,blank,0,-323,-105,382418,382596,178
108,0,blank,0,-323,-105,382596,382790,194
108,0,blank,0,-323,-105,382790,382848,58
108,0,blank,0,-323,-105,382848,383172,324
108,0,blank,0,-323,-105,383172,383270,98
108,0,blank,0,-323,-105,383270,383455,185
108,0,blank,0,-323,-105,383455,383524,69
108,0,blank,0,-323,-105,383524,383988,464
108,0,blank,0,-323,-105,383988,384209,221
108,0,blank,0,-323,-105,384209,384285,76
108,0,blank,0,-323,-105,384285,384541,256
108,0,blank,0,-323,-105,384541,384796,255
108,0,blank,0,-323,-105,384796,385051,255
108,0,blank,0,-323,-105,385051,385233,182
108,0,blank,0,-323,-105,385233,385363,130
108,0,blank,0,-323,-105,385363,385519,156
108,0,blank,0,-323,-105,385519,385885,366
108,0,blank,0,-323,-105,385885,386169,284
108,0,blank,0,-323,-105,386169,386310,141
108,0,blank,0,-323,-105,386310,386583,273
108,0,blank,0,-323,-105,386583,386870,287
108,0,blank,0,-323,-105,386870,387218,348
108,0,blank,0,-323,-105,387218,387393,175
108,0,blank,0,-323,-105,387393,387579,186
108,0,blank,0,-323,-105,387579,387975,396
108,0,blank,0,-323,-105,387975,388610,635
108,0,blank,0,-323,-105,388610,388709,99
108,0,blank,0,-323,-105,388709,388869,160
108,0,blank,0,-323,-105,388869,389024,155
108,0,blank,0,-323,-105,389024,389599,575
108,0,blank,0,-323,-105,389599,390082,483
108,0,blank,0,-323,-105,390082,390181,99
108,0,blank,0,-323,-105,390181,390418,237
108,0,blank,0,-323,-105,390418,390618,200
108,0,blank,0,-323,-105,390618,390774,156
108,0,blank,0,-323,-105,390774,391234,460
108,0,blank,0,-323,-105,391234,391416,182
108,0,blank,0,-323,-105,391416,391450,34
108,0,blank,0,-323,-105,391450,391633,183
108,0,blank,0,-323,-105,391633,391817,184
108,0,blank,0,-323,-105,391817,391989,172
108,0,blank,0,-323,-105,391989,392023,34
108,0,blank,0,-323,-105,392023,392620,597
108,0,blank,0,-323,-105,392620,392990,370
108,0,blank,0,-323,-105,392990,393140,150
108,0,blank,0,-323,-105,393140,393274,134
108,0,blank,0,-323,-105,393274,393455,181
108,0,blank,0,-323,-105,393455,393614,159
108,0,blank,0,-323,-105,393614,394185,571
108,0,blank,0,-323,-105,394185,394445,260
108,0,blank,0,-323,-105,394445,394625,180
108,0,blank,0,-323,-105,394625,394805,180
108,0,blank,0,-323,-105,394805,394982,177
108,0,blank,0,-323,-105,394982,395178,196
108,0,blank,0,-323,-105,395178,395360,182
108,0,blank,0,-323,-105,395360,395516,156
108,0,blank,0,-323,-105,395516,395729,213
109,0,blank,0,-323,-105,396336,396866,530
109,0,blank,0,-323,-105,396866,397000,134
109,0,blank,0,-323,-105,397000,397302,302
109,0,blank,0,-323,-105,397302,397557,255
109,0,blank,0,-323,-105,397557,397743,186
109,0,blank,0,-323,-105,397743,398689,946
109,0,blank,0,-323,-105,398689,398871,182
109,0,blank,0,-323,-105,398871,399022,151
109,0,blank,0,-323,-105,399376,399862,486
109,0,blank,0,-323,-105,399862,400072,210
109,0,blank,0,-323,-105,400072,400212,140
109,0,blank,0,-323,-105,400212,400367,155
109,0,blank,0,-323,-105,400367,400612,245
109,0,blank,0,-323,-105,400612,401240,628
109,0,blank,0,-323,-105,401240,401424,184
109,0,blank,0,-323,-105,401424,401456,32
109,0,blank,0,-323,-105,401456,402017,561
109,0,blank,0,-323,-105,402017,402571,554
109,0,blank,0,-323,-105,402571,402686,115
109,0,blank,0,-323,-105,402686,402930,244
109,0,blank,0,-323,-105,402930,403014,84
109,0,blank,0,-323,-105,403014,403333,319
109,0,blank,0,-323,-105,403333,403522,189
109,0,blank,0,-323,-105,403522,403608,86
109,0,blank,0,-323,-105,403608,403779,171
109,0,blank,0,-323,-105,403779,404016,237
109,0,blank,0,-323,-105,404016,404510,494
109,0,blank,0,-323,-105,404510,404798,288
109,0,blank,0,-323,-105,404798,404936,138
109,0,blank,0,-323,-105,404936,405037,101
109,0,blank,0,-323,-105,405037,405140,103
109,0,blank,0,-323,-105,405140,405402,262
109,0,blank,0,-323,-105,405402,405664,262
109,0,blank,0,-323,-105,405664,405828,164
109,0,blank,0,-323,-105,405828,405928,100
109,0,blank,0,-323,-105,405928,406204,276
109,0,blank,0,-323,-105,406204,406331,127
109,0,blank,0,-323,-105,406331,406502,171
109,0,blank,0,-323,-105,406502,407032,530
109,0,blank,0,-323,-105,407032,407213,181
109,0,blank,0,-323,-105,407213,407274,61
109,0,blank,0,-323,-105,407274,407443,169
109,0,blank,0,-323,-105,407443,407743,300
109,0,blank,0,-323,-105,407743,408061,318
109,0,blank,0,-323,-105,408061,408436,375
109,0,blank,0,-323,-105,408436,408513,77
109,0,blank,0,-323,-105,408513,408675,162
109,0,blank,0,-323,-105,408675,408718,43
109,0,blank,0,-323,-105,408718,408924,206
109,0,blank,0,-323,-105,408924,409034,110
109,0,blank,0,-323,-105,409034,409135,101
109,0,blank,0,-323,-105,409135,409308,173
109,0,blank,0,-323,-105,409308,409368,60
109,0,blank,0,-323,-105,409368,409764,396
109,0,blank,0,-323,-105,409764,409847,83
109,0,blank,0,-323,-105,409847,410231,384
109,0,blank,0,-323,-105,410231,410379,148
109,0,blank,0,-323,-105,410379,411030,651
109,0,blank,0,-323,-105,411030,411301,271
109,0,blank,0,-323,-105,411301,411422,121
109,0,blank,0,-323,-105,411422,411567,145
109,0,blank,0,-323,-105,411567,411906,339
109,0,blank,0,-323,-105,411906,411941,35
109,0,blank,0,-323,-105,411941,412199,258
109,0,blank,0,-323,-105,412199,412434,235
109,0,blank,0,-323,-105,412434,412502,68
109,0,blank,0,-323,-105,412502,413199,697
109,0,blank,0,-323,-105,413199,413384,185
109,0,blank,0,-323,-105,413384,413409,25
109,0,blank,0,-323,-105,413409,413820,411
109,0,blank,0,-323,-105,413820,413849,29
109,0,blank,0,-323,-105,413849,414304,455
109,0,blank,0,-323,-105,414304,414756,452
109,0,blank,0,-323,-105,414756,414926,170
109,0,blank,0,-323,-105,414926,415015,89
109,0,blank,0,-323,-105,415015,415169,154
109,0,blank,0,-323,-105,415169,415291,122
109,0,blank,0,-323,-105,415291,415394,103
109,0,blank,0,-323,-105,415394,415569,175
109,0,blank,0,-323,-105,415569,415995,426
109,0,blank,0,-323,-105,415995,416199,204
109,0,blank,0,-323,-105,416199,416332,133
109,0,blank,0,-323,-105,416332,416510,178
109,0,blank,0,-323,-105,416510,416710,200
109,0,blank,0,-323,-105,416710,416814,104
109,0,blank,0,-323,-105,416814,417196,382
109,0,blank,0,-323,-105,417196,417382,186
109,0,blank,0,-323,-105,417382,417549,167
109,0,blank,0,-323,-105,417549,417732,183
109,0,blank,0,-323,-105,417732,417757,25
109,0,blank,0,-323,-105,417757,418157,400
109,0,blank,0,-323,-105,418157,418549,392
109,0,blank,0,-323,-105,418549,418585,36
109,0,blank,0,-323,-105,418585,418770,185
109,0,blank,0,-323,-105,418770,418850,80
109,0,blank,0,-323,-105,418850,419333,483
109,0,blank,0,-323,-105,419333,419573,240
109,0,blank,0,-323,-105,419573,419702,129
109,0,blank,0,-323,-105,419702,419777,75
109,0,blank,0,-323,-105,419777,420038,261
109,0,blank,0,-323,-105,420038,420169,131
109,0,blank,0,-323,-105,420169,420310,141
109,0,blank,0,-323,-105,420310,420450,140
109,0,blank,0,-323,-105,420450,420857,407
109,0,blank,0,-323,-105,420857,420913,56
109,0,blank,0,-323,-105,420913,421145,232
109,0,blank,0,-323,-105,421145,421381,236
109,0,blank,0,-323,-105,421381,421572,191
109,0,blank,0,-323,-105,421572,421766,194
109,0,blank,0,-323,-105,421766,421949,183
109,0,blank,0,-323,-105,421949,422116,167
109,0,blank,0,-323,-105,422116,422229,113
109,0,blank,0,-323,-105,422229,422563,334
109,0,blank,0,-323,-105,422563,422718,155
109,0,blank,0,-323,-105,422718,422911,193
109,0,blank,0,-323,-105,422911,423411,500
109,0,blank,0,-323,-105,423411,423905,494
109,0,blank,0,-323,-105,423905,424070,165
109,0,blank,0,-323,-105,424070,424114,44
109,0,blank,0,-323,-105,424114,424310,196
109,0,blank,0,-323,-105,424310,424396,86
109,0,blank,0,-323,-105,424396,424627,231
109,0,blank,0,-323,-105,424627,424853,226
109,0,blank,0,-323,-105,424853,425035,182
109,0,blank,0,-323,-105,425035,425229,194
109,0,blank,0,-323,-105,425229,425453,224
109,0,blank,0,-323,-105,425453,425479,26
109,0,blank,0,-323,-105,425479,426037,558
109,0,blank,0,-323,-105,426037,426588,551
109,0,blank,0,-323,-105,426588,426777,189
109,0,blank,0,-323,-105,426777,426917,140
109,0,blank,0,-323,-105,426917,427039,122
109,0,blank,0,-323,-105,427039,427189,150
109,0,blank,0,-323,-105,427189,427477,288
109,0,blank,0,-323,-105,427477,427671,194
109,0,blank,0,-323,-105,427671,428205,534
109,0,blank,0,-323,-105,428205,428597,392
109,0,blank,0,-323,-105,428597,428796,199
109,0,blank,0,-323,-105,428796,428947,151
109,0,blank,0,-323,-105,428947,429129,182
109,0,blank,0,-323,-105,429129,429309,180
109,0,blank,0,-323,-105,429309,429405,96
109,0,blank,0,-323,-105,429405,429595,190
109,0,blank,0,-323,-105,429595,429707,112
109,0,blank,0,-323,-105,429707,429913,206
109,0,blank,0,-323,-105,429913,430225,312
109,0,blank,0,-323,-105,430225,430744,519
109,0,blank,0,-323,-105,430744,431202,458
109,0,blank,0,-323,-105,431202,431361,159
109,0,blank,0,-323,-105,431361,431539,178
109,0,blank,0,-323,-105,431539,431692,153
109,0,blank,0,-323,-105,431692,431841,149
109,0,blank,0,-323,-105,431841,432019,178
109,0,blank,0,-323,-105,432019,432102,83
109,0,blank,0,-323,-105,432102,432294,192
109,0,blank,0,-323,-105,432294,432565,271
109,0,blank,0,-323,-105,432565,432831,266
109,0,blank,0,-323,-105,432831,433028,197
109,0,blank,0,-323,-105,433028,433062,34
109,0,blank,0,-323,-105,433062,433535,473
109,0,blank,0,-323,-105,433535,433706,171
109,0,blank,0,-323,-105,433706,433842,136
109,0,blank,0,-323,-105,433842,433978,136
109,0,blank,0,-323,-105,433978,434076,98
109,0,blank,0,-323,-105,434076,434232,156
109,0,blank,0,-323,-105,434232,434397,165
109,0,blank,0,-323,-105,434397,434492,95
109,0,blank,0,-323,-105,434492,434707,215
109,0,blank,0,-323,-105,434707,434826,119
109,0,blank,0,-323,-105,434826,434971,145
109,0,blank,0,-323,-105,434971,435451,480
109,0,blank,0,-323,-105,435451,435624,173
109,0,blank,0,-323,-105,435624,435782,158
109,0,blank,0,-323,-105,435782,435888,106
109,0,blank,0,-323,-105,435888,436087,199
109,0,blank,0,-323,-105,436087,436181,94
109,0,blank,0,-323,-105,436181,436326,145
109,0,blank,0,-323,-105,436326,436500,174
109,0,blank,0,-323,-105,436500,436630,130
109,0,blank,0,-323,-105,436630,436928,298
109,0,blank,0,-323,-105,436928,437154,226
109,0,blank,0,-323,-105,437154,437213,59
109,0,blank,0,-323,-105,437213,437679,466
109,0,blank,0,-323,-105,437679,437717,38
109,0,blank,0,-323,-105,437717,437907,190
109,0,blank,0,-323,-105,437907,438097,190
109,0,blank,0,-323,-105,438097,438290,193
109,0,blank,0,-323,-105,438290,438484,194
109,0,blank,0,-323,-105,438484,438640,156
109,0,blank,0,-323,-105,438640,438777,137
109,0,blank,0,-323,-105,438777,439006,229
109,0,blank,0,-323,-105,439006,439282,276
109,0,blank,0,-323,-105,439282,439382,100
109,0,blank,0,-323,-105,439382,439729,347
109,0,blank,0,-323,-105,439729,439785,56
109,0,blank,0,-323,-105,439785,440205,420
109,0,blank,0,-323,-105,440205,440705,500
109,0,blank,0,-323,-105,440705,440830,125
109,0,blank,0,-323,-105,440830,441024,194
109,0,blank,0,-323,-105,441024,441196,172
109,0,blank,0,-323,-105,441196,441362,166
109,0,blank,0,-323,-105,441362,441486,124
109,0,blank,0,-323,-105,441486,441666,180
109,0,blank,0,-323,-105,441666,441768,102
109,0,blank,0,-323,-105,441768,441899,131
109,0,blank,0,-323,-105,441899,442222,323
109,0,blank,0,-323,-105,442222,442415,193
109,0,blank,0,-323,-105,442415,442473,58
109,0,blank,0,-323,-105,442473,442734,261
109,0,blank,0,-323,-105,442734,442949,215
109,0,blank,0,-323,-105,442949,443243,294
109,0,blank,0,-323,-105,443243,443277,34
109,0,blank,0,-323,-105,443277,443572,295
109,0,blank,0,-323,-105,443572,443863,291
109,0,blank,0,-323,-105,443863,444038,175
109,0,blank,0,-323,-105,444038,444387,349
109,0,blank,0,-323,-105,444387,444497,110
109,0,blank,0,-323,-105,444497,444964,467
109,0,blank,0,-323,-105,444964,445133,169
109,0,blank,0,-323,-105,445133,445177,44
109,0,blank,0,-323,-105,445177,445803,626
109,0,blank,0,-323,-105,445803,446174,371
109,0,blank,0,-323,-105,446174,446307,133
109,0,blank,0,-323,-105,446307,446757,450
109,0,blank,0,-323,-105,446757,447204,447
109,0,blank,0,-323,-105,447204,447381,177
109,0,blank,0,-323,-105,447381,447517,136
109,0,blank,0,-323,-105,447517,447645,128
109,0,blank,0,-323,-105,447645,447769,124
109,0,blank,0,-323,-105,447769,447958,189
109,0,blank,0,-323,-105,447958,448524,566
109,0,blank,0,-323,-105,448524,448718,194
109,0,blank,0,-323,-105,448718,449007,289
109,0,blank,0,-323,-105,449007,449299,292
109,0,blank,0,-323,-105,449299,449677,378
109,0,blank,0,-323,-105,449677,449743,66
109,0,blank,0,-323,-105,449743,450290,547
109,0,blank,0,-323,-105,450290,450460,170
109,0,blank,0,-323,-105,450460,450571,111
109,0,blank,0,-323,-105,450571,450869,298
109,0,blank,0,-323,-105,450869,450999,130
109,0,blank,0,-323,-105,450999,451569,570
109,0,blank,0,-323,-105,451569,451747,178
109,0,blank,0,-323,-105,451747,451941,194
109,0,blank,0,-323,-105,451941,452112,171
109,0,blank,0,-323,-105,452112,452307,195
109,0,blank,0,-323,-105,452307,452489,182
109,0,blank,0,-323,-105,452489,452596,107
109,0,blank,0,-323,-105,452596,452815,219
109,0,blank,0,-323,-105,452815,452861,46
109,0,blank,0,-323,-105,452861,453244,383
109,0,blank,0,-323,-105,453244,453326,82
109,0,blank,0,-323,-105,453326,453660,334
109,0,blank,0,-323,-105,453660,453917,257
109,0,blank,0,-323,-105,453917,454370,453
109,0,blank,0,-323,-105,454370,454555,185
109,0,blank,0,-323,-105,454555,454769,214
109,0,blank,0,-323,-105,454769,454881,112
109,0,blank,0,-323,-105,454881,455452,571
109,0,blank,0,-323,-105,455452,455828,376
109,0,blank,0,-323,-105,455828,455963,135
109,0,blank,0,-323,-105,455963,456222,259
109,0,blank,0,-323,-105,456222,456256,34
109,0,blank,0,-323,-105,456256,456663,407
109,0,blank,0,-323,-105,456663,456859,196
109,0,blank,0,-323,-105,456859,456916,57
109,0,blank,0,-323,-105,456916,457223,307
109,0,blank,0,-323,-105,457223,457327,104
109,0,blank,0,-323,-105,457327,458353,1026
109,0,blank,0,-323,-105,458353,458518,165
109,0,blank,0,-323,-105,458518,458653,135
109,0,blank,0,-323,-105,458653,459081,428
109,0,blank,0,-323,-105,459081,459499,418
109,0,blank,0,431.9137,406.7036,459542,459573,31
109,0,blank,0,-323,-105,460175,460364,189
109,0,blank,0,-323,-105,460364,460453,89
109,0,blank,0,-323,-105,460453,460633,180
109,0,blank,0,-323,-105,460633,461067,434
109,0,blank,0,-323,-105,461067,461491,424
109,0,blank,0,-323,-105,461491,461629,138
109,0,blank,0,-323,-105,461629,461823,194
109,0,blank,0,-323,-105,461823,461884,61
109,0,blank,0,-323,-105,461884,462120,236
109,0,blank,0,-323,-105,462120,462316,196
109,0,blank,0,-323,-105,462316,462511,195
109,0,blank,0,-323,-105,462511,462775,264
109,0,blank,0,-323,-105,462775,462903,128
109,0,blank,0,-323,-105,462903,463487,584
110,0,blank,0,-323,-105,464450,464541,91
110,0,blank,0,-323,-105,464541,464719,178
110,0,blank,0,-323,-105,464719,465063,344
110,0,blank,0,-323,-105,465063,465151,88
110,0,blank,0,-323,-105,465151,465333,182
110,0,blank,0,-323,-105,465333,465403,70
110,0,blank,0,-323,-105,465658,465834,176
110,0,blank,0,-323,-105,465834,466015,181
110,0,blank,0,-323,-105,466015,466112,97
110,0,blank,0,-323,-105,466112,466453,341
110,0,blank,0,-323,-105,466453,466651,198
110,0,blank,0,-323,-105,466651,466824,173
110,0,blank,0,-323,-105,466824,466963,139
110,0,blank,0,-323,-105,466963,467232,269
110,0,blank,0,-323,-105,467232,467365,133
110,0,blank,0,-323,-105,467365,467640,275
110,0,blank,0,-323,-105,467640,468054,414
110,0,blank,0,-323,-105,468054,468120,66
110,0,blank,0,-323,-105,468120,468430,310
110,0,blank,0,-323,-105,468430,468731,301
110,0,blank,0,-323,-105,468731,468858,127
110,0,blank,0,-323,-105,468858,469039,181
110,0,blank,0,-323,-105,469039,469230,191
110,0,blank,0,-323,-105,469230,469406,176
110,0,blank,0,-323,-105,469406,469583,177
110,0,blank,0,-323,-105,469583,469740,157
110,0,blank,0,-323,-105,469740,470027,287
110,0,blank,0,-323,-105,470027,470210,183
110,0,blank,0,-323,-105,470210,470350,140
110,0,blank,0,-323,-105,470350,470521,171
110,0,blank,0,-323,-105,470521,470702,181
110,0,blank,0,-323,-105,470702,470882,180
110,0,blank,0,-323,-105,470882,471064,182
110,0,blank,0,-323,-105,471064,471254,190
110,0,blank,0,-323,-105,471254,471481,227
110,0,blank,0,-323,-105,471481,471708,227
110,0,blank,0,-323,-105,471708,471885,177
110,0,blank,0,-323,-105,471885,472054,169
110,0,blank,0,-323,-105,472054,472252,198
110,0,blank,0,-323,-105,472252,472445,193
110,0,blank,0,-323,-105,472445,472642,197
110,0,blank,0,-323,-105,472642,472751,109
110,0,blank,0,-323,-105,472751,472860,109
110,0,blank,0,-323,-105,472860,472985,125
110,0,blank,0,-323,-105,472985,473126,141
110,0,blank,0,-323,-105,473126,473269,143
110,0,blank,0,-323,-105,473269,473464,195
110,0,blank,0,-323,-105,473464,473549,85
110,0,blank,0,-323,-105,473549,473675,126
110,0,blank,0,-323,-105,473675,473807,132
110,0,blank,0,-323,-105,473807,473931,124
110,0,blank,0,-323,-105,473931,474056,125
110,0,blank,0,-323,-105,474056,474243,187
110,0,blank,0,-323,-105,474243,474289,46
110,0,blank,0,-323,-105,474289,474479,190
