Frameno_fix,lineno_fix,Tokenname_fix,tokens_id,gaze_X_fix,gaze_Y_fix,timestamp_fix_start,timestamp_fix_end,time_duration
100,0,blank,0,148.346716666667,-59.7315166666667,3143,3338,195
100,0,blank,0,194.8857,-26.4607833333333,3338,3535,197
100,0,blank,0,87.09132,-5.12222,3535,3723,188
100,0,blank,0,540.810216666667,-19.99775,3788,3984,196
100,0,blank,0,529.33562,-31.87212,3984,4150,166
100,0,blank,0,538.0881,-30.0913,4150,4184,34
100,0,blank,0,442.191916666667,2.04226666666667,4216,4411,195
100,0,blank,0,120.921716666667,-31.1930166666667,4444,4640,196
100,0,blank,0,85.61955,-28.0983,4640,4834,194
100,0,blank,0,92.0303,-26.3321,4834,4900,66
100,0,blank,0,775.9904,1.49144,4964,5126,162
100,0,blank,0,1091.7274,50.3297,5159,5321,162
100,0,blank,0,1036.287,333.675375,5354,5485,131
100,0,blank,0,411.19056,64.02782,5549,5714,165
100,0,blank,0,483.239883333333,-0.939416666666664,5746,5944,198
100,0,blank,0,490.29705,-7.62163333333333,5944,6141,197
100,0,blank,0,485.777525,-14.955175,6141,6273,132
100,0,blank,0,-323,-105,6305,6470,165
100,0,blank,0,397.9175,-16.3312,6516,6569,53
100,0,blank,0,410.347483333333,-13.9727833333333,6636,6830,194
100,0,blank,0,404.32345,-10.6757666666667,6830,7029,199
100,2,elements,25,393.42925,26.6702,7029,7095,66
100,1,to,5,130.37885,10.1601166666667,7160,7358,198
100,1,to,5,126.5661,21.0763166666667,7358,7555,197
100,1,find,15,177.52864,17.81672,7555,7721,166
100,1,find,15,175.075733333333,23.1367166666667,7721,7916,195
100,1,program,4,113.053,9.82016666666667,7916,8107,191
100,2,diagonal,24,113.740266666667,35.5149666666667,8107,8301,194
100,2,diagonal,24,129.32875,30.1191666666667,8301,8497,196
100,2,diagonal,24,98.4244333333333,38.7107166666667,8497,8692,195
100,1,find,15,158.201716666667,22.2947833333333,8692,8887,195
100,0,blank,0,119.242483333333,-24.2313166666667,8887,9086,199
100,0,blank,0,99.98456,-29.7094,9086,9257,171
100,0,blank,0,236.7141,-38.5214,9290,9426,136
100,0,blank,0,263.18202,-18.33654,9426,9620,194
100,0,blank,0,312.660533333333,-9.24411666666667,9620,9816,196
100,1,order,10,364.929783333333,7.36708333333333,9816,10010,194
100,0,blank,0,326.64815,-15.14425,10010,10204,194
100,1,order,10,356.621166666667,4.10321666666667,10204,10400,196
100,0,blank,0,385.57718,-0.871359999999999,10400,10589,189
100,0,blank,0,381.463166666667,-16.10695,10589,10787,198
100,0,blank,0,436.16972,-4.4461,10787,10978,191
100,1,find,15,489.0475,3.9859,10978,11158,180
100,0,blank,0,520.707416666667,-13.4801666666667,11158,11357,199
100,0,blank,0,574.3927,-16.26126,11357,11525,168
100,0,blank,0,619.535766666667,-10.0751666666667,11525,11656,131
100,0,blank,0,40.6192333333333,19.7412333333333,11722,11921,199
100,0,blank,0,115.27908,8.77596,11921,12090,169
100,0,blank,0,115.48188,21.81582,12090,12255,165
100,1,matrix,8,246.7585,23.77278,12288,12455,167
100,1,matrix,8,248.11174,23.41952,12455,12619,164
100,0,blank,0,262.4239,54.8858,12619,12685,66
100,2,elements,25,379.5833,27.0168166666667,12710,12906,196
100,1,order,10,350.086,19.25895,12906,12984,78
100,1,order,10,370.7484,21.0482,12984,13185,201
100,0,blank,0,443.92435,-14.09295,13185,13360,175
100,1,N,13,428.40162,17.49814,13360,13531,171
100,1,order,10,368.186683333333,9.25131666666667,13531,13727,196
100,0,blank,0,375.386316666667,12.7633166666667,13727,13924,197
100,0,blank,0,436.802816666667,73.4983333333333,13924,14123,199
100,0,blank,0,477.1075,16.3684,14123,14316,193
100,0,blank,0,485.4613,39.7206,14316,14348,32
100,0,blank,0,-323,-105,14448,14626,178
100,0,blank,0,-323,-105,14626,14785,159
100,0,blank,0,-323,-105,14785,14977,192
100,0,blank,0,-323,-105,14977,15038,61
100,0,blank,0,442.068216666667,25.6652166666667,15075,15274,199
100,0,blank,0,482.1376,25.6127,15274,15450,176
100,0,blank,0,478.34714,32.4417,15450,15628,178
100,0,blank,0,481.510216666667,36.9498166666667,15628,15824,196
100,1,find,15,487.40605,19.74125,15824,16023,199
100,0,blank,0,475.108833333333,13.3374333333333,16023,16222,199
100,0,blank,0,479.13736,13.03358,16222,16388,166
100,0,blank,0,479.2346,2.30473333333334,16388,16587,199
100,1,and,14,470.9,1.9713,16587,16620,33
100,1,program,4,80.55764,14.06862,16654,16821,167
100,1,program,4,46.8027833333333,13.2385,16821,17020,199
100,1,program,4,78.5068666666667,1.53403333333333,17020,17216,196
100,1,program,4,69.48215,13.8362166666667,17216,17411,195
100,1,program,4,77.0648,2.16963333333333,17411,17606,195
100,0,blank,0,65.36095,-12.51465,17606,17672,66
100,1,find,15,505.3443,3.1892,17737,17924,187
100,0,blank,0,186.071825,54.281075,17956,18086,130
100,4,(,37,96.846325,71.25385,18086,18262,176
100,3,include,29,81.67045,54.4535666666667,18262,18457,195
100,0,blank,0,84.04358,52.49426,18457,18640,183
100,0,blank,0,86.3151,54.994025,18640,18835,195
100,3,stdio,31,128.81058,61.49114,18835,18991,156
100,3,>,34,174.436025,53.7478,18991,19164,173
100,0,blank,0,167.38485,47.991325,19164,19346,182
100,3,>,34,179.245675,48.984775,19346,19519,173
100,2,Opposite,23,210.23044,39.10142,19519,19687,168
100,0,blank,0,187.88322,60.59458,19687,19867,180
100,0,blank,0,90.0127333333334,76.1737333333333,19867,20056,189
100,4,main,36,74.7832166666667,78.7176833333333,20056,20246,190
100,0,blank,0,113.5954,68.3340333333333,20246,20438,192
100,0,blank,0,135.570016666667,82.52945,20438,20628,190
100,0,blank,0,144.932066666667,84.4872666666667,20628,20818,190
100,0,blank,0,112.1164,81.42874,20818,21002,184
100,0,blank,0,71.8050833333333,91.8149666666666,21002,21189,187
100,0,blank,0,65.8583333333333,97.2296666666667,21189,21374,185
100,6,int,41,120.31214,114.1156,21374,21556,182
100,0,blank,0,58.87636,94.71296,21556,21707,151
100,0,blank,0,-323,-105,21769,21896,127
100,4,main,36,73.2025,87.8209833333333,22034,22214,180
100,4,(,37,102.84606,88.85294,22214,22395,181
100,0,blank,0,150.650466666667,72.9660833333333,22395,22584,189
100,0,blank,0,119.07416,83.30756,22584,22771,187
100,4,main,36,74.0217,80.1211166666667,22771,22950,179
100,0,blank,0,103.266183333333,76.7772,22950,23136,186
100,0,blank,0,112.8959,77.67014,23136,23316,180
100,4,),38,111.082183333333,78.4527666666667,23316,23507,191
100,0,blank,0,65.5559333333333,101.990833333333,23507,23698,191
100,0,blank,0,53.1448166666667,99.6628666666667,23698,23891,193
100,0,blank,0,66.2648666666667,94.8316333333333,23891,24082,191
100,0,blank,0,45.6385333333333,100.087033333333,24082,24272,190
100,4,main,36,51.61358,88.4783,24272,24454,182
100,0,blank,0,59.2888,98.0335833333333,24454,24647,193
100,4,),38,104.697833333333,80.2764166666667,24647,24838,191
100,4,),38,111.100383333333,79.8730166666667,24838,25027,189
100,0,blank,0,93.7627166666667,78.2735,25027,25220,193
100,4,main,36,79.4998166666667,79.5140333333333,25220,25410,190
100,4,(,37,97.5290833333333,78.3194666666667,25410,25599,189
100,0,blank,0,115.8969,79.56808,25599,25759,160
100,4,),38,106.6494,71.844,25759,25823,64
100,4,(,37,100.6519,73.0888,25823,25978,155
100,4,(,37,95.4328,87.1225666666667,25978,26132,154
100,4,main,36,82.707875,69.41365,26132,26309,177
100,3,include,29,75.6241,63.02132,26309,26486,177
100,4,main,36,67.0356166666667,79.2870166666667,26486,26680,194
100,0,blank,0,75.46856,97.28386,26680,26873,193
100,6,int,41,117.700533333333,118.427116666667,26873,27057,184
100,4,main,36,70.8768666666667,85.46345,27057,27246,189
100,0,blank,0,94.8667666666667,91.7536333333333,27246,27436,190
100,0,blank,0,101.47705,91.1194333333333,27436,27625,189
100,0,blank,0,103.59205,103.3682,27625,27813,188
100,6,int,41,136.9554,118.59282,27813,27994,181
100,6,array,42,178.68976,132.29602,27994,28154,160
100,6,array,42,162.501675,125.5325,28154,28335,181
100,0,blank,0,139.37832,134.49694,28335,28514,179
100,6,array,42,163.318933333333,131.034033333333,28514,28692,178
100,6,10,47,218.1396,120.56592,28692,28880,188
100,0,blank,0,234.99778,113.93826,28880,29053,173
100,6,10,47,259.627066666667,117.85875,29053,29243,190
100,0,blank,0,222.469316666667,106.52395,29243,29433,190
100,0,blank,0,170.917733333333,113.026866666667,29433,29623,190
100,0,blank,0,187.089583333333,112.009933333333,29623,29813,190
100,6,10,47,227.5312,119.81745,29813,29941,128
100,0,blank,0,-323,-105,30006,30158,152
100,0,blank,0,-323,-105,30158,30213,55
100,0,blank,0,178.2167,105.608033333333,30245,30427,182
100,0,blank,0,163.381483333333,111.037466666667,30427,30618,191
100,6,10,47,218.037033333333,125.146633333333,30618,30814,196
100,6,10,47,230.214266666667,124.514083333333,30814,30998,184
100,0,blank,0,243.72955,123.229116666667,30998,31187,189
100,6,[,46,250.677866666667,120.062416666667,31187,31377,190
100,0,blank,0,216.991866666667,102.987533333333,31377,31564,187
100,0,blank,0,234.151566666667,110.57835,31564,31754,190
100,0,blank,0,254.53725,102.9044,31754,31941,187
100,6,10,47,267.644766666667,115.20675,31941,32130,189
100,0,blank,0,240.10966,104.52054,32130,32290,160
100,0,blank,0,-323,-105,32320,32480,160
100,6,10,47,257.8153,126.5502,32513,32559,46
100,6,],48,276.63145,114.30165,32623,32801,178
100,6,;,49,288.292766666667,121.909666666667,32801,32992,191
100,0,blank,0,297.221666666667,121.7039,32992,33181,189
100,0,blank,0,312.78096,123.13608,33181,33338,157
100,0,blank,0,329.1166,119.7008,33338,33396,58
100,0,blank,0,111.03315,144.71065,33505,33697,192
100,7,comma,62,129.9701,152.43938,33697,33868,171
100,7,comma,62,184.4341,145.214225,33868,33994,126
100,7,n,57,176.821175,153.93525,33994,34187,193
100,7,n,57,173.91696,151.84936,34187,34344,157
100,0,blank,0,219.28598,138.16532,34344,34523,179
100,7,a,59,212.1337,142.056583333333,34523,34712,189
100,6,10,47,257.340716666667,129.7008,34712,34900,188
100,7,0,65,249.23275,147.372783333333,34900,35087,187
100,0,blank,0,255.69955,134.404816666667,35087,35275,188
100,0,blank,0,285.08535,135.939616666667,35275,35464,189
100,6,;,49,290.923416666667,129.26735,35464,35655,191
100,0,blank,0,293.311133333333,120.716,35655,35847,192
100,6,],48,281.93865,123.127966666667,35847,36036,189
100,6,[,46,212.474683333333,125.170466666667,36036,36225,189
100,6,10,47,232.80024,125.10912,36225,36406,181
100,6,[,46,248.159116666667,128.179533333333,36406,36596,190
100,0,blank,0,290.30282,135.35638,36596,36778,182
100,0,blank,0,295.327466666667,129.577683333333,36778,36971,193
100,6,;,49,289.4141,118.1775,36971,37003,32
100,0,blank,0,340.172416666667,132.853583333333,37159,37349,190
100,7,0,65,335.362583333333,142.831233333333,37349,37543,194
100,0,blank,0,370.659825,151.5319,37543,37722,179
100,0,blank,0,377.009033333333,149.485633333333,37722,37906,184
100,7,;,66,347.7281,142.8053,37906,37939,33
100,8,"Entertheorderofthematrix\n",69,138.078683333333,170.8687,37969,38156,187
100,8,"Entertheorderofthematrix\n",69,134.664766666667,166.0598,38156,38342,186
100,8,"Entertheorderofthematrix\n",69,175.646816666667,164.253916666667,38342,38529,187
100,8,"Entertheorderofthematrix\n",69,231.819033333333,170.79925,38529,38715,186
100,8,"Entertheorderofthematrix\n",69,304.980166666667,157.840016666667,38715,38906,191
100,8,"Entertheorderofthematrix\n",69,369.177116666667,157.4792,38906,39098,192
100,8,"Entertheorderofthematrix\n",69,436.284583333333,166.420166666667,39098,39287,189
100,8,),70,460.66935,166.987933333333,39287,39478,191
100,0,blank,0,444.8322,143.550633333333,39478,39669,191
100,9,"%d%d",74,154.62475,182.048216666667,39732,39924,192
100,8,"Entertheorderofthematrix\n",69,144.312483333333,173.414033333333,39924,40116,192
100,8,"Entertheorderofthematrix\n",69,195.73475,170.546883333333,40116,40309,193
100,8,"Entertheorderofthematrix\n",69,202.857,177.213433333333,40309,40500,191
100,8,"Entertheorderofthematrix\n",69,217.3443,176.581266666667,40500,40690,190
100,8,"Entertheorderofthematrix\n",69,174.24315,160.48155,40690,40880,190
100,0,blank,0,183.228916666667,189.269633333333,40880,41071,191
100,9,comma,78,181.980866666667,180.887666666667,41071,41261,190
100,8,"Entertheorderofthematrix\n",69,188.84105,176.36565,41261,41450,189
100,9,comma,78,220.7318,179.426983333333,41450,41639,189
100,8,"Entertheorderofthematrix\n",69,239.734183333333,177.598783333333,41639,41832,193
100,8,"Entertheorderofthematrix\n",69,249.811533333333,162.359216666667,41832,42026,194
100,8,"Entertheorderofthematrix\n",69,237.197866666667,169.253233333333,42026,42220,194
100,9,&,79,193.8849,180.54485,42220,42414,194
100,0,blank,0,186.346533333333,181.925083333333,42414,42606,192
100,8,"Entertheorderofthematrix\n",69,172.318966666667,175.112916666667,42606,42798,192
100,9,"%d%d",74,168.102275,192.7686,42798,42948,150
100,9,"%d%d",74,163.87588,189.51938,42948,43126,178
100,9,&,79,197.571666666667,184.535383333333,43126,43317,191
100,9,m,77,210.947316666667,187.808533333333,43317,43506,189
100,9,&,79,196.230433333333,183.2065,43506,43698,192
100,8,"Entertheorderofthematrix\n",69,236.609183333333,176.341683333333,43698,43891,193
100,8,"Entertheorderofthematrix\n",69,242.97885,174.5893,43891,44083,192
100,9,&,79,203.15965,179.811716666667,44083,44274,191
100,8,"Entertheorderofthematrix\n",69,189.735316666667,177.670933333333,44274,44465,191
100,0,blank,0,191.584483333333,182.492883333333,44465,44656,191
100,9,&,79,197.2935,182.44595,44656,44718,62
100,0,blank,0,-323,-105,44750,44911,161
100,9,comma,78,177.718466666667,186.91995,45023,45195,172
100,9,"%d%d",74,172.003666666667,179.39495,45195,45384,189
100,0,blank,0,190.1529,190.689483333333,45384,45571,187
100,8,"Entertheorderofthematrix\n",69,198.922366666667,175.36005,45571,45759,188
100,8,"Entertheorderofthematrix\n",69,203.634633333333,175.72675,45759,45944,185
100,8,"Entertheorderofthematrix\n",69,180.432966666667,177.8097,45944,46129,185
100,0,blank,0,175.703316666667,178.8213,46129,46315,186
100,8,"Entertheorderofthematrix\n",69,215.139483333333,174.5457,46315,46500,185
100,8,"Entertheorderofthematrix\n",69,252.9069,161.527433333333,46500,46688,188
100,8,"Entertheorderofthematrix\n",69,250.2043,176.779566666667,46688,46874,186
100,0,blank,0,279.449316666667,179.965916666667,46874,47062,188
100,8,"Entertheorderofthematrix\n",69,286.60845,176.2182,47062,47211,149
100,0,blank,0,272.3115,182.11666,47211,47398,187
100,9,n,80,245.00006,188.11012,47398,47584,186
100,8,"Entertheorderofthematrix\n",69,242.378483333333,177.048683333333,47584,47779,195
100,9,m,77,210.827033333333,180.78315,47779,47973,194
100,9,comma,78,174.255133333333,181.982333333333,47973,48164,191
100,9,&,79,193.336483333333,184.105116666667,48164,48357,193
100,0,blank,0,191.068533333333,196.6679,48357,48455,98
100,0,blank,0,-323,-105,48487,48600,113
100,9,comma,78,178.8256,186.5324,48642,48692,50
100,9,comma,78,180.115133333333,188.77035,48781,48964,183
100,9,m,77,212.647583333333,180.865816666667,48964,49157,193
100,0,blank,0,224.4648,200.4743,49157,49189,32
100,9,n,80,250.6622,192.2911,49189,49409,220
100,9,&,79,244.529116666667,190.546983333333,49409,49586,177
100,9,n,80,249.2636,185.2481,49586,49651,65
100,0,blank,0,-323,-105,49717,49878,161
100,9,comma,78,218.4857,196.9326,49920,49973,53
100,9,n,80,247.029116666667,184.66965,50038,50220,182
100,9,&,79,234.587383333333,184.033566666667,50220,50412,192
100,9,&,79,241.6356,183.652116666667,50412,50605,193
100,8,"Entertheorderofthematrix\n",69,239.8758,174.161325,50605,50733,128
100,0,blank,0,-323,-105,50797,50991,194
100,9,&,79,242.3878,179.19926,51025,51171,146
100,0,blank,0,229.16562,185.75528,51171,51360,189
100,9,&,79,244.46508,193.02704,51360,51523,163
100,0,blank,0,261.19072,204.46124,51523,51709,186
100,9,&,79,241.97675,187.442416666667,51709,51900,191
100,9,&,79,240.2215,187.10905,51900,51964,64
100,0,blank,0,-323,-105,51997,52131,134
100,9,n,80,252.760833333333,191.3798,52272,52455,183
100,9,n,80,252.973683333333,182.522616666667,52455,52653,198
100,9,&,79,239.70615,187.731466666667,52653,52849,196
100,9,&,79,239.24525,185.5389,52849,53041,192
100,8,"Entertheorderofthematrix\n",69,244.624866666667,174.914066666667,53041,53237,196
100,9,n,80,251.72105,188.525366666667,53237,53432,195
100,0,blank,0,242.174366666667,200.716866666667,53432,53629,197
100,9,&,79,240.126675,188.73265,53629,53796,167
100,9,n,80,247.5202,191.6427,53796,53917,121
100,9,&,79,239.24875,184.72895,53917,54116,199
100,0,blank,0,269.25768,203.02196,54116,54285,169
100,9,),81,257.203583333333,186.671933333333,54285,54483,198
100,0,blank,0,244.7225,218.417,54483,54516,33
100,0,blank,0,-323,-105,54583,54741,158
100,9,),81,260.19595,182.67215,54867,55051,184
100,9,),81,255.860633333333,183.377916666667,55051,55245,194
100,9,),81,256.861966666667,186.797533333333,55245,55442,197
100,9,;,82,270.855066666667,197.392816666667,55442,55637,195
100,0,blank,0,278.547816666667,189.158733333333,55637,55829,192
100,9,),81,257.036766666667,189.47035,55829,56024,195
100,9,&,79,243.5915,188.0478,56024,56056,32
100,0,blank,0,-323,-105,56121,56229,108
100,0,blank,0,246.58784,178.21434,56344,56543,199
100,0,blank,0,262.3188,193.804866666667,56543,56739,196
100,9,),81,254.658266666667,189.111933333333,56739,56933,194
100,9,),81,258.702733333333,198.0249,56933,57126,193
100,9,),81,258.031783333333,194.27635,57126,57319,193
100,9,),81,254.276616666667,183.738266666667,57319,57513,194
100,9,n,80,246.374383333333,186.260116666667,57513,57709,196
100,9,;,82,266.14618,185.5776,57709,57878,169
100,0,blank,0,263.116083333333,182.34395,57878,58076,198
100,9,n,80,246.881133333333,196.246733333333,58076,58273,197
100,9,m,77,209.418266666667,194.718516666667,58273,58467,194
100,9,),81,257.885966666667,192.480366666667,58467,58658,191
100,9,&,79,244.163275,192.82795,58658,58786,128
100,0,blank,0,124.27658,214.03286,58817,58997,180
100,10,==,86,118.91805,221.3358,58997,59187,190
100,0,blank,0,165.887433333333,212.27225,59187,59375,188
100,0,blank,0,166.4744,229.140333333333,59375,59563,188
100,0,blank,0,177.630716666667,213.9424,59563,59751,188
100,0,blank,0,205.912766666667,211.355833333333,59751,59939,188
100,9,&,79,235.750366666667,190.926283333333,59939,60131,192
100,9,&,79,237.238066666667,196.073066666667,60131,60320,189
100,0,blank,0,206.5171,218.5772,60320,60512,192
100,0,blank,0,174.91215,240.685483333333,60512,60704,192
100,12,"Entertheco-efficientofthematrix\n",92,237.189366666667,246.29735,60704,60900,196
100,12,"Entertheco-efficientofthematrix\n",92,310.4455,258.0845,60900,61098,198
100,12,"Entertheco-efficientofthematrix\n",92,305.0722,252.600733333333,61098,61291,193
100,12,"Entertheco-efficientofthematrix\n",92,282.65606,247.54534,61291,61450,159
100,12,"Entertheco-efficientofthematrix\n",92,429.199916666667,263.722066666667,61483,61670,187
100,12,"Entertheco-efficientofthematrix\n",92,502.732666666667,259.844733333333,61670,61856,186
100,12,"Entertheco-efficientofthematrix\n",92,514.776616666667,265.899366666667,61856,62044,188
100,12,"Entertheco-efficientofthematrix\n",92,520.4916,262.813833333333,62044,62229,185
100,12,"Entertheco-efficientofthematrix\n",92,524.06145,261.159883333333,62229,62418,189
100,12,"Entertheco-efficientofthematrix\n",92,547.746633333333,260.4277,62418,62610,192
100,12,"Entertheco-efficientofthematrix\n",92,547.85745,259.7314,62610,62738,128
100,12,"Entertheco-efficientofthematrix\n",92,208.836483333333,254.565,62802,62996,194
100,13,0,99,175.963383333333,272.393566666667,62996,63190,194
100,13,=,98,158.14655,274.411683333333,63190,63382,192
100,12,"Entertheco-efficientofthematrix\n",92,168.250866666667,254.3468,63382,63573,191
100,12,"Entertheco-efficientofthematrix\n",92,206.4226,255.830866666667,63573,63764,191
100,0,blank,0,174.660933333333,229.821933333333,63764,63951,187
100,0,blank,0,148.8926,217.8508,63951,64136,185
100,0,blank,0,183.656683333333,211.8984,64136,64324,188
100,0,blank,0,177.762633333333,210.359916666667,64324,64513,189
100,0,blank,0,174.87225,209.947966666667,64513,64699,186
100,0,blank,0,167.6302,209.187933333333,64699,64887,188
100,0,blank,0,180.826566666667,214.069066666667,64887,65076,189
100,0,blank,0,179.249133333333,238.244683333333,65076,65268,192
100,12,"Entertheco-efficientofthematrix\n",92,207.649266666667,247.831216666667,65268,65460,192
100,12,"Entertheco-efficientofthematrix\n",92,247.167766666667,252.520416666667,65460,65651,191
100,12,"Entertheco-efficientofthematrix\n",92,301.982216666667,255.203683333333,65651,65843,192
100,12,"Entertheco-efficientofthematrix\n",92,300.968666666667,262.209133333333,65843,66033,190
100,12,"Entertheco-efficientofthematrix\n",92,313.716,256.925083333333,66033,66223,190
100,12,"Entertheco-efficientofthematrix\n",92,324.208916666667,261.745183333333,66223,66413,190
100,12,"Entertheco-efficientofthematrix\n",92,384.26045,262.106883333333,66413,66604,191
100,12,"Entertheco-efficientofthematrix\n",92,443.88045,261.774716666667,66604,66795,191
100,0,blank,0,356.775616666667,274.6891,66795,66982,187
100,0,blank,0,356.660866666667,243.245016666667,66982,67170,188
100,12,"Entertheco-efficientofthematrix\n",92,365.937833333333,252.284433333333,67170,67357,187
100,12,"Entertheco-efficientofthematrix\n",92,367.3727,247.057416666667,67357,67542,185
100,12,"Entertheco-efficientofthematrix\n",92,411.50645,261.050316666667,67542,67725,183
100,0,blank,0,487.88104,270.15146,67725,67876,151
100,0,blank,0,497.774625,231.7589,67907,68067,160
100,12,"Entertheco-efficientofthematrix\n",92,517.578,249.2403,68067,68229,162
100,12,"Entertheco-efficientofthematrix\n",92,514.5458,264.4327,68229,68399,170
100,12,"Entertheco-efficientofthematrix\n",92,537.6438,260.14835,68399,68563,164
100,12,"Entertheco-efficientofthematrix\n",92,551.17695,264.241475,68563,68730,167
100,0,blank,0,579.99686,262.22636,68730,68896,166
100,12,"Entertheco-efficientofthematrix\n",92,212.983483333333,251.752383333333,68957,69140,183
100,0,blank,0,348.077666666667,191.0938,69171,69353,182
100,9,),81,254.161766666667,187.9522,69353,69536,183
100,0,blank,0,262.266083333333,193.656533333333,69536,69718,182
100,0,blank,0,172.6892,212.326016666667,69718,69903,185
100,0,blank,0,132.81375,210.389383333333,69903,70087,184
100,0,blank,0,166.30365,207.258616666667,70087,70272,185
100,0,blank,0,171.3125,204.888133333333,70272,70457,185
100,0,blank,0,166.069883333333,235.183133333333,70457,70643,186
100,0,blank,0,171.808266666667,220.829316666667,70643,70829,186
100,0,blank,0,170.051233333333,233.328366666667,70829,71015,186
100,13,0,99,175.163933333333,278.024533333333,71015,71198,183
100,13,=,98,163.2936,280.33555,71198,71383,185
100,0,blank,0,194.693,271.96855,71383,71569,186
100,13,i,106,206.752183333333,282.119316666667,71569,71754,185
100,0,blank,0,234.4779,272.80855,71754,71939,185
100,0,blank,0,270.339983333333,274.491133333333,71939,72123,184
100,13,++,105,280.5053,275.7,72123,72305,182
100,12,"Entertheco-efficientofthematrix\n",92,313.005566666667,265.785466666667,72305,72488,183
100,0,blank,0,324.051016666667,279.694766666667,72488,72674,186
100,12,"Entertheco-efficientofthematrix\n",92,238.9612,253.597133333333,72674,72858,184
100,12,"Entertheco-efficientofthematrix\n",92,277.219116666667,262.353166666667,72858,73045,187
100,0,blank,0,188.112466666667,330.815483333333,73045,73233,188
100,0,blank,0,234.691166666667,314.469166666667,73233,73423,190
100,0,blank,0,237.5972,316.771833333333,73423,73612,189
100,0,blank,0,273.02905,331.5131,73612,73800,188
100,15,n,117,291.656216666667,330.042366666667,73800,73986,186
100,0,blank,0,301.00612,334.69756,73986,74168,182
100,0,blank,0,249.4191,338.7589,74168,74283,115
100,17,"%d",125,251.6282,363.209,74283,74370,87
100,17,"%d",125,247.6452,370.333033333333,74370,74558,188
100,17,"%d",125,259.672183333333,369.00115,74558,74749,191
100,17,array,128,298.470616666667,370.71115,74749,74939,190
100,17,array,128,329.9221,371.3765,74939,75127,188
100,0,blank,0,363.60355,377.332883333333,75127,75317,190
100,17,j,133,386.60765,374.5016,75317,75507,190
100,0,blank,0,409.164466666667,393.19855,75507,75699,192
100,0,blank,0,424.18545,389.954883333333,75699,75888,189
100,0,blank,0,372.234716666667,366.5549,75888,76077,189
100,15,++,119,325.64575,326.551633333333,76077,76265,188
100,15,n,117,289.088933333333,327.339833333333,76265,76452,187
100,0,blank,0,256.00945,298.45385,76452,76643,191
100,0,blank,0,267.108516666667,278.32635,76643,76834,191
100,0,blank,0,247.5855,293.77718,76834,76993,159
100,0,blank,0,-323,-105,77025,77183,158
100,0,blank,0,-323,-105,77183,77250,67
100,0,blank,0,304.481066666667,341.1355,77293,77471,178
100,0,blank,0,355.582733333333,380.55995,77471,77663,192
100,17,],134,396.37206,370.45412,77663,77822,159
100,17,comma,126,264.726066666667,357.914433333333,77855,78043,188
100,0,blank,0,255.62075,319.4851,78043,78231,188
100,0,blank,0,235.024983333333,311.220933333333,78231,78420,189
100,13,i,106,211.655516666667,281.76485,78420,78612,192
100,13,;,104,185.130783333333,273.965266666667,78612,78806,194
100,13,0,99,179.256616666667,279.039866666667,78806,79000,194
100,15,j,120,247.518616666667,317.492733333333,79000,79194,194
100,13,i,106,204.059683333333,277.302266666667,79194,79389,195
100,13,i,106,211.707666666667,283.033,79389,79487,98
100,0,blank,0,-323,-105,79520,79681,161
100,0,blank,0,-323,-105,79681,79721,40
100,12,(,91,149.67175,265.36955,79747,79794,47
100,0,blank,0,-323,-105,79893,80084,191
100,0,blank,0,-323,-105,80084,80260,176
100,0,blank,0,-323,-105,80260,80444,184
100,0,blank,0,-323,-105,80444,80568,124
100,0,blank,0,202.433916666667,267.310383333333,80606,80779,173
100,12,"Entertheco-efficientofthematrix\n",92,224.08205,263.8283,80779,80967,188
100,0,blank,0,233.500233333333,274.509483333333,80967,81158,191
100,0,blank,0,234.249233333333,271.031583333333,81158,81347,189
100,0,blank,0,263.486266666667,309.93475,81347,81538,191
100,0,blank,0,336.29875,348.432833333333,81538,81728,190
100,17,],134,367.5716,361.508966666667,81728,81825,97
100,0,blank,0,-323,-105,81926,82094,168
100,0,blank,0,-323,-105,82094,82266,172
100,0,blank,0,-323,-105,82266,82396,130
100,21,0,148,179.5839,443.0045,82439,82474,35
100,0,blank,0,195.095516666667,336.123,82499,82688,189
100,0,blank,0,202.21245,292.0416,82688,82877,189
100,13,;,104,190.397083333333,272.939033333333,82877,83068,191
100,12,"Entertheco-efficientofthematrix\n",92,175.18225,259.0867,83068,83133,65
100,0,blank,0,-323,-105,83199,83384,185
100,0,blank,0,-323,-105,83384,83426,42
100,12,"Entertheco-efficientofthematrix\n",92,193.531733333333,262.57835,83467,83652,185
100,13,i,106,213.8047,269.316366666667,83652,83851,199
100,0,blank,0,234.24115,277.736533333333,83851,84043,192
100,0,blank,0,219.530066666667,274.038383333333,84043,84239,196
100,0,blank,0,222.171716666667,280.8179,84239,84434,195
100,13,<,102,230.545333333333,276.816266666667,84434,84625,191
100,12,"Entertheco-efficientofthematrix\n",92,215.9775,252.6907,84625,84657,32
100,0,blank,0,-323,-105,84722,84903,181
100,0,blank,0,265.670766666667,271.676433333333,84935,85123,188
100,13,<,102,226.96956,286.11602,85123,85291,168
100,13,<,102,224.36682,274.29614,85291,85463,172
100,0,blank,0,216.0073,279.0062,85463,85498,35
100,0,blank,0,-323,-105,85568,85751,183
100,0,blank,0,-323,-105,85751,85833,82
100,0,blank,0,226.69355,295.534983333333,85868,86054,186
100,0,blank,0,221.25438,302.76526,86054,86224,170
100,0,blank,0,204.04728,293.95536,86224,86402,178
100,0,blank,0,191.9018,296.57472,86402,86578,176
100,0,blank,0,189.02958,293.13178,86578,86754,176
100,0,blank,0,187.93478,288.80524,86754,86929,175
100,13,;,104,187.19946,287.69004,86929,87103,174
100,0,blank,0,217.0944,278.32692,87103,87277,174
100,0,blank,0,229.50398,308.24916,87277,87449,172
100,0,blank,0,232.94378,320.77584,87449,87620,171
100,0,blank,0,232.78146,324.3031,87620,87790,170
100,15,j,120,243.62088,322.4689,87790,87960,170
100,0,blank,0,282.58788,313.3713,87960,88130,170
100,0,blank,0,280.09334,315.94136,88130,88305,175
100,15,++,119,332.18522,318.96884,88305,88475,170
100,0,blank,0,358.07278,326.84336,88475,88641,166
100,15,++,119,329.744416666667,320.951616666667,88641,88840,199
100,0,blank,0,261.353416666667,325.505466666667,88840,89034,194
100,0,blank,0,276.91066,337.49386,89034,89198,164
100,0,blank,0,302.8261,335.037283333333,89198,89397,199
100,0,blank,0,303.046325,334.6165,89397,89527,130
100,0,blank,0,-323,-105,89559,89725,166
100,0,blank,0,-323,-105,89725,89768,43
100,0,blank,0,270.6392,289.84005,89799,89979,180
100,0,blank,0,282.4467,322.615866666667,89979,90173,194
100,0,blank,0,294.95032,335.42438,90173,90334,161
100,0,blank,0,-323,-105,90433,90586,153
100,0,blank,0,-323,-105,90586,90701,115
100,0,blank,0,-323,-105,90701,90883,182
100,0,blank,0,-323,-105,90883,91072,189
100,0,blank,0,-323,-105,91072,91216,144
100,0,blank,0,-323,-105,91216,91381,165
100,0,blank,0,-323,-105,91381,91547,166
100,0,blank,0,-323,-105,91547,91729,182
100,0,blank,0,-323,-105,91729,91864,135
100,0,blank,0,-323,-105,91864,92093,229
100,0,blank,0,-323,-105,92093,92250,157
100,0,blank,0,-323,-105,92250,92432,182
100,0,blank,0,-323,-105,92432,92510,78
100,0,blank,0,-323,-105,92510,92661,151
100,0,blank,0,-323,-105,92661,92859,198
100,0,blank,0,-323,-105,92859,92973,114
100,0,blank,0,-323,-105,92973,93166,193
100,13,i,106,204.182225,268.32795,93182,93350,168
100,0,blank,0,280.795383333333,317.044966666667,93350,93539,189
100,0,blank,0,-323,-105,93602,93785,183
100,0,blank,0,-323,-105,93785,93947,162
100,0,blank,0,-323,-105,93947,94081,134
100,0,blank,0,-323,-105,94081,94261,180
100,0,blank,0,-323,-105,94261,94442,181
100,0,blank,0,-323,-105,94442,94557,115
100,0,blank,0,-323,-105,94557,94986,429
100,0,blank,0,199.91244,339.8236,95045,95237,192
100,15,j,120,176.614533333333,331.134116666667,95237,95428,191
100,0,blank,0,168.941216666667,337.185766666667,95428,95617,189
100,0,blank,0,178.9654,335.8156,95617,95812,195
100,0,blank,0,190.53635,350.4237,95812,95944,132
100,0,blank,0,-323,-105,96006,96139,133
100,0,blank,0,186.6885,336.6487,96172,96217,45
100,0,blank,0,192.52905,330.586616666667,96297,96487,190
100,0,blank,0,208.5485,332.765666666667,96487,96684,197
100,0,blank,0,205.8428,330.790733333333,96684,96789,105
100,0,blank,0,-323,-105,96859,96966,107
100,17,scanf,123,184.7635,366.397,96994,97032,38
100,0,blank,0,188.620483333333,327.1936,97100,97283,183
100,0,blank,0,210.174116666667,332.941683333333,97283,97478,195
100,0,blank,0,204.49795,340.09585,97478,97670,192
100,0,blank,0,178.6983,349.3492,97670,97867,197
100,0,blank,0,206.26655,382.3627,97867,98057,190
100,0,blank,0,275.252816666667,377.607833333333,98057,98254,197
100,0,blank,0,301.048616666667,384.1851,98254,98444,190
100,0,blank,0,220.741283333333,378.534816666667,98444,98639,195
100,0,blank,0,-323,-105,98734,98878,144
100,0,blank,0,-323,-105,98878,99027,149
100,17,scanf,123,174.395183333333,374.7348,99225,99405,180
100,0,blank,0,174.51555,338.961166666667,99405,99601,196
100,0,blank,0,166.89362,340.67908,99601,99769,168
100,0,blank,0,191.88516,353.39582,99769,99938,169
100,0,blank,0,195.552333333333,348.032016666667,99938,100137,199
100,17,(,124,217.628783333333,356.04265,100137,100333,196
100,0,blank,0,211.2866,348.87385,100333,100530,197
100,15,(,110,170.3739,330.024716666667,100530,100727,197
100,13,=,98,153.42656,284.51522,100727,100896,169
100,0,blank,0,162.02824,294.66484,100896,101063,167
100,15,=,112,196.7687,325.332133333333,101063,101161,98
100,0,blank,0,-323,-105,101199,101377,178
100,0,blank,0,186.42315,337.379583333333,101407,101588,181
100,0,blank,0,189.56096,318.86098,101588,101758,170
100,15,=,112,196.362833333333,319.010283333333,101758,101957,199
100,0,blank,0,204.816516666667,319.246333333333,101957,102154,197
100,15,j,120,179.0513,320.455466666667,102154,102348,194
100,0,blank,0,161.553466666667,321.30225,102348,102540,192
100,0,blank,0,183.056366666667,324.5714,102540,102735,195
100,15,=,112,200.908766666667,325.717683333333,102735,102933,198
100,15,=,112,201.908616666667,323.0475,102933,103130,197
100,15,=,112,200.998516666667,315.118883333333,103130,103324,194
100,0,blank,0,159.4079,378.5315,103324,103358,34
100,0,blank,0,193.1544,334.1692,103429,103626,197
100,0,blank,0,174.928133333333,348.86355,103626,103820,194
100,0,blank,0,195.05435,348.688366666667,103820,104018,198
100,17,"%d",125,255.67445,357.4716,104018,104086,68
100,0,blank,0,277.017775,366.03465,104156,104330,174
100,17,"%d",125,247.3895,371.57522,104330,104497,167
100,0,blank,0,291.7998,376.628183333333,104497,104696,199
100,17,array,128,326.58805,367.0705,104696,104763,67
100,0,blank,0,-323,-105,104879,105062,183
100,0,blank,0,-323,-105,105062,105257,195
100,0,blank,0,247.746483333333,387.25405,105282,105465,183
100,0,blank,0,263.154066666667,388.438766666667,105465,105664,199
100,0,blank,0,287.1547,349.1842,105664,105697,33
100,0,blank,0,146.78086,397.23298,105731,105900,169
100,0,blank,0,165.9548,377.88512,105900,106068,168
100,0,blank,0,204.1337,384.262,106068,106266,198
100,17,"%d",125,245.684266666667,374.23605,106266,106464,198
100,0,blank,0,253.787733333333,385.826716666667,106464,106659,195
100,0,blank,0,239.1051,377.615333333333,106659,106852,193
100,0,blank,0,203.168416666667,376.09375,106852,107046,194
100,17,(,124,219.302283333333,373.937933333333,107046,107237,191
100,0,blank,0,274.723133333333,368.645833333333,107237,107427,190
100,17,comma,126,264.1263,365.290566666667,107427,107617,190
100,0,blank,0,247.874,378.30695,107617,107807,190
100,17,"%d",125,247.3163,374.711316666667,107807,107996,189
100,0,blank,0,261.141516666667,378.9456,107996,108186,190
100,0,blank,0,288.347166666667,383.2011,108186,108375,189
100,0,blank,0,313.73215,377.945183333333,108375,108565,190
100,0,blank,0,280.951416666667,375.689383333333,108565,108758,193
100,17,"%d",125,261.7977,375.4394,108758,108949,191
100,0,blank,0,264.7701,378.911716666667,108949,109140,191
100,0,blank,0,299.42895,376.947766666667,109140,109332,192
100,0,blank,0,306.482333333333,379.736666666667,109332,109427,95
100,0,blank,0,-323,-105,109459,109599,140
100,17,array,128,311.355766666667,372.053733333333,109729,109908,179
100,17,array,128,315.906383333333,366.2433,109908,110099,191
100,17,array,128,335.759866666667,367.217966666667,110099,110288,189
100,17,array,128,325.641583333333,369.721416666667,110288,110474,186
100,17,array,128,321.3163,362.855583333333,110474,110659,185
100,17,array,128,313.8363,368.252616666667,110659,110845,186
100,17,i,130,357.972583333333,368.891916666667,110845,111032,187
100,17,array,128,341.016933333333,371.33945,111032,111220,188
100,0,blank,0,174.725133333333,385.40805,111251,111441,190
100,17,scanf,123,198.7667,366.1375,111441,111472,31
100,17,i,130,363.507816666667,375.184,111504,111692,188
100,0,blank,0,364.313283333333,381.0193,111692,111881,189
100,0,blank,0,368.61425,379.61535,111881,112068,187
100,17,[,132,382.32905,360.0892,112068,112131,63
100,0,blank,0,200.116216666667,378.364233333333,112161,112349,188
100,0,blank,0,202.6852,386.05465,112349,112411,62
100,0,blank,0,344.9028,381.418083333333,112442,112630,188
100,0,blank,0,364.069233333333,376.601366666667,112630,112818,188
100,0,blank,0,364.0058,379.130125,112818,112943,125
100,17,scanf,123,174.149583333333,370.581933333333,112973,113160,187
100,17,&,127,285.441466666667,370.36805,113160,113345,185
100,17,],134,366.308225,369.138075,113345,113468,123
100,17,scanf,123,187.36415,361.049133333333,113499,113685,186
100,0,blank,0,135.695066666667,374.5657,113685,113872,187
100,0,blank,0,110.02205,383.856,113872,114060,188
100,0,blank,0,93.0698,371.666833333333,114060,114251,191
100,0,blank,0,81.3466666666667,396.147466666667,114251,114440,189
100,0,blank,0,73.04915,429.554133333333,114440,114626,186
100,0,blank,0,71.1312833333333,436.053183333333,114626,114812,186
100,0,blank,0,81.33125,450.919225,114812,114976,164
100,0,blank,0,96.3913,402.1933,114976,115091,115
100,14,{,108,89.9084,299.9911,115091,115284,193
100,0,blank,0,305.585766666667,322.279116666667,115351,115535,184
100,15,;,118,301.3751,315.021666666667,115535,115629,94
100,0,blank,0,99.89745,355.243516666667,115660,115846,186
100,0,blank,0,95.8781833333333,358.734616666667,115846,116034,188
100,0,blank,0,99.9277833333333,342.359966666667,116034,116223,189
100,0,blank,0,118.494316666667,342.152683333333,116223,116414,191
100,0,blank,0,117.810716666667,382.174266666667,116414,116603,189
100,0,blank,0,86.2939333333333,420.875383333333,116603,116794,191
100,20,printf,139,90.4785166666667,439.39175,116794,116984,190
100,20,printf,139,133.777366666667,438.355416666667,116984,117175,191
100,20,printf,139,123.213216666667,439.940966666667,117175,117366,191
100,21,0,148,178.357416666667,452.79065,117366,117555,189
100,20,"Thegivenmatrixis\n",141,232.935416666667,441.720083333333,117555,117743,188
100,0,blank,0,292.171566666667,442.274383333333,117743,117931,188
100,20,"Thegivenmatrixis\n",141,289.207,437.75055,117931,117994,63
100,21,for,144,92.4351833333333,459.90055,118025,118213,188
100,0,blank,0,146.302083333333,460.097483333333,118213,118401,188
100,21,(,145,126.314966666667,459.836316666667,118401,118591,190
100,21,for,144,113.14915,458.2336,118591,118781,190
100,21,i,155,138.122683333333,457.812383333333,118781,118973,192
100,21,m,152,249.557866666667,458.61395,118973,119163,190
100,21,i,155,143.803483333333,452.85825,119163,119352,189
100,0,blank,0,144.198683333333,460.968533333333,119352,119540,188
100,0,blank,0,176.95415,464.99255,119540,119731,191
100,0,blank,0,195.072633333333,463.7954,119731,119921,190
100,0,blank,0,215.713,464.113533333333,119921,120111,190
100,21,m,152,243.993316666667,463.760066666667,120111,120300,189
100,21,m,152,253.922283333333,461.160533333333,120300,120489,189
100,0,blank,0,248.009733333333,465.588733333333,120489,120681,192
100,0,blank,0,235.261666666667,462.728766666667,120681,120872,191
100,0,blank,0,247.476075,466.256425,120872,121000,128
100,0,blank,0,245.091833333333,344.22185,121032,121223,191
100,0,blank,0,260.597116666667,319.844016666667,121223,121416,193
100,13,m,103,253.8825,287.0895,121416,121607,191
100,13,m,103,248.96905,283.027533333333,121607,121797,190
100,0,blank,0,243.830133333333,292.628983333333,121797,121986,189
100,13,<,102,228.963116666667,285.177483333333,121986,122174,188
100,0,blank,0,195.0029,288.7818,122174,122362,188
100,0,blank,0,164.657933333333,280.3983,122362,122549,187
100,13,(,96,128.661316666667,277.661466666667,122549,122739,190
100,0,blank,0,172.361333333333,277.583383333333,122739,122930,191
100,0,blank,0,235.049,278.123733333333,122930,123120,190
100,0,blank,0,204.0445,288.8266,123120,123278,158
100,0,blank,0,77.0394,-103.8132,123367,123393,26
100,0,blank,0,237.057683333333,280.492883333333,123417,123601,184
100,13,i,106,136.000216666667,271.487466666667,123632,123823,191
100,13,i,106,135.43285,284.534333333333,123823,124013,190
100,13,0,99,173.90416,282.29556,124013,124171,158
100,0,blank,0,-323,-105,124203,124370,167
100,0,blank,0,-323,-105,124370,124407,37
100,13,m,103,245.50075,275.200283333333,124441,124618,177
100,12,"Entertheco-efficientofthematrix\n",92,260.5011,260.3259,124618,124771,153
100,13,;,104,256.901066666667,286.3839,124771,124970,199
100,0,blank,0,260.75806,294.54126,124970,125137,167
100,0,blank,0,255.827375,291.9791,125137,125307,170
100,0,blank,0,267.2126,269.61705,125307,125490,183
100,0,blank,0,263.7352,278.8949,125490,125515,25
100,0,blank,0,266.8706,283.9493,125515,125705,190
100,12,"Entertheco-efficientofthematrix\n",92,274.498333333333,260.732766666667,125705,125888,183
100,0,blank,0,247.089733333333,291.1612,125888,126070,182
100,0,blank,0,181.767166666667,291.533916666667,126070,126255,185
100,0,blank,0,126.462766666667,266.049516666667,126255,126453,198
100,0,blank,0,-323,-105,126519,126580,61
100,0,blank,0,131.092416666667,301.372116666667,126722,126914,192
100,13,(,96,127.57512,287.837,126914,127081,167
100,0,blank,0,115.9029,286.246966666667,127081,127278,197
100,12,(,91,152.827983333333,265.41115,127278,127474,196
100,0,blank,0,134.588116666667,291.592083333333,127474,127667,193
100,0,blank,0,146.864933333333,283.731366666667,127667,127863,196
100,13,=,98,153.51944,284.52322,127863,128031,168
100,0,blank,0,153.83725,261.7123,128031,128097,66
100,0,blank,0,152.501216666667,286.59655,128128,128326,198
100,13,=,98,159.662,287.584433333333,128326,128522,196
100,0,blank,0,159.033083333333,288.468116666667,128522,128714,192
100,0,blank,0,194.065633333333,296.966066666667,128714,128910,196
100,0,blank,0,209.962633333333,296.68635,128910,129101,191
100,13,<,102,224.65735,286.56795,129101,129294,193
100,0,blank,0,198.923883333333,292.160416666667,129294,129485,191
100,0,blank,0,181.655583333333,297.2143,129485,129678,193
100,13,<,102,223.939116666667,285.819683333333,129678,129870,192
100,13,;,104,261.729883333333,279.926216666667,129870,130060,190
100,0,blank,0,249.6702,290.8622,130060,130157,97
100,0,blank,0,-323,-105,130188,130297,109
100,0,blank,0,215.721466666667,286.470633333333,130452,130634,182
100,0,blank,0,178.62225,289.985416666667,130634,130828,194
100,0,blank,0,240.23425,293.88255,130828,131022,194
100,0,blank,0,246.92425,298.50305,131022,131210,188
100,0,blank,0,251.476333333333,289.642116666667,131210,131396,186
100,0,blank,0,267.714866666667,275.348216666667,131396,131584,188
100,0,blank,0,265.475866666667,285.281583333333,131584,131774,190
100,13,;,104,258.33532,286.9354,131774,131930,156
100,0,blank,0,-323,-105,131993,132147,154
100,13,<,102,229.4702,285.408,132190,132244,54
100,13,m,103,250.854483333333,279.442533333333,132311,132495,184
100,13,m,103,247.026633333333,284.02165,132495,132690,195
100,0,blank,0,235.2481,286.87635,132690,132883,193
100,0,blank,0,126.7714,297.69735,132883,133075,192
100,0,blank,0,124.2328,284.5127,133075,133269,194
100,0,blank,0,225.52704,294.72578,133269,133435,166
100,0,blank,0,223.774,290.428966666667,133435,133632,197
100,13,=,98,163.89645,277.785566666667,133632,133827,195
100,13,(,96,131.4592,283.6636,133827,133999,172
100,0,blank,0,117.47946,273.94872,133999,134169,170
100,0,blank,0,124.4612,269.78458,134169,134333,164
100,13,;,104,187.90182,281.1435,134333,134503,170
100,13,=,98,158.3455,268.50624,134503,134674,171
100,0,blank,0,158.763966666667,266.420983333333,134674,134868,194
100,0,blank,0,144.5232,276.203483333333,134868,135065,197
100,0,blank,0,147.3295,304.133866666667,135065,135260,195
100,15,=,112,201.8545,321.20705,135260,135385,125
100,0,blank,0,192.8419,337.6122,135385,135493,108
100,0,blank,0,187.9443,322.868,135493,135614,121
100,15,j,120,177.21035,321.5835,135614,135801,187
100,0,blank,0,211.9103,331.25825,135801,135998,197
100,0,blank,0,223.662183333333,332.60105,135998,136195,197
100,15,<,116,265.242833333333,331.969033333333,136195,136388,193
100,0,blank,0,232.319966666667,347.96275,136388,136583,195
100,17,scanf,123,174.3844,373.5933,136583,136750,167
100,0,blank,0,220.57038,377.34072,136750,136917,167
100,12,printf,90,123.4429,261.73335,136949,137147,198
100,10,==,86,112.079566666667,218.781733333333,137147,137342,195
100,10,==,86,119.175033333333,211.41005,137342,137536,194
100,9,"%d%d",74,124.6072,191.712783333333,137536,137729,193
100,0,blank,0,150.635116666667,271.8079,137729,137918,189
100,0,blank,0,152.91075,290.546183333333,137918,138109,191
100,13,i,106,137.861316666667,282.195016666667,138109,138303,194
100,13,=,98,154.397833333333,286.554533333333,138303,138500,197
100,0,blank,0,143.759066666667,290.260133333333,138500,138698,198
100,0,blank,0,143.08525,291.12035,138698,138764,66
100,9,(,73,100.0608,192.328716666667,138796,138992,196
100,10,m,85,94.5329666666667,204.38655,138992,139187,195
100,10,m,85,88.8434833333333,215.113666666667,139187,139378,191
100,10,m,85,86.9887166666667,208.4615,139378,139571,193
100,9,"%d%d",74,139.366066666667,191.441833333333,139571,139768,197
100,0,blank,0,188.479866666667,202.594266666667,139768,139865,97
100,0,blank,0,185.634433333333,350.045566666667,139897,140092,195
100,15,for,109,138.8349,311.60336,140092,140262,170
100,0,blank,0,163.255633333333,300.0061,140262,140455,193
100,0,blank,0,216.7402,294.263,140455,140648,193
100,0,blank,0,206.84155,289.72715,140648,140840,192
100,0,blank,0,193.338983333333,294.720716666667,140840,141032,192
100,0,blank,0,191.3944,304.10625,141032,141096,64
100,0,blank,0,-323,-105,141163,141287,124
100,0,blank,0,236.552783333333,286.506783333333,141335,141524,189
100,0,blank,0,205.46575,292.551716666667,141524,141715,191
100,0,blank,0,107.16075,292.221966666667,141715,141907,192
100,13,i,106,136.9692,284.485483333333,141907,142098,191
100,0,blank,0,185.519383333333,288.9321,142098,142288,190
100,13,m,103,243.488183333333,283.118066666667,142288,142477,189
100,13,(,96,125.2787,281.702233333333,142477,142672,195
100,0,blank,0,120.776933333333,279.235683333333,142672,142862,190
100,0,blank,0,118.7157,285.2275,142862,142959,97
100,13,<,102,228.336375,283.705375,142991,143119,128
100,0,blank,0,-323,-105,143184,143316,132
100,13,m,103,244.6615,285.8927,143372,143441,69
100,0,blank,0,247.841233333333,288.686083333333,143511,143692,181
100,0,blank,0,253.433433333333,300.749983333333,143692,143883,191
100,0,blank,0,270.947466666667,332.7207,143883,144071,188
100,0,blank,0,278.247133333333,333.75145,144071,144259,188
100,0,blank,0,292.1841,338.7625,144259,144290,31
100,0,blank,0,282.348483333333,476.025366666667,144322,144512,190
100,0,blank,0,281.738316666667,393.423333333333,144512,144703,191
100,0,blank,0,294.827166666667,334.870583333333,144703,144895,192
100,0,blank,0,298.717466666667,333.53705,144895,145086,191
100,0,blank,0,249.569566666667,294.358866666667,145086,145278,192
100,0,blank,0,240.1331,289.3993,145278,145309,31
100,0,blank,0,255.167683333333,397.055516666667,145340,145531,191
100,0,blank,0,122.212383333333,442.111833333333,145531,145722,191
100,21,for,144,102.613083333333,444.899233333333,145722,145917,195
100,0,blank,0,147.270716666667,449.5562,145917,146110,193
100,0,blank,0,217.2303,453.14285,146110,146301,191
100,21,++,154,282.284066666667,450.142016666667,146301,146489,188
100,20,"Thegivenmatrixis\n",141,325.619883333333,439.685733333333,146489,146679,190
100,21,),156,308.579166666667,445.0664,146679,146868,189
100,0,blank,0,310.548883333333,442.793466666667,146868,147059,191
100,20,"Thegivenmatrixis\n",141,338.5109,437.02535,147059,147249,190
100,0,blank,0,351.0978,443.55765,147249,147313,64
100,0,blank,0,119.35295,463.831616666667,147345,147538,193
100,21,for,144,85.5645166666667,458.5737,147538,147731,193
100,21,i,155,141.975283333333,459.99985,147731,147928,197
100,0,blank,0,118.990283333333,467.962433333333,147928,148124,196
100,0,blank,0,148.521416666667,471.803133333333,148124,148317,193
100,0,blank,0,168.9645,476.8016,148317,148509,192
100,0,blank,0,206.826766666667,480.782133333333,148509,148697,188
100,0,blank,0,235.921366666667,472.60395,148697,148885,188
100,0,blank,0,249.676133333333,478.3061,148885,149074,189
100,0,blank,0,254.4716,470.235633333333,149074,149263,189
100,0,blank,0,256.194466666667,476.7839,149263,149452,189
100,0,blank,0,279.18195,508.911516666667,149452,149641,189
100,0,blank,0,281.279983333333,520.178966666667,149641,149830,189
100,0,blank,0,293.3315,525.118425,149830,149956,126
100,0,blank,0,147.158733333333,544.535283333333,149988,150179,191
100,0,blank,0,186.1936,559.996816666667,150179,150369,190
100,25,printf,172,183.54825,535.643116666667,150369,150557,188
100,0,blank,0,261.144916666667,570.724433333333,150557,150747,190
100,0,blank,0,296.2837,574.4102,150747,150939,192
100,0,blank,0,324.06065,573.918366666667,150939,151132,193
100,0,blank,0,223.655616666667,572.2425,151132,151322,190
100,27,"\n",188,225.238133333333,577.183316666667,151322,151510,188
100,0,blank,0,253.374483333333,561.220016666667,151510,151699,189
100,0,blank,0,235.36005,568.4646,151699,151886,187
100,0,blank,0,263.0403,568.936,151886,152076,190
100,0,blank,0,289.110066666667,564.158833333333,152076,152264,188
100,0,blank,0,329.523633333333,572.1618,152264,152455,191
100,0,blank,0,358.2114,561.754133333333,152455,152645,190
100,27,printf,186,160.146066666667,585.582666666667,152676,152868,192
100,0,blank,0,142.490166666667,600.037366666667,152868,153059,191
100,27,printf,186,128.758166666667,591.790983333333,153059,153248,189
100,0,blank,0,115.4376,563.05225,153248,153436,188
100,0,blank,0,120.55975,535.164233333333,153436,153627,191
100,0,blank,0,150.44345,525.3619,153627,153816,189
100,25,printf,172,167.96015,532.716266666667,153816,154007,191
100,0,blank,0,221.073516666667,563.526166666667,154007,154196,189
100,27,printf,186,179.1396,590.396316666667,154196,154387,191
100,0,blank,0,202.423716666667,596.064616666667,154387,154581,194
100,0,blank,0,200.06926,598.9224,154581,154750,169
100,0,blank,0,198.923433333333,608.81755,154750,154946,196
100,0,blank,0,116.41335,630.8809,154946,155139,193
100,29,for,192,85.2088,638.098183333333,155139,155329,190
100,29,for,192,99.7708666666667,638.7107,155329,155527,198
100,0,blank,0,142.52708,659.95552,155527,155712,185
100,0,blank,0,104.0721,616.534,155712,155835,123
100,29,for,192,108.5645,626.6323,155835,155927,92
100,29,for,192,100.3446,629.720866666667,155927,156120,193
100,30,{,205,91.2384,647.8351,156120,156153,33
100,0,blank,0,910.067833333333,405.8922,156218,156416,198
100,0,blank,0,931.925,375.4993,156416,156447,31
100,0,blank,0,921.835,326.3331,156447,156926,479
100,0,blank,0,933.256,324.131,156926,156966,40
100,0,blank,0,1014.3095,112.888366666667,156990,157182,192
100,0,blank,0,1039.78883333333,109.105266666667,157182,157376,194
100,0,blank,0,1050.7524,106.08668,157376,157544,168
100,0,blank,0,1059.1026,100.57974,157544,157712,168
100,0,blank,0,1052.359,119.28826,157712,157904,192
100,0,blank,0,1053.282,113.17286,157904,158070,166
101,0,blank,0,1050.62775,640.38775,158514,158649,135
101,0,blank,0,892.7844,416.57904,158683,158851,168
101,0,blank,0,292.41584,318.87238,158917,159085,168
101,0,blank,0,288.61708,315.84552,159085,159252,167
101,0,blank,0,284.608066666667,322.321316666667,159252,159450,198
101,0,blank,0,256.8007,506.6622,159483,159515,32
101,0,blank,0,-323,-105,159578,159684,106
101,0,blank,0,255.3248,326.649633333333,159832,160015,183
101,0,blank,0,245.275,320.520933333333,160015,160213,198
101,0,blank,0,217.241733333333,296.3762,160213,160412,199
101,21,i,155,204.15962,294.01112,160412,160584,172
101,20,"Thegivenmatrixis\n",141,157.96714,288.61756,160584,160757,173
101,20,"Thegivenmatrixis\n",141,177.596066666667,285.42885,160757,160954,197
101,20,"Thegivenmatrixis\n",141,179.83392,289.367,160954,161122,168
101,20,"Thegivenmatrixis\n",141,160.937375,275.772875,161122,161256,134
101,0,blank,0,-323,-105,161289,161482,193
101,20,"Thegivenmatrixis\n",141,186.178966666667,278.482383333333,161625,161804,179
101,20,"Thegivenmatrixis\n",141,177.946633333333,272.578533333333,161804,161996,192
101,20,"Thegivenmatrixis\n",141,193.386233333333,277.435583333333,161996,162187,191
101,0,blank,0,245.5213,255.04315,162187,162377,190
101,0,blank,0,251.645133333333,193.689,162377,162567,190
101,0,blank,0,318.97885,200.6373,162567,162757,190
101,17,],134,365.22162,217.55124,162757,162914,157
101,0,blank,0,173.86145,261.214383333333,162946,163135,189
101,0,blank,0,205.905383333333,268.494183333333,163135,163322,187
101,0,blank,0,202.3728,261.63325,163322,163509,187
101,0,blank,0,176.753733333333,265.751783333333,163509,163701,192
101,0,blank,0,232.7363,261.35835,163701,163893,192
101,20,"Thegivenmatrixis\n",141,314.855266666667,270.225883333333,163893,164084,191
101,20,"Thegivenmatrixis\n",141,340.3538,273.354633333333,164084,164272,188
101,20,"Thegivenmatrixis\n",141,339.462333333333,276.791316666667,164272,164460,188
101,20,"Thegivenmatrixis\n",141,278.290966666667,276.630683333333,164460,164647,187
101,0,blank,0,233.01005,297.2867,164647,164836,189
101,21,++,154,292.527666666667,296.671433333333,164836,165022,186
101,0,blank,0,305.515166666667,319.15465,165022,165211,189
101,23,j,169,337.7716,341.587566666667,165211,165400,189
101,0,blank,0,362.145766666667,351.15645,165400,165587,187
101,0,blank,0,373.824416666667,362.333716666667,165587,165775,188
101,25,"%d",174,241.996583333333,395.956633333333,165806,165994,188
101,25,"%d",174,249.138733333333,381.65325,165994,166182,188
101,25,comma,175,285.67635,387.217283333333,166182,166376,194
101,0,blank,0,319.619366666667,362.8045,166376,166471,95
101,25,(,173,227.551616666667,381.573183333333,166502,166690,188
101,25,(,173,232.387183333333,384.964616666667,166690,166878,188
101,25,"%d",174,259.800166666667,386.028583333333,166878,167069,191
101,25,"%d",174,259.23925,382.80435,167069,167259,190
101,25,"%d",174,261.66775,386.3402,167259,167449,190
101,0,blank,0,286.978483333333,371.077183333333,167449,167639,190
101,25,"%d",174,243.589316666667,388.243466666667,167639,167828,189
101,0,blank,0,218.98025,364.232516666667,167828,168017,189
101,0,blank,0,242.709233333333,377.66,168017,168206,189
101,25,"%d",174,251.36715,384.279583333333,168206,168394,188
101,25,"%d",174,269.948683333333,388.262,168394,168584,190
101,25,"%d",174,278.392733333333,392.132,168584,168771,187
101,0,blank,0,299.81045,398.89695,168771,168957,186
101,0,blank,0,306.958283333333,400.67635,168957,169144,187
101,0,blank,0,307.412316666667,409.64485,169144,169330,186
101,0,blank,0,317.39985,403.79105,169330,169515,185
101,0,blank,0,324.635383333333,403.675533333333,169515,169703,188
101,25,array,176,349.15005,393.4525,169703,169890,187
101,25,[,180,385.169966666667,391.9958,169952,170139,187
101,25,],182,409.377,390.00995,170139,170329,190
101,0,blank,0,436.26285,408.201283333333,170329,170515,186
101,0,blank,0,438.164833333333,409.891266666667,170515,170607,92
101,0,blank,0,279.778216666667,428.5017,170638,170825,187
101,27,;,190,248.82565,435.63415,170825,171012,187
101,27,"\n",188,203.9308,436.994183333333,171012,171197,185
101,0,blank,0,255.89416,444.41536,171197,171352,155
101,0,blank,0,148.449466666667,502.867283333333,171383,171571,188
101,0,blank,0,157.265533333333,504.444533333333,171571,171756,185
101,0,blank,0,158.52,490.044216666667,171756,171941,185
101,29,i,203,205.857366666667,484.774166666667,171941,172126,185
101,0,blank,0,196.028466666667,487.2983,172126,172311,185
101,0,blank,0,231.511416666667,490.95715,172311,172498,187
101,0,blank,0,275.143466666667,488.6376,172498,172686,188
101,0,blank,0,281.606716666667,493.972933333333,172686,172874,188
101,29,i,203,295.807433333333,485.09795,172874,173063,189
101,29,++,202,290.748116666667,486.97405,173063,173250,187
101,0,blank,0,266.298233333333,479.1021,173250,173440,190
101,0,blank,0,240.634266666667,480.907066666667,173440,173628,188
101,0,blank,0,262.3923,489.567333333333,173628,173817,189
101,0,blank,0,266.8869,498.64315,173817,174007,190
101,0,blank,0,273.552783333333,488.553866666667,174007,174197,190
101,29,i,203,296.312016666667,473.186816666667,174197,174388,191
101,29,i,203,297.51696,481.28008,174388,174546,158
101,0,blank,0,256.0472,742.2644,174578,174640,62
101,0,blank,0,-323,-105,174698,174832,134
101,0,blank,0,-323,-105,174883,174942,59
101,0,blank,0,335.151416666667,469.357116666667,174976,175168,192
101,0,blank,0,328.77132,479.68982,175168,175345,177
101,0,blank,0,332.67834,493.13816,175345,175515,170
101,0,blank,0,340.899116666667,493.3007,175515,175709,194
101,0,blank,0,338.656083333333,495.198683333333,175709,175905,196
101,0,blank,0,342.94158,485.84522,175905,176094,189
101,0,blank,0,352.0325,473.1674,176094,176169,75
101,0,blank,0,354.6371,490.1381,176169,176297,128
101,0,blank,0,330.6356,476.95395,176297,176478,181
101,0,blank,0,332.0457,472.29434,176478,176650,172
101,0,blank,0,324.10384,480.33288,176650,176825,175
101,0,blank,0,325.34604,476.85478,176825,176999,174
101,0,blank,0,323.1053,471.1632,176999,177172,173
101,0,blank,0,325.69526,470.79962,177172,177346,174
101,0,blank,0,-323,-105,177415,177563,148
101,0,blank,0,324.85575,492.766616666667,177596,177786,190
101,0,blank,0,329.6592,473.9777,177786,177961,175
101,0,blank,0,328.6812,476.4968,177961,178134,173
101,0,blank,0,301.36696,499.22802,178134,178304,170
101,0,blank,0,293.93106,497.77254,178304,178468,164
101,0,blank,0,-323,-105,178536,178709,173
101,0,blank,0,-323,-105,178709,178749,40
101,29,),204,311.78762,482.17188,178785,178959,174
101,0,blank,0,316.9689,476.93426,178959,179127,168
101,0,blank,0,326.059416666667,498.3888,179127,179324,197
101,0,blank,0,319.46515,491.105066666667,179324,179518,194
101,0,blank,0,325.061183333333,492.658366666667,179518,179711,193
101,0,blank,0,320.45866,470.61372,179711,179878,167
101,0,blank,0,330.2538,478.750433333333,179878,179976,98
101,0,blank,0,-323,-105,180043,180210,167
101,0,blank,0,-323,-105,180210,180296,86
101,29,i,203,296.895625,468.22835,180332,180449,117
101,0,blank,0,182.78348,540.34006,180483,180651,168
101,31,+,209,229.49518,527.51652,180651,180822,171
101,0,blank,0,237.36474,518.49822,180822,180993,171
101,0,blank,0,213.28176,511.62044,180993,181163,170
101,31,array,210,280.49328,525.02014,181163,181336,173
101,31,+,209,232.18408,524.21298,181336,181508,172
101,0,blank,0,217.9618,525.662525,181508,181644,136
101,0,blank,0,-323,-105,181709,181874,165
101,0,blank,0,-323,-105,181874,181942,68
101,31,array,210,265.158483333333,517.4449,181980,182168,188
101,31,array,210,290.47874,513.18588,182168,182335,167
101,31,],216,315.45504,521.08808,182335,182505,170
101,31,],216,351.66605,531.762766666667,182505,182704,199
101,31,],216,349.922533333333,528.932216666667,182704,182900,196
101,0,blank,0,366.13668,520.369,182900,183066,166
101,0,blank,0,376.60685,525.89445,183066,183133,67
101,0,blank,0,-323,-105,183167,183331,164
101,31,],216,348.5269,517.552433333333,183421,183608,187
101,0,blank,0,352.91656,524.4559,183608,183779,171
101,0,blank,0,352.35208,531.8568,183779,183951,172
101,32,-,230,357.796375,534.4658,183951,184087,136
101,0,blank,0,-323,-105,184153,184341,188
101,0,blank,0,-323,-105,184341,184451,110
101,32,i,229,341.013783333333,534.81945,184484,184672,188
101,0,blank,0,344.37062,536.39294,184672,184840,168
101,31,],216,316.45094,531.68622,184840,185008,168
101,31,],216,348.475266666667,529.02295,185008,185206,198
101,32,i,229,342.60288,536.04778,185206,185374,168
101,0,blank,0,289.144916666667,502.092233333333,185374,185573,199
101,0,blank,0,236.66256,496.16762,185573,185743,170
101,0,blank,0,236.2298,494.13078,185743,185913,170
101,31,],216,319.8234,523.13222,185913,186081,168
101,31,],216,347.80718,526.3383,186081,186249,168
101,31,;,217,359.88282,521.46484,186249,186417,168
101,0,blank,0,349.134966666667,510.5186,186417,186519,102
101,0,blank,0,-323,-105,186587,186645,58
101,0,blank,0,362.35465,532.798583333333,186772,186958,186
101,31,;,217,358.62226,513.37786,186958,187127,169
101,0,blank,0,373.58585,520.6388,187127,187326,199
101,0,blank,0,373.81178,530.32754,187326,187493,167
101,0,blank,0,369.215866666667,521.3256,187493,187692,199
101,31,[,214,298.0353,521.97995,187692,187889,197
101,32,array,222,212.2975,545.830416666667,187889,188087,198
101,32,+,221,189.369883333333,547.698183333333,188087,188286,199
101,0,blank,0,202.40535,555.394766666667,188286,188482,196
101,32,array,222,225.6256,551.1103,188482,188679,197
101,32,i,229,271.471966666667,553.78455,188679,188874,195
101,32,[,226,262.2253,543.619,188874,188906,32
101,0,blank,0,253.988816666667,555.9814,188972,189171,199
101,0,blank,0,177.806866666667,556.088116666667,189171,189368,197
101,0,blank,0,199.0214,558.59225,189368,189433,65
101,32,+,221,190.136733333333,552.511516666667,189505,189703,198
101,0,blank,0,217.92116,516.60362,189703,189870,167
101,31,array,210,291.96578,530.17878,189870,190038,168
101,31,[,214,331.64818,521.17508,190038,190206,168
101,31,[,214,302.89648,525.90584,190206,190376,170
101,31,array,210,293.234016666667,523.8758,190376,190571,195
101,32,i,229,267.288883333333,536.48195,190571,190763,192
101,32,array,222,244.008266666667,547.057516666667,190763,190954,191
101,0,blank,0,228.298366666667,554.254066666667,190954,191147,193
101,32,array,222,237.2706,536.0414,191147,191343,196
101,0,blank,0,284.94735,551.184383333333,191343,191541,198
101,0,blank,0,308.631416666667,543.818783333333,191541,191736,195
101,0,blank,0,329.0231,555.871766666667,191736,191931,195
101,32,-,230,357.047583333333,551.908133333333,191931,192126,195
101,32,i,229,334.716833333333,544.062616666667,192126,192321,195
101,0,blank,0,282.550083333333,552.19165,192321,192515,194
101,32,array,222,233.959166666667,552.976183333333,192515,192707,192
101,0,blank,0,218.766616666667,526.884766666667,192707,192901,194
101,0,blank,0,221.619783333333,507.335683333333,192901,193095,194
101,0,blank,0,234.313,488.232033333333,193095,193288,193
101,0,blank,0,271.418033333333,491.483533333333,193288,193479,191
101,32,array,222,211.13215,536.426583333333,193479,193672,193
101,32,array,222,220.39735,548.917566666667,193672,193865,193
101,32,array,222,214.165933333333,538.827133333333,193865,194062,197
101,0,blank,0,202.68225,532.1113,194062,194129,67
101,0,blank,0,-323,-105,194195,194304,109
101,32,array,222,208.238416666667,536.37795,194446,194629,183
101,32,array,222,214.557433333333,542.96125,194629,194824,195
101,0,blank,0,197.8096,534.969383333333,194824,195015,191
101,0,blank,0,198.698,541.916316666667,195015,195205,190
101,32,array,222,203.04715,538.373733333333,195205,195395,190
101,32,array,222,205.330316666667,536.0473,195395,195585,190
101,32,array,222,245.999916666667,538.577766666667,195585,195772,187
101,31,array,210,277.2396,531.164366666667,195772,195960,188
101,0,blank,0,285.439033333333,533.370716666667,195960,196148,188
101,31,[,214,295.190083333333,521.49305,196148,196335,187
101,32,-,230,315.15896,545.76124,196335,196513,178
101,0,blank,0,345.3581,563.0383,196513,196696,183
101,0,blank,0,347.29525,539.8917,196696,196865,169
101,32,array,222,217.5239,534.9695,196900,197084,184
101,31,sum,208,198.034366666667,513.715333333333,197084,197269,185
101,0,blank,0,174.68185,510.304283333333,197269,197455,186
101,0,blank,0,162.5724,517.364866666667,197455,197643,188
101,31,sum,208,194.941616666667,526.443,197643,197831,188
101,0,blank,0,201.1745,533.8415,197831,198022,191
101,31,sum,208,191.78535,526.8917,198022,198085,63
101,0,blank,0,-323,-105,198148,198280,132
101,32,array,222,229.0673,545.7109,198393,198574,181
101,32,array,222,235.188983333333,544.095933333333,198574,198767,193
101,32,],232,279.740933333333,551.847066666667,198767,198957,190
101,0,blank,0,312.587066666667,554.976466666667,198957,199147,190
101,32,-,230,316.500583333333,545.10245,199147,199336,189
101,0,blank,0,305.3654,553.524933333333,199336,199526,190
101,32,[,226,289.9815,540.027416666667,199526,199716,190
101,32,[,226,289.26595,545.53975,199716,199908,192
101,32,m,227,298.2124,547.1591,199908,199939,31
101,0,blank,0,-323,-105,200004,200164,160
101,0,blank,0,229.2712,561.8311,200209,200265,56
101,0,blank,0,214.3035,519.1235,200334,200359,25
101,32,-,230,315.266,535.813733333333,200392,200586,194
101,0,blank,0,325.294916666667,545.705183333333,200586,200777,191
101,32,i,229,342.227766666667,552.102866666667,200777,200967,190
101,0,blank,0,367.618616666667,552.055366666667,200967,201156,189
101,0,blank,0,350.189933333333,553.063266666667,201156,201344,188
101,0,blank,0,331.024916666667,538.812866666667,201344,201533,189
101,0,blank,0,352.877266666667,554.209433333333,201533,201721,188
101,0,blank,0,372.913033333333,549.301966666667,201721,201906,185
101,31,],216,350.042116666667,530.735233333333,201906,202095,189
101,0,blank,0,330.459466666667,539.167333333333,202095,202285,190
101,0,blank,0,320.905166666667,500.942766666667,202285,202476,191
101,31,],216,344.014283333333,527.64925,202476,202670,194
101,0,blank,0,368.590816666667,491.5124,202670,202866,196
101,0,blank,0,386.40726,501.139,202866,203037,171
101,0,blank,0,392.465283333333,527.907833333333,203037,203235,198
101,0,blank,0,404.6658,412.89905,203235,203300,65
101,0,blank,0,390.836666666667,473.605416666667,203333,203529,196
101,0,blank,0,375.389983333333,531.01675,203529,203725,196
101,0,blank,0,346.03062,541.9747,203725,203889,164
101,0,blank,0,-321.86986,609.79592,203987,204152,165
101,0,blank,0,350.188216666667,558.372416666667,204218,204417,199
101,32,i,229,335.0695,536.8735,204417,204615,198
101,0,blank,0,352.246183333333,547.371783333333,204615,204811,196
101,0,blank,0,347.9661,560.328,204811,204844,33
101,0,blank,0,-323,-105,204911,205068,157
101,0,blank,0,357.3543,638.7906,205094,205120,26
101,0,blank,0,368.125566666667,546.781983333333,205174,205356,182
101,32,-,230,360.490833333333,539.57505,205356,205553,197
101,31,[,214,298.370816666667,520.36755,205553,205747,194
101,29,m,200,245.842516666667,486.83055,205747,205943,196
101,0,blank,0,221.244316666667,484.8081,205943,206139,196
101,0,blank,0,366.115283333333,540.70025,206173,206369,196
101,0,blank,0,351.52925,541.73415,206369,206500,131
101,0,blank,0,-323,-105,206532,206719,187
101,0,blank,0,-323,-105,206719,206915,196
101,32,array,222,246.2344,543.374533333333,206949,207147,198
101,32,array,222,211.753883333333,541.766333333333,207147,207340,193
101,32,array,222,227.5773,551.50455,207340,207533,193
101,35,"ThesumoftheOppositediagonalelemetsis=%d\n",244,176.692016666667,605.543033333333,207533,207725,192
101,34,"\nThesumofthemaindiagonalelementsis=%d\n",237,180.623566666667,585.336266666667,207725,207920,195
101,0,blank,0,195.5868,565.05685,207920,208113,193
101,34,"\nThesumofthemaindiagonalelementsis=%d\n",237,178.12,586.1827,208113,208307,194
101,35,"ThesumoftheOppositediagonalelemetsis=%d\n",244,188.9296,600.7543,208307,208341,34
101,35,"ThesumoftheOppositediagonalelemetsis=%d\n",244,277.620766666667,611.843066666667,208373,208569,196
101,35,"ThesumoftheOppositediagonalelemetsis=%d\n",244,245.68394,608.76316,208569,208730,161
101,35,"ThesumoftheOppositediagonalelemetsis=%d\n",244,342.0998,608.0187,208730,208794,64
101,34,"\nThesumofthemaindiagonalelementsis=%d\n",237,360.9964,578.8317,208794,209002,208
101,35,"ThesumoftheOppositediagonalelemetsis=%d\n",244,418.851416666667,599.52315,209002,209187,185
101,35,"ThesumoftheOppositediagonalelemetsis=%d\n",244,419.01295,611.66985,209187,209252,65
101,34,"\nThesumofthemaindiagonalelementsis=%d\n",237,574.001433333333,579.407666666667,209285,209481,196
101,34,"\nThesumofthemaindiagonalelementsis=%d\n",237,644.728166666667,596.0596,209481,209676,195
101,34,sum,239,710.953166666667,596.17475,209676,209872,196
101,34,sum,239,709.2104,586.6493,209872,210038,166
101,34,sum,239,697.3354,593.3252,210038,210206,168
101,0,blank,0,674.27822,590.24214,210206,210380,174
101,34,sum,239,689.54816,596.21336,210380,210546,166
101,35,"ThesumoftheOppositediagonalelemetsis=%d\n",244,700.864,599.068566666667,210546,210744,198
101,34,sum,239,695.265,594.74945,210744,210811,67
101,35,"ThesumoftheOppositediagonalelemetsis=%d\n",244,340.66874,602.7144,210878,211042,164
101,35,"ThesumoftheOppositediagonalelemetsis=%d\n",244,204.9899,608.508116666667,211075,211270,195
101,0,blank,0,153.002816666667,623.054383333333,211270,211466,196
101,35,"ThesumoftheOppositediagonalelemetsis=%d\n",244,196.5726,619.599,211466,211659,193
101,34,"\nThesumofthemaindiagonalelementsis=%d\n",237,182.918633333333,592.969116666667,211659,211850,191
101,0,blank,0,151.27705,559.324133333333,211850,212041,191
101,31,sum,208,145.4598,515.131683333333,212041,212229,188
101,29,0,196,182.6631,477.457283333333,212229,212416,187
101,0,blank,0,200.212733333333,458.36,212416,212508,92
101,20,"Thegivenmatrixis\n",141,160.83935,284.931216666667,212541,212729,188
101,0,blank,0,156.631466666667,389.659866666667,212729,212914,185
101,0,blank,0,152.433783333333,411.485533333333,212914,213100,186
101,0,blank,0,155.335566666667,451.823083333333,213100,213288,188
101,0,blank,0,151.23305,481.174683333333,213288,213474,186
101,32,=,219,145.899866666667,552.737633333333,213474,213663,189
101,34,printf,235,143.059866666667,597.71445,213663,213852,189
101,0,blank,0,137.891466666667,644.453183333333,213852,214043,191
101,0,blank,0,130.738333333333,655.336233333333,214043,214235,192
101,0,blank,0,144.96745,669.649583333333,214235,214429,194
101,0,blank,0,152.161516666667,663.677266666667,214429,214621,192
101,0,blank,0,170.646333333333,650.27665,214621,214812,191
101,0,blank,0,167.722383333333,636.745316666667,214812,215008,196
101,0,blank,0,193.41296,573.17634,215008,215168,160
101,38,(,252,150.114466666667,681.0551,215202,215395,193
101,0,blank,0,189.392066666667,693.719433333333,215395,215590,195
101,0,blank,0,262.1541,694.118633333333,215590,215785,195
101,38,"Thegivenorderisnotsquarematrix\n",253,267.1564,677.9103,215785,215817,32
101,0,blank,0,367.6476,688.207416666667,215850,216046,196
101,0,blank,0,367.4955,690.0901,216046,216078,32
101,0,blank,0,519.5972,625.941633333333,216348,216539,191
101,0,blank,0,193.333633333333,634.036933333333,216572,216768,196
101,35,"ThesumoftheOppositediagonalelemetsis=%d\n",244,186.66235,613.7218,216768,216834,66
101,0,blank,0,-323,-105,216884,217046,162
101,35,"ThesumoftheOppositediagonalelemetsis=%d\n",244,176.654933333333,617.2892,217320,217507,187
101,38,"Thegivenorderisnotsquarematrix\n",253,160.426333333333,665.934316666667,217507,217700,193
101,0,blank,0,224.947433333333,695.049483333333,217700,217890,190
101,0,blank,0,277.187983333333,690.456666666667,217890,218084,194
101,0,blank,0,328.65406,692.6682,218084,218247,163
101,0,blank,0,399.270166666667,686.497166666667,218247,218413,166
101,38,"Thegivenorderisnotsquarematrix\n",253,449.6419,670.8219,218413,218589,176
101,0,blank,0,480.6689,569.9446,218589,218623,34
101,0,blank,0,540.50595,661.9211,218658,218727,69
101,0,blank,0,567.9096,652.225,218727,218858,131
101,38,"Thegivenorderisnotsquarematrix\n",253,471.1562,674.786166666667,218858,219025,167
101,38,"Thegivenorderisnotsquarematrix\n",253,475.1396,685.17,219025,219452,427
101,0,blank,0,495.62985,658.025475,219452,219619,167
101,38,"Thegivenorderisnotsquarematrix\n",253,543.587433333333,667.448933333333,219619,219757,138
101,0,blank,0,562.9126,639.577,219757,219916,159
101,0,blank,0,580.0388,632.81965,219916,220048,132
101,0,blank,0,567.670833333333,655.924033333333,220113,220310,197
101,0,blank,0,549.77445,645.73845,220310,220491,181
101,0,blank,0,587.72974,643.34656,220491,220688,197
101,0,blank,0,589.793,628.0865,220688,220855,167
101,0,blank,0,587.4381,641.92825,220855,220922,67
101,0,blank,0,183.3584,624.84212,220988,221165,177
101,35,"ThesumoftheOppositediagonalelemetsis=%d\n",244,175.496783333333,616.42135,221165,221357,192
101,35,"ThesumoftheOppositediagonalelemetsis=%d\n",244,265.446,609.37805,221357,221547,190
101,34,"\nThesumofthemaindiagonalelementsis=%d\n",237,323.35015,597.726216666667,221547,221736,189
101,34,"\nThesumofthemaindiagonalelementsis=%d\n",237,413.098583333333,592.743166666667,221736,221923,187
101,34,"\nThesumofthemaindiagonalelementsis=%d\n",237,505.427233333333,584.6164,221923,222110,187
101,34,"\nThesumofthemaindiagonalelementsis=%d\n",237,600.181483333333,582.766766666667,222110,222298,188
101,34,"\nThesumofthemaindiagonalelementsis=%d\n",237,632.22235,579.6668,222298,222484,186
101,0,blank,0,651.6106,568.885025,222484,222608,124
101,0,blank,0,-323,-105,222672,222831,159
101,34,"\nThesumofthemaindiagonalelementsis=%d\n",237,606.5627,583.8159,222862,222902,40
101,0,blank,0,618.87725,576.397466666667,222968,223152,184
101,0,blank,0,627.247333333333,574.433666666667,223152,223351,199
101,0,blank,0,603.17105,574.58545,223351,223550,199
101,0,blank,0,571.139716666667,575.166783333333,223550,223744,194
101,0,blank,0,576.596083333333,560.293016666667,223744,223937,193
101,0,blank,0,611.937716666667,556.914983333333,223937,224129,192
101,0,blank,0,625.72354,566.23002,224129,224293,164
101,0,blank,0,-323,-105,224360,224519,159
101,0,blank,0,-323,-105,224519,224563,44
101,0,blank,0,632.87875,570.449066666667,224594,224791,197
101,0,blank,0,650.91385,573.705866666667,224791,224984,193
101,0,blank,0,661.667166666667,576.9415,224984,225176,192
101,0,blank,0,679.687583333333,577.407233333333,225176,225365,189
101,34,sum,239,710.734,585.208483333333,225365,225555,190
101,34,),240,720.006666666667,586.548983333333,225555,225747,192
101,0,blank,0,716.458166666667,605.5826,225747,225939,192
101,34,"\nThesumofthemaindiagonalelementsis=%d\n",237,660.4159,594.8992,225939,226005,66
101,34,"\nThesumofthemaindiagonalelementsis=%d\n",237,218.559183333333,591.904466666667,226036,226233,197
101,34,"\nThesumofthemaindiagonalelementsis=%d\n",237,225.6146,577.854416666667,226233,226427,194
101,31,array,210,244.1679,527.533366666667,226427,226620,193
101,32,array,222,206.80465,541.786633333333,226620,226814,194
101,32,array,222,217.433816666667,546.489333333333,226814,227005,191
101,0,blank,0,-323,-105,227037,227222,185
101,0,blank,0,-323,-105,227222,227333,111
101,0,blank,0,202.592966666667,551.271266666667,227364,227561,197
101,0,blank,0,230.729183333333,554.076266666667,227561,227755,194
101,32,array,222,240.993383333333,548.728816666667,227755,227946,191
101,32,array,222,226.564516666667,537.228066666667,227946,228137,191
101,32,array,222,214.841816666667,538.368783333333,228137,228328,191
101,0,blank,0,180.76745,536.7145,228328,228519,191
101,32,+,221,192.161383333333,552.34075,228519,228712,193
101,32,array,222,227.558933333333,553.453566666667,228712,228904,192
101,32,array,222,219.756033333333,552.432333333333,228904,228999,95
101,0,blank,0,-323,-105,229063,229195,132
101,0,blank,0,295.937916666667,576.693933333333,229331,229527,196
101,32,[,226,292.8806,538.30804,229527,229700,173
101,0,blank,0,326.08922,565.29648,229700,229870,170
101,0,blank,0,324.385733333333,548.66005,229870,230067,197
101,32,-,230,318.350016666667,548.496616666667,230067,230262,195
101,32,m,227,295.451433333333,542.889066666667,230262,230456,194
101,0,blank,0,308.178,647.3281,230456,230488,32
101,32,-,230,318.639816666667,545.205416666667,230520,230714,194
101,32,m,227,295.578883333333,544.717783333333,230714,230911,197
101,32,i,229,268.294166666667,549.139766666667,230911,231107,196
101,32,-,230,315.27222,542.32906,231107,231274,167
101,0,blank,0,316.09254,554.47988,231274,231437,163
101,0,blank,0,-323,-105,231504,231632,128
101,0,blank,0,376.6149,766.3704,231659,231684,25
101,0,blank,0,332.769266666667,542.487816666667,231743,231929,186
101,31,i,215,341.5118,531.353833333333,231929,232128,199
101,32,i,229,341.072133333333,542.5056,232128,232324,196
101,32,i,229,342.38055,548.602716666667,232324,232519,195
101,0,blank,0,344.594,556.4158,232519,232583,64
101,0,blank,0,-323,-105,232616,232806,190
101,32,i,229,336.442366666667,543.929033333333,232927,233113,186
101,32,i,229,337.44525,546.1461,233113,233312,199
101,0,blank,0,349.37775,546.182983333333,233312,233508,196
101,0,blank,0,346.9776,552.1509,233508,233702,194
101,0,blank,0,351.3893,555.212133333333,233702,233896,194
101,32,-,230,359.134,548.089683333333,233896,234091,195
101,0,blank,0,367.618366666667,546.663183333333,234091,234285,194
101,32,i,229,271.101166666667,540.32205,234285,234480,195
101,0,blank,0,305.162433333333,549.777866666667,234480,234676,196
101,0,blank,0,-323,-105,234708,234895,187
101,0,blank,0,-323,-105,234895,235035,140
101,0,blank,0,350.40716,557.68406,235068,235236,168
101,32,-,230,356.671783333333,541.20995,235236,235432,196
101,0,blank,0,351.4434,549.2752,235432,235627,195
101,0,blank,0,356.3237,563.9431,235627,235658,31
101,0,blank,0,-323,-105,235690,235855,165
101,0,blank,0,359.9351,651.5693,235882,235908,26
101,0,blank,0,343.5604,557.327133333333,235964,236141,177
101,0,blank,0,359.906,563.217083333333,236141,236337,196
101,0,blank,0,370.555933333333,555.086916666667,236337,236528,191
101,0,blank,0,378.2091,561.461333333333,236528,236719,191
101,0,blank,0,369.82715,550.905033333333,236719,236911,192
101,0,blank,0,366.568333333333,559.43465,236911,237104,193
101,0,blank,0,371.21818,552.10492,237104,237281,177
101,0,blank,0,395.87275,557.8233,237281,237458,177
101,32,;,233,394.98405,545.9314,237458,237657,199
101,32,],232,391.18622,542.55228,237657,237826,169
101,32,],232,385.948433333333,542.684033333333,237826,237923,97
101,0,blank,0,-323,-105,237956,238131,175
101,0,blank,0,367.0909,534.337266666667,238264,238449,185
101,0,blank,0,349.579633333333,535.075866666667,238449,238647,198
101,32,m,227,301.355016666667,548.963716666667,238647,238842,195
101,0,blank,0,344.53245,558.608883333333,238842,239035,193
101,0,blank,0,369.3449,552.337133333333,239035,239227,192
101,0,blank,0,372.1021,539.902083333333,239227,239424,197
101,0,blank,0,288.65325,567.533366666667,239424,239622,198
101,32,array,222,228.978,547.25105,239622,239690,68
101,0,blank,0,125.08194,689.4269,239794,239965,171
101,0,blank,0,99.9966833333333,693.33445,239965,240164,199
101,0,blank,0,64.6296333333333,700.997433333333,240164,240266,102
101,0,blank,0,808.1786,670.62054,240336,240513,177
101,0,blank,0,797.04475,717.1711,240513,240648,135
101,0,blank,0,1029.759,687.76984,240681,240848,167
101,0,blank,0,1013.55,703.9802,240848,240881,33
101,35,"ThesumoftheOppositediagonalelemetsis=%d\n",244,561.698933333333,601.573233333333,240915,241015,100
101,35,"ThesumoftheOppositediagonalelemetsis=%d\n",244,323.864033333333,609.515366666667,241048,241148,100
101,0,blank,0,-323,-105,241351,241544,193
101,0,blank,0,-323,-105,241544,241697,153
101,0,blank,0,-323,-105,241697,241746,49
101,0,blank,0,-323,-105,241887,241947,60
101,0,blank,0,471.793575,-103.964025,242009,242175,166
101,0,blank,0,478.66765,-103.9527,242175,242243,68
101,0,blank,0,470.6991,780.4269,242280,242456,176
101,0,blank,0,469.226575,777.00335,242456,242592,136
101,0,blank,0,545.2504,465.1171,242695,242730,35
