Frameno_fix,lineno_fix,Tokenname_fix,tokens_id,gaze_X_fix,gaze_Y_fix,timestamp_fix_start,timestamp_fix_end,time_duration
100,0,blank,0,146.49605,65.0743833333333,3474,3671,197
100,0,blank,0,190.022283333333,112.702,3671,3845,174
100,0,blank,0,181.5187,136.204483333333,3845,4019,174
100,0,blank,0,155.591666666667,89.0975,4019,4191,172
100,0,blank,0,212.86495,109.848716666667,4191,4367,176
100,0,blank,0,209.1571,134.407316666667,4367,4546,179
100,6,index,37,167.313466666667,122.332516666667,4546,4719,173
100,6,index,37,178.8271,124.03835,4719,4894,175
100,6,index,37,182.788716666667,120.802916666667,4894,5068,174
100,0,blank,0,201.45165,108.77685,5068,5243,175
100,0,blank,0,220.957983333333,113.497016666667,5243,5417,174
100,0,blank,0,227.816366666667,98.2035,5417,5505,88
100,1,list,12,469.729233333333,13.3731333333333,5535,5710,175
100,0,blank,0,476.73255,-26.9321333333333,5710,5885,175
100,0,blank,0,492.3404,-29.80905,5885,5943,58
100,0,blank,0,-323,-105,5972,6052,80
100,1,Program,4,114.986042857143,19.5086857142857,6126,6317,191
100,0,blank,0,118.047966666667,-11.8996666666667,6317,6495,178
100,0,blank,0,120.226125,-2.91665,6495,6614,119
100,0,blank,0,183.608866666667,338.6917,6644,6821,177
100,16,rand,96,187.037033333333,333.841033333333,6821,6910,89
100,0,blank,0,-323,-105,6969,6998,29
100,25,"\nTheelementisnotfound",157,192.05205,531.443866666667,7101,7264,163
100,0,blank,0,-323,-105,7324,7506,182
100,0,blank,0,-323,-105,7506,7696,190
100,0,blank,0,-323,-105,7696,7875,179
100,0,blank,0,-323,-105,7875,8054,179
100,0,blank,0,-323,-105,8054,8223,169
100,0,blank,0,-323,-105,8223,8405,182
100,0,blank,0,-323,-105,8405,8491,86
100,0,blank,0,-323,-105,8491,8692,201
100,0,blank,0,-323,-105,8692,8758,66
100,0,blank,0,-323,-105,8758,8995,237
100,0,blank,0,-323,-105,8995,9056,61
100,0,blank,0,-323,-105,9056,9237,181
100,0,blank,0,-323,-105,9237,9406,169
100,0,blank,0,-323,-105,9406,9600,194
100,0,blank,0,-323,-105,9600,9682,82
100,0,blank,0,183.129016666667,64.76005,9750,9942,192
100,0,blank,0,200.915166666667,64.7640333333333,9942,10033,91
100,4,(,31,90.9087,80.8306,10289,10415,126
100,0,blank,0,-323,-105,10447,10612,165
100,0,blank,0,-323,-105,10612,10652,40
100,4,main,30,62.8513166666667,88.8196,10687,10858,171
100,4,),32,99.1291333333333,79.2873,10858,11044,186
100,0,blank,0,147.326233333333,73.8190666666667,11044,11225,181
100,0,blank,0,123.757733333333,98.9661,11225,11406,181
100,0,blank,0,80.93195,112.650083333333,11406,11590,184
100,0,blank,0,86.5504833333333,113.274966666667,11590,11773,183
100,0,blank,0,109.91248,104.1354,11773,11953,180
100,0,blank,0,98.2990666666667,104.203466666667,11953,12147,194
100,0,blank,0,61.2042,97.2332,12147,12220,73
100,0,blank,0,86.7494,113.6675,12220,12392,172
100,0,blank,0,92.7298,113.071716666667,12392,12585,193
100,0,blank,0,118.144266666667,104.561783333333,12585,12770,185
100,0,blank,0,119.979283333333,109.284366666667,12770,12951,181
100,6,size,35,90.0036,127.324375,12951,13073,122
100,6,size,35,98.9933,128.117516666667,13211,13382,171
100,6,size,35,109.871283333333,116.856166666667,13382,13565,183
100,0,blank,0,143.398483333333,119.413766666667,13565,13749,184
100,6,index,37,144.869516666667,128.984583333333,13749,13933,184
100,6,index,37,144.450033333333,132.124466666667,13933,14122,189
100,0,blank,0,143.7819,120.0237,14122,14153,31
100,0,blank,0,-323,-105,14183,14264,81
100,6,comma,38,129.71465,127.830666666667,14375,14550,175
100,0,blank,0,139.089216666667,128.22105,14550,14734,184
100,7,list,42,103.611616666667,141.142333333333,14734,14921,187
100,8,int,47,73.3453833333333,168.880333333333,14921,15104,183
100,0,blank,0,74.9991833333333,166.5216,15104,15286,182
100,8,int,47,53.7584166666667,170.484733333333,15286,15469,183
100,0,blank,0,50.2690166666667,157.172283333333,15469,15650,181
100,8,int,47,47.8140666666667,166.7183,15650,15834,184
100,8,int,47,52.9246,167.7768,15834,15864,30
100,0,blank,0,-323,-105,15925,16032,107
100,17,printf,102,109.5608,366.29,16083,16131,48
100,7,int,41,53.0909857142857,152.121885714286,16196,16395,199
100,0,blank,0,76.5553833333333,161.660533333333,16395,16576,181
100,8,count,48,115.809683333333,171.364866666667,16576,16761,185
100,0,blank,0,140.100766666667,177.891766666667,16761,16939,178
100,0,blank,0,204.150416666667,170.322166666667,16939,17120,181
100,0,blank,0,244.184083333333,169.231583333333,17120,17303,183
100,0,blank,0,287.38305,166.757066666667,17303,17483,180
100,0,blank,0,305.307716666667,152.403216666667,17483,17664,181
100,0,blank,0,327.2599,155.304933333333,17664,17847,183
100,0,blank,0,321.4996,169.7939,17847,17878,31
100,0,blank,0,-323,-105,17908,18040,132
100,0,blank,0,259.683685714286,174.899971428571,18066,18257,191
100,0,blank,0,258.628016666667,175.240233333333,18257,18441,184
100,0,blank,0,287.1711,179.6331,18441,18623,182
100,0,blank,0,296.048633333333,184.087466666667,18623,18804,181
100,0,blank,0,294.34275,164.292183333333,18804,18987,183
100,0,blank,0,254.623683333333,162.198766666667,18987,19173,186
100,0,blank,0,306.8027,155.833433333333,19173,19359,186
100,0,blank,0,314.3052,158.063566666667,19359,19451,92
100,7,list,42,91.37495,144.641,19512,19696,184
100,8,count,48,93.2015166666667,164.099233333333,19696,19881,185
100,8,=,49,151.432133333333,167.80775,19881,20065,184
100,0,blank,0,185.3551,150.740716666667,20065,20248,183
100,0,blank,0,229.212016666667,158.619583333333,20248,20425,177
100,0,blank,0,274.1027,150.60325,20425,20607,182
100,0,blank,0,291.36565,162.210766666667,20607,20790,183
100,8,count,48,113.812066666667,159.8864,20820,21002,182
100,6,size,35,114.5895,128.9192,21002,21033,31
100,0,blank,0,-323,-105,21063,21196,133
100,0,blank,0,114.160757142857,157.8079,21326,21521,195
100,7,;,46,165.194866666667,141.434166666667,21521,21702,181
100,0,blank,0,207.260083333333,159.219433333333,21702,21884,182
100,0,blank,0,236.00845,172.706566666667,21884,22065,181
100,0,blank,0,267.52635,160.572183333333,22065,22245,180
100,0,blank,0,288.630466666667,162.529016666667,22245,22443,198
100,0,blank,0,264.64712,155.80204,22443,22628,185
100,0,blank,0,248.822316666667,164.96235,22628,22814,186
100,0,blank,0,259.011033333333,174.485916666667,22814,22998,184
100,0,blank,0,288.927583333333,174.666833333333,22998,23185,187
100,0,blank,0,321.0194,168.859083333333,23185,23368,183
100,0,blank,0,322.0787,169.4901,23368,23430,62
100,0,blank,0,116.94545,188.980183333333,23461,23643,182
100,0,blank,0,109.933616666667,182.099733333333,23643,23823,180
100,7,list,42,92.2302666666667,140.441216666667,23823,24004,181
100,7,list,42,84.38225,139.619716666667,24004,24187,183
100,7,list,42,86.2922333333333,155.48555,24187,24368,181
100,0,blank,0,99.6522,199.413,24368,24549,181
100,0,blank,0,114.744,194.7291,24549,24643,94
100,0,blank,0,71.5814666666667,179.5891,24782,24961,179
100,0,blank,0,77.1125833333333,130.05835,24961,25145,184
100,0,blank,0,83.59985,102.1182,25145,25327,182
100,0,blank,0,86.1028333333333,90.5834833333333,25327,25510,183
100,0,blank,0,93.5091333333333,89.4871166666667,25510,25701,191
100,0,blank,0,94.82095,111.279883333333,25701,25896,195
100,0,blank,0,103.196216666667,84.4270166666667,25896,26086,190
100,0,blank,0,137.969716666667,71.98235,26086,26265,179
100,0,blank,0,143.7354,67.82535,26265,26445,180
100,0,blank,0,176.1529,77.5796833333333,26445,26625,180
100,0,blank,0,183.725666666667,86.1046666666667,26625,26807,182
100,0,blank,0,172.457566666667,79.94985,26807,26983,176
100,0,blank,0,190.809216666667,95.9790166666667,26983,27166,183
100,0,blank,0,200.065283333333,71.7072833333333,27166,27348,182
100,4,main,30,76.7140833333333,89.5765666666667,27378,27559,181
100,0,blank,0,79.31755,101.108616666667,27559,27742,183
100,0,blank,0,82.8041666666667,113.037466666667,27742,27833,91
100,0,blank,0,-323,-105,27863,28002,139
100,0,blank,0,109.9847,104.2617,28118,28291,173
100,0,blank,0,122.9325,100.919,28291,28474,183
100,0,blank,0,122.197316666667,97.83045,28474,28655,181
100,0,blank,0,116.40085,112.660483333333,28655,28837,182
100,7,list,42,93.4388333333333,138.390133333333,28837,29017,180
100,7,list,42,86.6564333333333,148.300033333333,29017,29198,181
100,7,list,42,90.7511333333333,151.634983333333,29198,29378,180
100,0,blank,0,91.9829166666667,135.831366666667,29378,29559,181
100,0,blank,0,115.371016666667,88.4020166666667,29559,29740,181
100,0,blank,0,150.627033333333,83.1503333333333,29740,29920,180
100,0,blank,0,137.816783333333,67.7123833333333,29920,30102,182
100,0,blank,0,88.0569166666667,134.760366666667,30102,30282,180
100,10,printf,55,72.2676,217.2291,30311,30497,186
100,0,blank,0,77.24586,186.34444,30497,30646,149
100,8,count,48,130.84445,168.823116666667,30706,30887,181
100,0,blank,0,214.22195,165.744916666667,30887,31069,182
100,0,blank,0,259.624283333333,162.590733333333,31069,31250,181
100,0,blank,0,309.373283333333,167.2254,31250,31433,183
100,0,blank,0,319.0226,174.8416,31433,31463,30
100,0,blank,0,82.5768666666667,117.866183333333,31492,31673,181
100,4,(,31,87.0777166666667,89.1901333333333,31673,31854,181
100,0,blank,0,131.01704,101.5571,31854,32006,152
100,9,i,53,93.8608333333333,187.056483333333,32038,32213,175
100,8,count,48,88.64842,174.31784,32213,32363,150
100,8,count,48,87.67965,174.7377,32363,32491,128
100,7,list,42,93.2613,150.6296,32491,32583,92
100,0,blank,0,126.1971,177.51905,32583,32754,171
100,0,blank,0,156.267566666667,177.536116666667,32754,32950,196
100,0,blank,0,155.11585,186.9184,32950,33138,188
100,6,comma,38,124.983383333333,116.569833333333,33138,33324,186
100,0,blank,0,116.03015,75.6185166666667,33324,33507,183
100,0,blank,0,82.7454333333333,105.884183333333,33507,33691,184
100,0,blank,0,86.7115166666667,111.6176,33691,33873,182
100,0,blank,0,104.0341,88.6674333333333,33873,34055,182
100,3,stdlib,25,132.075833333333,54.7514833333333,34055,34236,181
100,0,blank,0,88.3277,55.37605,34236,34359,123
100,0,blank,0,137.239866666667,171.725816666667,34389,34577,188
100,0,blank,0,133.377533333333,189.59795,34577,34763,186
100,0,blank,0,110.965433333333,192.315666666667,34763,34949,186
100,11,scanf,60,69.64805,223.8071,34949,35132,183
100,10,printf,55,69.0541166666667,217.068116666667,35132,35323,191
100,10,(,56,107.595533333333,212.43815,35323,35509,186
100,0,blank,0,99.8469,95.7722833333333,35538,35725,187
100,0,blank,0,86.5037333333333,100.0912,35725,35906,181
100,4,),32,96.8988,82.00225,35906,36087,181
100,0,blank,0,131.605033333333,73.2777833333333,36087,36270,183
100,0,blank,0,96.37455,199.768566666667,36270,36450,180
100,10,printf,55,101.753033333333,219.9186,36450,36634,184
100,10,printf,55,100.21106,205.63778,36634,36805,171
100,9,;,54,97.27032,185.91228,36805,36964,159
100,0,blank,0,79.36135,178.458183333333,37025,37208,183
100,12,index,68,56.2916333333333,251.451816666667,37208,37390,182
100,11,scanf,60,46.8797666666667,223.5711,37390,37582,192
100,10,printf,55,52.6241,202.2577,37582,37614,32
100,9,int,52,67.7633,191.1869,37684,37714,30
100,11,scanf,60,51.50958,230.99108,37774,37941,167
100,10,printf,55,57.12165,218.531675,37941,38091,150
100,9,int,52,49.5332,185.1824,38154,38183,29
100,16,list,91,100.2957,337.6058,38248,38278,30
100,10,"Enterthesizeofthelist:",57,120.98305,206.053633333333,38307,38486,179
100,10,"Enterthesizeofthelist:",57,130.195716666667,208.513883333333,38486,38667,181
100,0,blank,0,136.160566666667,192.3091,38667,38847,180
100,0,blank,0,139.981683333333,179.310266666667,38847,39031,184
100,10,printf,55,101.3979,201.010133333333,39031,39217,186
100,9,;,54,98.1308,187.923833333333,39217,39307,90
100,12,index,68,77.483725,256.577875,39444,39557,113
100,0,blank,0,-323,-105,39722,39774,52
100,0,blank,0,-323,-105,39855,40043,188
100,0,blank,0,-323,-105,40043,40072,29
100,13,"Printingthelist:\n",74,193.297583333333,286.42145,40232,40424,192
100,0,blank,0,238.888216666667,259.678783333333,40424,40613,189
100,0,blank,0,245.863566666667,249.466233333333,40613,40704,91
100,0,blank,0,271.64155,258.74155,40764,40858,94
100,0,blank,0,283.160433333333,245.152366666667,40921,41104,183
100,0,blank,0,268.432283333333,235.769666666667,41104,41286,182
100,10,"Enterthesizeofthelist:",57,139.982533333333,206.1989,41286,41476,190
100,10,"Enterthesizeofthelist:",57,131.636166666667,213.001966666667,41476,41661,185
100,10,"Enterthesizeofthelist:",57,154.88274,202.4722,41661,41848,187
100,0,blank,0,120.436366666667,182.9221,41848,42031,183
100,10,"Enterthesizeofthelist:",57,121.98322,214.3851,42031,42230,199
100,0,blank,0,143.578116666667,239.235533333333,42230,42417,187
100,11,"%d",62,141.8943,241.8009,42417,42447,30
100,13,"Printingthelist:\n",74,171.0075,271.8586,42478,42599,121
100,13,"Printingthelist:\n",74,179.15415,273.36595,42662,42852,190
100,0,blank,0,-323,-105,42882,42913,31
100,0,blank,0,195.5168,244.4754,42938,42969,31
100,0,blank,0,-323,-105,43002,43035,33
100,12,size,70,140.233966666667,247.856366666667,43060,43237,177
100,13,"Printingthelist:\n",74,159.6314,285.03454,43237,43419,182
100,17,"%d\t",104,177.9113,364.7251,43419,43451,32
100,13,"Printingthelist:\n",74,163.3879,281.5233,43512,43537,25
100,13,"Printingthelist:\n",74,154.0473,274.9843,43599,43624,25
100,0,blank,0,-323,-105,43711,43742,31
100,0,blank,0,154.1806,300.1819,43767,43804,37
100,0,blank,0,174.083675,140.653875,43957,44134,177
100,0,blank,0,125.4178,96.3955,44306,44394,88
100,0,blank,0,104.1151,202.3735,44484,44538,54
100,16,rand,96,205.837675,338.0081,44581,44755,174
100,0,blank,0,166.2544,327.3719,44755,44798,43
100,16,size,100,285.704766666667,341.85205,44843,45040,197
100,16,size,100,285.699666666667,347.752766666667,45040,45221,181
100,17,list,106,254.8015,367.758233333333,45221,45402,181
100,17,list,106,250.222016666667,373.766216666667,45402,45583,181
100,0,blank,0,311.111716666667,381.229,45583,45774,191
100,0,blank,0,340.950866666667,380.00985,45774,45954,180
100,0,blank,0,341.618283333333,376.75395,45954,46134,180
100,0,blank,0,312.766416666667,376.4673,46134,46318,184
100,0,blank,0,316.8228,379.782383333333,46318,46499,181
100,0,blank,0,337.029633333333,388.273233333333,46499,46678,179
100,0,blank,0,345.704225,373.0767,46678,46798,120
100,0,blank,0,-323,-105,46828,46933,105
100,0,blank,0,369.271566666667,368.286116666667,47061,47234,173
100,0,blank,0,372.9769,361.350216666667,47234,47414,180
100,0,blank,0,233.323233333333,348.3806,47444,47623,179
100,0,blank,0,242.699416666667,351.674333333333,47623,47803,180
100,17,list,106,258.637616666667,357.6582,47803,47981,178
100,17,list,106,252.022483333333,374.8909,47981,48160,179
100,16,size,100,276.7552,342.162916666667,48160,48339,179
100,0,blank,0,365.018916666667,335.129733333333,48339,48521,182
100,0,blank,0,371.7527,331.2356,48521,48551,30
100,0,blank,0,258.7898,311.723016666667,48581,48762,181
100,0,blank,0,258.645383333333,329.633933333333,48762,48942,180
100,17,list,106,265.714783333333,358.96075,48942,49121,179
100,17,list,106,238.317433333333,368.850266666667,49121,49302,181
100,0,blank,0,224.227816666667,356.153166666667,49302,49483,181
100,16,),98,240.770566666667,352.814133333333,49483,49663,180
100,0,blank,0,223.3804,360.5778,49663,49693,30
100,10,"Enterthesizeofthelist:",57,227.858016666667,208.967633333333,49724,49908,184
100,0,blank,0,263.35084,224.21468,49908,50062,154
100,19,"\nEnterthekeytosearch:",115,325.70865,410.816833333333,50093,50287,194
100,0,blank,0,335.379466666667,374.32725,50287,50468,181
100,0,blank,0,322.145733333333,345.11985,50468,50651,183
100,0,blank,0,262.010116666667,322.51525,50651,50834,183
100,0,blank,0,260.4313,304.529416666667,50834,51017,183
100,0,blank,0,342.542966666667,301.648033333333,51017,51198,181
100,0,blank,0,354.087916666667,327.499166666667,51198,51380,182
100,0,blank,0,353.328883333333,358.81245,51380,51562,182
100,0,blank,0,336.171516666667,362.4796,51562,51743,181
100,0,blank,0,343.551366666667,356.4434,51743,51925,182
100,0,blank,0,370.859866666667,352.617016666667,51925,52107,182
100,0,blank,0,389.465883333333,376.904016666667,52107,52290,183
100,0,blank,0,367.764616666667,360.608216666667,52290,52473,183
100,0,blank,0,383.892316666667,366.534716666667,52473,52662,189
100,0,blank,0,385.1795,362.37195,52662,52801,139
100,16,size,100,286.82605,334.35415,52801,52977,176
100,0,blank,0,271.80545,319.3676,52977,53162,185
100,0,blank,0,335.084816666667,322.619216666667,53162,53348,186
100,0,blank,0,334.432666666667,324.5107,53348,53532,184
100,0,blank,0,327.797166666667,339.292,53532,53718,186
100,0,blank,0,294.30085,328.075,53718,53901,183
100,16,size,100,311.0408,335.110016666667,53901,54081,180
100,0,blank,0,391.85615,368.1027,54081,54264,183
100,0,blank,0,347.573766666667,377.942516666667,54264,54450,186
100,0,blank,0,354.0605,374.101683333333,54450,54632,182
100,0,blank,0,367.238975,379.835925,54632,54753,121
100,0,blank,0,-323,-105,54783,54890,107
100,0,blank,0,370.148566666667,369.240133333333,55007,55198,191
100,0,blank,0,367.834133333333,360.187083333333,55198,55382,184
100,0,blank,0,383.262683333333,384.343083333333,55382,55565,183
100,0,blank,0,382.766083333333,380.054633333333,55565,55749,184
100,0,blank,0,371.277883333333,384.520166666667,55749,55932,183
100,0,blank,0,330.006916666667,384.413633333333,55932,56117,185
100,0,blank,0,321.417816666667,393.4407,56117,56300,183
100,17,;,111,316.654183333333,375.686833333333,56300,56482,182
100,0,blank,0,335.491833333333,374.9223,56482,56665,183
100,0,blank,0,356.341033333333,382.487283333333,56665,56849,184
100,0,blank,0,320.4619,394.592675,56849,56972,123
100,0,blank,0,1101.763,548.6352,57064,57096,32
100,0,blank,0,-323,-105,57756,57916,160
100,0,blank,0,-323,-105,57916,57961,45
100,0,blank,0,398.358983333333,390.284566666667,58060,58245,185
100,0,blank,0,394.7571,379.59545,58245,58429,184
100,0,blank,0,367.53735,362.476166666667,58429,58612,183
100,0,blank,0,367.711516666667,357.126633333333,58612,58794,182
100,0,blank,0,386.850883333333,352.515883333333,58794,58976,182
100,0,blank,0,387.086166666667,379.610833333333,58976,59157,181
100,0,blank,0,396.703166666667,371.151966666667,59157,59340,183
100,0,blank,0,330.407883333333,392.565266666667,59340,59521,181
100,19,"\nEnterthekeytosearch:",115,281.988533333333,399.749166666667,59521,59700,179
100,0,blank,0,225.961066666667,385.265783333333,59700,59881,181
100,19,"\nEnterthekeytosearch:",115,222.983166666667,412.213666666667,59881,60066,185
100,19,"\nEnterthekeytosearch:",115,220.912233333333,404.114,60066,60253,187
100,0,blank,0,-323,-105,60314,60456,142
100,19,"\nEnterthekeytosearch:",115,194.083833333333,414.244433333333,60490,60671,181
100,0,blank,0,208.629383333333,385.285866666667,60671,60858,187
100,0,blank,0,206.799933333333,385.790783333333,60858,61038,180
100,0,blank,0,274.520183333333,378.687533333333,61038,61219,181
100,19,"\nEnterthekeytosearch:",115,267.794616666667,405.050933333333,61219,61400,181
100,19,"\nEnterthekeytosearch:",115,229.995033333333,406.126,61400,61581,181
100,0,blank,0,229.612616666667,388.626016666667,61581,61764,183
100,0,blank,0,221.6907,398.940483333333,61764,61948,184
100,0,blank,0,223.448266666667,390.903066666667,61948,62136,188
100,19,"\nEnterthekeytosearch:",115,220.2944,399.697616666667,62136,62320,184
100,19,"\nEnterthekeytosearch:",115,222.583316666667,414.62855,62320,62503,183
100,19,"\nEnterthekeytosearch:",115,237.623683333333,412.040283333333,62503,62686,183
100,0,blank,0,345.441783333333,374.073566666667,62686,62870,184
100,0,blank,0,347.064716666667,373.854583333333,62870,63053,183
100,0,blank,0,382.571133333333,372.632033333333,63053,63237,184
100,0,blank,0,382.058833333333,357.614366666667,63237,63424,187
100,0,blank,0,388.151066666667,353.677733333333,63424,63610,186
100,0,blank,0,392.804866666667,344.536333333333,63610,63797,187
100,0,blank,0,385.17322,378.4431,63797,63953,156
100,19,"\nEnterthekeytosearch:",115,231.731183333333,408.257566666667,63985,64169,184
100,19,"\nEnterthekeytosearch:",115,232.101233333333,408.052283333333,64169,64358,189
100,19,"\nEnterthekeytosearch:",115,214.553383333333,418.535766666667,64358,64539,181
100,20,),124,205.621466666667,423.904116666667,64539,64721,182
100,19,"\nEnterthekeytosearch:",115,231.886366666667,407.141566666667,64721,64904,183
100,19,"\nEnterthekeytosearch:",115,220.622533333333,416.595316666667,64904,65088,184
100,20,),124,210.288233333333,424.676316666667,65088,65272,184
100,19,"\nEnterthekeytosearch:",115,222.012683333333,410.464816666667,65272,65453,181
100,19,"\nEnterthekeytosearch:",115,229.171133333333,411.082766666667,65453,65636,183
100,19,"\nEnterthekeytosearch:",115,230.843533333333,400.08575,65636,65818,182
100,0,blank,0,322.847533333333,395.992183333333,65818,66008,190
100,0,blank,0,359.921,386.359533333333,66008,66190,182
100,0,blank,0,374.8784,372.869616666667,66190,66372,182
100,0,blank,0,369.104866666667,386.761733333333,66372,66554,182
100,0,blank,0,386.861983333333,389.246433333333,66554,66735,181
100,0,blank,0,391.881783333333,364.7588,66735,66917,182
100,0,blank,0,390.67725,384.357175,66917,67042,125
100,0,blank,0,259.945,394.08765,67074,67258,184
100,19,"\nEnterthekeytosearch:",115,277.00175,404.223466666667,67258,67440,182
100,19,"\nEnterthekeytosearch:",115,287.157433333333,414.789816666667,67440,67624,184
100,19,"\nEnterthekeytosearch:",115,352.004133333333,404.51885,67624,67814,190
100,0,blank,0,383.564733333333,390.145666666667,67814,68004,190
100,19,"\nEnterthekeytosearch:",115,248.42395,417.9167,68037,68222,185
100,19,"\nEnterthekeytosearch:",115,249.048633333333,409.204766666667,68222,68406,184
100,0,blank,0,221.111216666667,392.623366666667,68406,68594,188
100,19,"\nEnterthekeytosearch:",115,213.717016666667,409.361433333333,68594,68783,189
100,0,blank,0,286.714283333333,395.924716666667,68783,68973,190
100,0,blank,0,337.905016666667,398.733733333333,68973,69166,193
100,19,"\nEnterthekeytosearch:",115,334.5899,400.815416666667,69166,69356,190
100,0,blank,0,348.0347,388.479616666667,69356,69543,187
100,0,blank,0,379.17685,362.149283333333,69543,69740,197
100,0,blank,0,380.495316666667,372.7617,69740,69937,197
100,0,blank,0,380.59472,390.12158,69937,70101,164
100,0,blank,0,380.78595,383.0569,70101,70296,195
100,0,blank,0,382.769883333333,376.703066666667,70296,70493,197
100,0,blank,0,389.36665,389.3343,70493,70683,190
100,0,blank,0,393.536883333333,389.1483,70683,70877,194
100,0,blank,0,390.237716666667,388.037083333333,70877,71072,195
100,0,blank,0,387.494116666667,392.769266666667,71072,71266,194
100,0,blank,0,352.13886,394.9384,71266,71437,171
100,19,"\nEnterthekeytosearch:",115,355.89315,400.060683333333,71437,71636,199
100,0,blank,0,260.884183333333,398.45865,71636,71831,195
100,19,"\nEnterthekeytosearch:",115,253.68965,402.416016666667,71831,72016,185
100,0,blank,0,250.885283333333,393.8843,72016,72200,184
100,0,blank,0,366.777816666667,394.368566666667,72230,72422,192
100,0,blank,0,392.9175,371.223783333333,72422,72606,184
100,0,blank,0,383.796316666667,383.624683333333,72606,72796,190
100,0,blank,0,339.46225,387.0003,72796,72988,192
100,0,blank,0,346.51156,378.45342,72988,73145,157
100,0,blank,0,365.5964,376.1603,73145,73292,147
100,0,blank,0,369.9241,361.9335,73292,73487,195
100,0,blank,0,388.61598,367.88796,73487,73678,191
100,0,blank,0,370.362266666667,378.283133333333,73678,73864,186
100,0,blank,0,324.112816666667,362.948,73864,74047,183
100,0,blank,0,328.355116666667,371.45065,74047,74235,188
100,0,blank,0,357.348183333333,372.021933333333,74235,74425,190
100,0,blank,0,388.079216666667,371.361983333333,74425,74613,188
100,0,blank,0,391.2453,366.819033333333,74613,74801,188
100,0,blank,0,389.604383333333,366.81035,74801,74989,188
100,0,blank,0,389.291283333333,362.709583333333,74989,75177,188
100,0,blank,0,366.085,466.9342,75177,75209,32
100,0,blank,0,246.859066666667,385.121416666667,75457,75656,199
100,17,list,106,251.982483333333,375.499983333333,75656,75841,185
100,0,blank,0,371.275183333333,382.026116666667,75841,76026,185
100,0,blank,0,397.750233333333,374.024266666667,76026,76212,186
100,0,blank,0,333.141716666667,377.685183333333,76212,76396,184
100,17,list,106,240.793383333333,372.88475,76396,76587,191
100,0,blank,0,224.074416666667,388.4408,76587,76771,184
100,0,blank,0,217.9358,388.80252,76771,76923,152
100,0,blank,0,332.81314,378.5788,76953,77121,168
100,0,blank,0,310.939833333333,378.937466666667,77121,77315,194
100,0,blank,0,377.5126,386.718316666667,77315,77500,185
100,0,blank,0,389.899416666667,373.417533333333,77500,77686,186
100,17,],109,299.0148,358.76258,77716,77892,176
100,0,blank,0,364.360766666667,367.2376,77892,78079,187
100,0,blank,0,370.469466666667,358.632883333333,78079,78264,185
100,0,blank,0,328.74225,370.27975,78264,78331,67
100,0,blank,0,-323,-105,78361,78417,56
100,0,blank,0,260.454166666667,302.345666666667,78562,78740,178
100,17,],109,298.661633333333,356.987433333333,78740,78920,180
100,17,),110,309.161816666667,356.153383333333,78920,79102,182
100,16,size,100,307.1762,349.897466666667,79102,79283,181
100,17,[,107,275.378783333333,371.828533333333,79283,79464,181
100,0,blank,0,240.62285,398.508833333333,79464,79644,180
100,17,list,106,250.645666666667,358.5329,79644,79828,184
100,17,list,106,247.693933333333,374.460233333333,79828,80010,182
100,0,blank,0,248.655716666667,383.431,80010,80191,181
100,0,blank,0,241.229333333333,381.066483333333,80191,80373,182
100,0,blank,0,247.16335,383.95215,80373,80433,60
100,0,blank,0,374.15875,389.915216666667,80463,80655,192
100,0,blank,0,367.67195,377.009333333333,80655,80843,188
100,0,blank,0,364.0781,390.5508,80843,80873,30
100,17,list,106,266.069633333333,374.527416666667,80904,81089,185
100,17,list,106,260.48355,370.491583333333,81089,81274,185
100,17,list,106,257.780783333333,365.00785,81274,81461,187
100,0,blank,0,241.7999,389.51025,81461,81647,186
100,0,blank,0,335.43776,343.71462,81679,81842,163
100,19,"\nEnterthekeytosearch:",115,231.323616666667,401.2217,81874,82065,191
100,19,"\nEnterthekeytosearch:",115,222.0369,404.490583333333,82065,82254,189
100,0,blank,0,226.703783333333,395.230916666667,82254,82446,192
100,14,size,85,242.0575,300.232725,82446,82581,135
100,13,"Printingthelist:\n",74,253.378466666667,270.185066666667,82647,82843,196
100,0,blank,0,252.79,222.3669,82843,82877,34
100,14,i,87,264.9769,309.62485,82912,82980,68
100,0,blank,0,284.08372,322.2811,83013,83193,180
100,0,blank,0,325.30738,295.93574,83227,83390,163
100,0,blank,0,313.01075,259.3654,83424,83556,132
100,0,blank,0,312.267375,289.258325,83589,83723,134
100,13,"Printingthelist:\n",74,305.058775,273.34385,83757,83893,136
100,0,blank,0,-323,-105,84029,84173,144
100,0,blank,0,369.524066666667,360.6379,84206,84376,170
100,0,blank,0,362.14555,365.940983333333,84376,84561,185
100,0,blank,0,359.172733333333,361.269,84561,84748,187
100,0,blank,0,377.986183333333,362.052283333333,84748,84935,187
100,0,blank,0,391.764383333333,382.590566666667,84935,85124,189
100,0,blank,0,388.1541,384.5256,85124,85156,32
100,0,blank,0,228.858033333333,364.407483333333,85186,85370,184
100,0,blank,0,230.339633333333,374.762783333333,85370,85554,184
100,0,blank,0,229.763616666667,376.594833333333,85554,85739,185
100,19,"\nEnterthekeytosearch:",115,222.77475,400.7743,85739,85923,184
100,19,"\nEnterthekeytosearch:",115,208.359716666667,409.241283333333,85923,86106,183
100,0,blank,0,204.091683333333,396.569616666667,86106,86293,187
100,17,"%d\t",104,184.1035,364.1358,86293,86325,32
100,0,blank,0,302.468783333333,374.5823,86355,86542,187
100,17,;,111,314.111633333333,369.110083333333,86542,86730,188
100,0,blank,0,331.0998,370.72265,86730,86926,196
100,0,blank,0,329.797666666667,354.85495,86926,87110,184
100,0,blank,0,322.537833333333,337.356183333333,87110,87292,182
100,16,;,101,317.10766,339.10648,87292,87445,153
100,0,blank,0,-323,-105,87475,87531,56
100,17,),110,309.500733333333,361.278466666667,87679,87867,188
100,0,blank,0,349.87015,359.1161,87867,88053,186
100,0,blank,0,396.3152,371.3701,88053,88236,183
100,0,blank,0,367.242916666667,368.726933333333,88236,88419,183
100,0,blank,0,361.187716666667,373.122433333333,88419,88600,181
100,0,blank,0,381.258816666667,373.679766666667,88600,88782,182
100,0,blank,0,382.823533333333,384.23005,88782,88963,181
100,0,blank,0,374.814666666667,378.612283333333,88963,89142,179
100,0,blank,0,365.02318,361.02552,89142,89293,151
100,0,blank,0,245.577083333333,386.876666666667,89323,89507,184
100,0,blank,0,241.103433333333,393.588533333333,89507,89695,188
100,19,"\nEnterthekeytosearch:",115,211.5929,402.110633333333,89695,89878,183
100,0,blank,0,234.946883333333,387.043483333333,89878,90063,185
100,0,blank,0,239.798716666667,391.269383333333,90063,90252,189
100,0,blank,0,234.990133333333,390.7375,90252,90441,189
100,0,blank,0,285.197466666667,384.43705,90441,90627,186
100,0,blank,0,288.8601,389.17215,90627,90808,181
100,0,blank,0,293.21565,382.11475,90808,90989,181
100,0,blank,0,286.489916666667,388.904333333333,90989,91170,181
100,17,),110,307.424716666667,362.605716666667,91170,91352,182
100,17,;,111,320.179583333333,372.84535,91352,91533,181
100,0,blank,0,377.766216666667,371.949616666667,91533,91715,182
100,0,blank,0,370.876216666667,377.431683333333,91715,91898,183
100,0,blank,0,322.8558,356.641933333333,91898,92080,182
100,16,%,99,260.2603,338.1252,92080,92263,183
100,16,%,99,261.388666666667,347.044466666667,92263,92354,91
100,0,blank,0,328.593666666667,329.6607,92384,92565,181
100,0,blank,0,336.394816666667,340.360883333333,92565,92750,185
100,0,blank,0,370.844133333333,387.836433333333,92750,92932,182
100,0,blank,0,392.971366666667,369.253183333333,92932,93112,180
100,0,blank,0,384.2131,373.184283333333,93112,93294,182
100,0,blank,0,345.929483333333,317.6346,93294,93477,183
100,0,blank,0,341.271566666667,331.7872,93477,93592,115
100,0,blank,0,322.67645,327.7991,93592,93778,186
100,16,size,100,290.405666666667,346.6833,93778,93969,191
100,0,blank,0,285.053816666667,331.176066666667,93969,94152,183
100,0,blank,0,313.3668,320.092616666667,94152,94340,188
100,0,blank,0,336.291816666667,349.034866666667,94340,94522,182
100,0,blank,0,363.085716666667,344.419216666667,94522,94705,183
100,0,blank,0,372.488183333333,352.699833333333,94705,94894,189
100,0,blank,0,370.739166666667,369.105266666667,94894,95078,184
100,0,blank,0,286.992683333333,330.693933333333,95108,95291,183
100,0,blank,0,270.787483333333,382.121233333333,95291,95476,185
100,19,"\nEnterthekeytosearch:",115,237.0765,408.5804,95476,95660,184
100,0,blank,0,214.85025,394.331716666667,95660,95843,183
100,0,blank,0,236.466916666667,392.5543,95843,96029,186
100,0,blank,0,291.533983333333,398.181816666667,96029,96211,182
100,0,blank,0,289.7717,384.356866666667,96211,96391,180
100,0,blank,0,303.2946,396.60875,96391,96573,182
100,0,blank,0,308.50005,398.152083333333,96573,96754,181
100,0,blank,0,359.380216666667,382.54725,96754,96932,178
100,0,blank,0,327.984883333333,369.543566666667,96932,97112,180
100,17,list,106,234.807233333333,364.1782,97112,97295,183
100,16,%,99,257.185233333333,351.777,97295,97477,182
100,17,],109,297.321666666667,371.382866666667,97477,97658,181
100,17,),110,311.582933333333,370.88335,97658,97839,181
100,0,blank,0,346.451383333333,371.085383333333,97839,98020,181
100,0,blank,0,365.059716666667,325.7941,98020,98203,183
100,0,blank,0,380.953683333333,354.851566666667,98203,98384,181
100,0,blank,0,381.74145,353.567066666667,98384,98567,183
100,0,blank,0,383.127183333333,355.599833333333,98567,98749,182
100,0,blank,0,341.185016666667,340.835833333333,98749,98931,182
100,0,blank,0,331.435466666667,312.021433333333,98931,99112,181
100,0,blank,0,303.396133333333,330.7886,99112,99295,183
100,0,blank,0,299.9151,319.43515,99295,99475,180
100,0,blank,0,318.59735,322.529983333333,99475,99658,183
100,16,;,101,318.951816666667,334.64945,99658,99845,187
100,0,blank,0,299.419033333333,327.687866666667,99845,100026,181
100,0,blank,0,290.764016666667,321.297883333333,100026,100208,182
100,16,size,100,280.599216666667,336.3991,100208,100388,180
100,0,blank,0,249.73155,335.126333333333,100388,100569,181
100,0,blank,0,252.249133333333,302.941766666667,100569,100752,183
100,14,;,86,248.169816666667,303.93185,100752,100934,182
100,16,size,100,295.48685,336.432083333333,100934,101115,181
100,16,;,101,321.988116666667,351.840033333333,101115,101296,181
100,0,blank,0,323.27355,326.715133333333,101296,101480,184
100,0,blank,0,279.839816666667,314.485683333333,101480,101663,183
100,0,blank,0,266.31345,328.10545,101663,101844,181
100,0,blank,0,249.130816666667,323.6906,101844,102027,183
100,0,blank,0,281.743316666667,332.180966666667,102027,102210,183
100,0,blank,0,321.217983333333,324.772483333333,102210,102391,181
100,0,blank,0,368.348533333333,372.368366666667,102391,102573,182
100,0,blank,0,383.776116666667,359.5862,102573,102756,183
100,0,blank,0,366.697083333333,371.230083333333,102756,102938,182
100,0,blank,0,333.8025,367.069166666667,102938,103117,179
100,0,blank,0,312.283183333333,363.394316666667,103117,103299,182
100,0,blank,0,325.6846,363.143266666667,103299,103481,182
100,0,blank,0,330.882783333333,361.8639,103481,103661,180
100,0,blank,0,388.176033333333,358.222883333333,103661,103842,181
100,0,blank,0,373.44475,370.25185,103842,104025,183
100,0,blank,0,358.275883333333,362.6738,104025,104206,181
100,0,blank,0,373.033366666667,378.931483333333,104206,104387,181
100,0,blank,0,377.512216666667,366.5859,104387,104569,182
100,0,blank,0,354.754333333333,347.20325,104569,104751,182
100,0,blank,0,368.93245,340.277533333333,104751,104933,182
100,0,blank,0,344.450616666667,357.7009,104933,105115,182
100,0,blank,0,302.034733333333,363.549266666667,105115,105295,180
100,0,blank,0,265.772566666667,352.196816666667,105295,105477,182
100,17,list,106,237.451133333333,367.837916666667,105477,105659,182
100,17,list,106,234.960083333333,368.663633333333,105659,105842,183
100,16,),98,234.969666666667,352.33995,105842,106028,186
100,16,%,99,254.08504,349.4553,106028,106178,150
100,0,blank,0,-323,-105,106238,106361,123
100,0,blank,0,326.1702,375.139042857143,106390,106589,199
100,0,blank,0,339.201883333333,360.685516666667,106589,106769,180
100,0,blank,0,303.421933333333,369.741566666667,106769,106949,180
100,17,i,108,284.91855,375.414866666667,106949,107128,179
100,17,list,106,271.9141,368.8855,107128,107306,178
100,16,(,97,231.99812,348.22606,107306,107454,148
100,0,blank,0,221.095766666667,173.9384,107483,107576,93
100,0,blank,0,294.3485,183.57412,107673,107831,158
100,0,blank,0,299.46175,144.36585,107862,107925,63
100,0,blank,0,344.189066666667,323.9703,108124,108294,170
100,16,;,101,318.501325,335.93435,108294,108414,120
100,16,%,99,263.776883333333,343.995216666667,108444,108625,181
100,17,],109,294.8923,365.994716666667,108625,108806,181
100,16,size,100,305.617,338.7038,108806,108932,126
100,0,blank,0,298.442133333333,386.0341,108962,109146,184
100,0,blank,0,296.21306,382.35166,109146,109301,155
100,19,"\nEnterthekeytosearch:",115,369.6435,409.75875,109363,109548,185
100,0,blank,0,389.7033,384.357883333333,109548,109744,196
100,0,blank,0,389.23775,342.655183333333,109744,109938,194
100,0,blank,0,179.3163,298.5063,109976,110045,69
100,19,"\nEnterthekeytosearch:",115,195.925925,403.925075,110076,110197,121
100,16,rand,96,199.6083,341.8084,110258,110288,30
100,0,blank,0,189.344375,385.37245,110318,110438,120
100,19,"\nEnterthekeytosearch:",115,179.3496,408.8259,110469,110530,61
100,0,blank,0,-323,-105,110589,110774,185
100,0,blank,0,-323,-105,110774,110855,81
100,0,blank,0,273.578683333333,330.076516666667,110888,111087,199
100,13,"Printingthelist:\n",74,316.967766666667,284.448583333333,111087,111270,183
100,0,blank,0,339.934083333333,295.7377,111270,111450,180
100,0,blank,0,333.016383333333,311.025666666667,111450,111632,182
100,0,blank,0,307.188766666667,291.11275,111632,111814,182
100,13,"Printingthelist:\n",74,311.823483333333,283.14665,111814,111992,178
100,0,blank,0,303.951283333333,290.768083333333,111992,112181,189
100,13,"Printingthelist:\n",74,325.076683333333,275.943966666667,112181,112364,183
100,13,"Printingthelist:\n",74,320.63565,278.088166666667,112364,112543,179
100,0,blank,0,262.6545,316.036516666667,112543,112723,180
100,13,"Printingthelist:\n",74,269.060766666667,276.063966666667,112723,112903,180
100,0,blank,0,-323,-105,112964,113133,169
100,16,size,100,310.701214285714,339.840242857143,113161,113352,191
100,16,size,100,310.536166666667,353.041966666667,113352,113522,170
100,16,size,100,309.763466666667,335.099766666667,113522,113696,174
100,16,size,100,305.0669,341.255,113696,113809,113
100,13,"Printingthelist:\n",74,306.569,276.60365,113838,113986,148
100,0,blank,0,294.18815,320.81585,113986,114164,178
100,0,blank,0,267.189583333333,174.1216,114275,114473,198
100,0,blank,0,270.6727,166.2223,114473,114651,178
100,0,blank,0,225.027866666667,157.020116666667,114651,114831,180
100,0,blank,0,247.038816666667,164.696933333333,114831,115012,181
100,0,blank,0,255.3929,165.660816666667,115012,115191,179
100,0,blank,0,256.6231,166.443266666667,115191,115371,180
100,0,blank,0,259.95335,168.59375,115371,115550,179
100,0,blank,0,250.372366666667,184.841366666667,115550,115730,180
100,0,blank,0,249.72575,174.373,115730,115910,180
100,0,blank,0,259.1097,180.499066666667,115910,116090,180
100,0,blank,0,236.57065,180.700733333333,116090,116273,183
100,0,blank,0,238.003383333333,185.748866666667,116273,116453,180
100,0,blank,0,228.3973,154.4476,116453,116484,31
100,0,blank,0,328.533166666667,375.186883333333,116514,116694,180
100,16,size,100,297.803766666667,350.5931,116694,116874,180
100,0,blank,0,246.323966666667,353.249633333333,116874,117052,178
100,0,blank,0,243.813983333333,329.743683333333,117052,117231,179
100,0,blank,0,247.77515,326.681083333333,117231,117409,178
100,0,blank,0,250.41265,312.936833333333,117409,117587,178
100,0,blank,0,283.293733333333,321.824683333333,117587,117765,178
100,14,++,88,285.785483333333,299.238616666667,117765,117943,178
100,14,i,87,271.499416666667,307.809433333333,117943,118121,178
100,0,blank,0,293.436466666667,315.803983333333,118121,118299,178
100,0,blank,0,320.158483333333,304.527583333333,118299,118476,177
100,0,blank,0,318.96065,316.766416666667,118476,118663,187
100,0,blank,0,314.809233333333,308.074566666667,118663,118842,179
100,13,"Printingthelist:\n",74,295.498933333333,273.691383333333,118842,119027,185
100,0,blank,0,264.749116666667,262.413783333333,119027,119209,182
100,0,blank,0,238.23402,262.40032,119209,119359,150
100,10,"Enterthesizeofthelist:",57,239.843883333333,203.85295,119450,119634,184
100,0,blank,0,237.69995,167.190733333333,119634,119817,183
100,0,blank,0,234.1924,179.565916666667,119817,120000,183
100,0,blank,0,249.229816666667,167.103733333333,120000,120182,182
100,0,blank,0,260.3419,178.667175,120182,120303,121
100,16,size,100,309.580366666667,339.945283333333,120334,120517,183
100,0,blank,0,306.57215,327.6515,120517,120700,183
100,0,blank,0,297.100566666667,316.675266666667,120700,120791,91
100,0,blank,0,369.3818,334.36115,120880,121063,183
100,16,(,97,230.0058,349.9967,121126,121185,59
100,19,"\nEnterthekeytosearch:",115,266.18852,406.41814,121275,121426,151
100,0,blank,0,-323,-105,121457,121596,139
100,0,blank,0,374.0773,436.005,121728,121915,187
100,19,),116,408.402283333333,418.421533333333,121915,122096,181
100,0,blank,0,422.4607,374.4589,122126,122186,60
100,0,blank,0,418.731066666667,423.6195,122216,122396,180
100,19,"\nEnterthekeytosearch:",115,392.914516666667,417.634033333333,122396,122581,185
100,21,index,132,280.470466666667,450.2618,122581,122762,181
100,21,index,132,293.887016666667,457.158116666667,122762,122945,183
100,0,blank,0,250.979,426.585133333333,122945,123124,179
100,0,blank,0,226.102916666667,422.414366666667,123124,123302,178
100,21,search,128,183.969916666667,453.414183333333,123302,123484,182
100,21,(,129,185.466166666667,451.3732,123484,123666,182
100,21,index,132,276.547866666667,452.983516666667,123696,123876,180
100,21,index,132,283.680933333333,454.663283333333,123876,124057,181
100,21,index,132,297.94845,457.9998,124057,124234,177
100,0,blank,0,273.574366666667,439.846183333333,124234,124412,178
100,0,blank,0,237.551133333333,473.5325,124412,124594,182
100,0,blank,0,251.338566666667,475.615516666667,124594,124775,181
100,0,blank,0,281.72505,478.196833333333,124775,124955,180
100,0,blank,0,233.574616666667,482.6092,124955,125135,180
100,0,blank,0,259.90045,486.8942,125135,125316,181
100,21,index,132,288.48305,444.3773,125316,125495,179
100,0,blank,0,285.950816666667,476.312066666667,125495,125675,180
100,19,"\nEnterthekeytosearch:",115,283.6497,404.2207,125675,125706,31
100,0,blank,0,233.582583333333,517.493183333333,125766,125948,182
100,23,"\nTheelementfoundat%dlocation",147,251.091716666667,501.51425,125948,126130,182
100,0,blank,0,281.4297,393.5074,126130,126161,31
100,0,blank,0,267.3749,465.5543,126188,126218,30
100,23,"\nTheelementfoundat%dlocation",147,178.029533333333,487.322616666667,126249,126431,182
100,23,"\nTheelementfoundat%dlocation",147,194.15145,496.90995,126431,126613,182
100,23,"\nTheelementfoundat%dlocation",147,258.89045,489.48135,126613,126797,184
100,0,blank,0,285.712733333333,484.647333333333,126797,126978,181
100,0,blank,0,317.480883333333,480.66605,126978,127161,183
100,0,blank,0,343.052816666667,486.138783333333,127161,127347,186
100,23,"\nTheelementfoundat%dlocation",147,383.83805,490.839866666667,127347,127533,186
100,0,blank,0,402.283733333333,477.35655,127533,127716,183
100,23,"\nTheelementfoundat%dlocation",147,438.777616666667,498.703433333333,127716,127900,184
100,23,"\nTheelementfoundat%dlocation",147,446.5597,497.361483333333,127900,128087,187
100,23,"\nTheelementfoundat%dlocation",147,469.980766666667,504.5692,128087,128271,184
100,23,comma,148,475.39005,504.45725,128271,128331,60
100,23,"\nTheelementfoundat%dlocation",147,286.802766666667,501.826816666667,128361,128547,186
100,0,blank,0,215.631733333333,512.78355,128547,128730,183
100,0,blank,0,184.458683333333,514.977766666667,128730,128911,181
100,23,"\nTheelementfoundat%dlocation",147,238.803833333333,504.370866666667,128911,129094,183
100,23,"\nTheelementfoundat%dlocation",147,259.1963,500.444916666667,129094,129278,184
100,23,"\nTheelementfoundat%dlocation",147,271.8399,504.128183333333,129278,129466,188
100,0,blank,0,260.2336,517.467833333333,129466,129654,188
100,0,blank,0,214.08955,553.265966666667,129654,129837,183
100,25,"\nTheelementisnotfound",157,189.351966666667,536.50605,129837,130021,184
100,0,blank,0,184.784433333333,573.2772,130021,130118,97
100,31,size,183,169.249533333333,678.4775,130150,130340,190
100,31,size,183,179.325116666667,681.623116666667,130340,130530,190
100,31,key,186,244.91615,677.031983333333,130530,130720,190
100,0,blank,0,249.9846,684.1025,130720,130752,32
100,0,blank,0,220.88495,520.090883333333,130783,130970,187
100,0,blank,0,238.5077,520.821216666667,130970,131160,190
100,0,blank,0,193.926633333333,525.97695,131160,131348,188
100,0,blank,0,199.593766666667,520.2403,131348,131542,194
100,25,"\nTheelementisnotfound",157,239.7907,547.4827,131542,131733,191
100,25,"\nTheelementisnotfound",157,255.546033333333,541.0328,131733,131916,183
100,0,blank,0,261.589416666667,557.9335,131916,132100,184
100,0,blank,0,221.610433333333,513.595516666667,132100,132288,188
100,23,"\nTheelementfoundat%dlocation",147,209.307516666667,505.53255,132288,132484,196
100,0,blank,0,197.451283333333,517.69115,132484,132675,191
100,0,blank,0,192.917266666667,515.9322,132675,132869,194
100,0,blank,0,235.2204,516.0979,132869,133057,188
100,23,"\nTheelementfoundat%dlocation",147,255.0057,505.66375,133057,133242,185
100,0,blank,0,248.022183333333,513.210733333333,133242,133429,187
100,23,"\nTheelementfoundat%dlocation",147,217.20405,505.293633333333,133429,133617,188
100,20,),124,210.1417,425.5562,133617,133647,30
100,23,"\nTheelementfoundat%dlocation",147,194.5097,499.244133333333,133678,133861,183
100,23,"\nTheelementfoundat%dlocation",147,221.182616666667,492.064516666667,133861,134052,191
100,23,"\nTheelementfoundat%dlocation",147,248.247516666667,491.968733333333,134052,134241,189
100,0,blank,0,245.182666666667,481.2363,134241,134368,127
100,23,"\nTheelementfoundat%dlocation",147,223.3815,496.8899,134368,134486,118
100,23,"\nTheelementfoundat%dlocation",147,228.4251,488.4642,134486,134599,113
100,21,list,130,207.721725,456.150525,134599,134789,190
100,0,blank,0,250.234516666667,459.918633333333,134789,134979,190
100,21,index,132,273.034866666667,448.454916666667,134979,135167,188
100,0,blank,0,372.530233333333,442.866733333333,135167,135361,194
100,21,key,136,382.103433333333,453.367583333333,135361,135552,191
100,0,blank,0,418.4396,461.3268,135552,135583,31
100,20,),124,205.4751,430.5269,135614,135646,32
100,21,list,130,212.642516666667,459.599683333333,135709,135896,187
100,0,blank,0,261.559366666667,470.641366666667,135896,136087,191
100,0,blank,0,289.024616666667,483.431833333333,136087,136277,190
100,23,"\nTheelementfoundat%dlocation",147,262.33545,488.705716666667,136277,136460,183
100,0,blank,0,222.23775,474.615583333333,136460,136650,190
100,23,"\nTheelementfoundat%dlocation",147,257.318266666667,501.422316666667,136650,136840,190
100,0,blank,0,257.143316666667,484.734016666667,136840,137028,188
100,23,"\nTheelementfoundat%dlocation",147,255.514283333333,498.000133333333,137028,137213,185
100,23,"\nTheelementfoundat%dlocation",147,259.76405,500.6597,137213,137397,184
100,23,"\nTheelementfoundat%dlocation",147,257.501383333333,500.54165,137397,137580,183
100,0,blank,0,269.6433,508.976283333333,137580,137768,188
100,0,blank,0,317.67355,523.493983333333,137768,137955,187
100,0,blank,0,265.436583333333,513.547583333333,137955,138142,187
100,0,blank,0,252.369866666667,521.2827,138142,138329,187
100,25,"\nTheelementisnotfound",157,234.769583333333,542.228183333333,138329,138517,188
100,0,blank,0,246.409583333333,520.0385,138517,138702,185
100,0,blank,0,267.6812,516.342333333333,138702,138889,187
100,23,"\nTheelementfoundat%dlocation",147,330.373316666667,488.60275,138889,139075,186
100,23,"\nTheelementfoundat%dlocation",147,328.601533333333,502.87265,139075,139258,183
100,23,"\nTheelementfoundat%dlocation",147,325.134016666667,500.501383333333,139258,139445,187
100,23,"\nTheelementfoundat%dlocation",147,347.8757,498.68325,139445,139628,183
100,23,"\nTheelementfoundat%dlocation",147,338.416416666667,496.28495,139628,139810,182
100,23,"\nTheelementfoundat%dlocation",147,336.77655,495.866266666667,139810,139992,182
100,0,blank,0,328.7293,509.0935,139992,140022,30
100,0,blank,0,-323,-105,140084,140111,27
100,0,blank,0,333.063066666667,478.945233333333,140240,140422,182
100,21,index,132,277.046433333333,446.23845,140422,140602,180
100,17,list,106,252.3724,373.3191,140602,140692,90
100,0,blank,0,-323,-105,140722,140777,55
100,0,blank,0,228.12445,314.65805,140911,141090,179
100,11,size,65,203.71008,236.54612,141090,141247,157
100,11,size,65,178.6196,225.2813,141278,141310,32
100,6,index,37,167.0644,114.3134,141342,141373,31
100,6,index,37,189.005,133.6847,141405,141437,32
100,0,blank,0,238.306,247.8246,141499,141531,32
100,0,blank,0,139.65995,98.2015,141563,141629,66
100,13,"Printingthelist:\n",74,282.855566666667,267.763716666667,141661,141858,197
100,13,"Printingthelist:\n",74,290.74635,267.3031,141858,141918,60
100,0,blank,0,848.709,415.5559,142041,142166,125
100,0,blank,0,24.6128,693.894683333333,142287,142480,193
100,0,blank,0,-323,-105,142511,142648,137
100,0,blank,0,19.0688166666667,437.646216666667,142767,142949,182
100,0,blank,0,14.000475,449.58615,142949,143074,125
100,0,blank,0,0.490833333333332,426.60785,143137,143326,189
100,0,blank,0,35.47515,386.752866666667,143326,143518,192
100,0,blank,0,40.6280833333333,398.9949,143518,143705,187
100,0,blank,0,92.5156333333334,396.479616666667,143705,143897,192
100,0,blank,0,110.648933333333,520.124483333333,143897,144087,190
100,25,printf,155,102.27405,531.4282,144087,144276,189
100,25,printf,155,91.4312333333333,545.390583333333,144276,144464,188
100,0,blank,0,138.0294,555.494316666667,144464,144654,190
100,25,"\nTheelementisnotfound",157,156.79316,550.47522,144654,144823,169
100,25,"\nTheelementisnotfound",157,154.181233333333,547.66005,144823,145012,189
100,25,"\nTheelementisnotfound",157,196.894566666667,543.327816666667,145012,145202,190
100,25,printf,155,75.4629333333333,537.415166666667,145234,145425,191
100,0,blank,0,27.9347833333333,504.128566666667,145425,145617,192
100,0,blank,0,23.7761833333333,476.740816666667,145617,145811,194
100,0,blank,0,34.5080333333333,459.366383333333,145811,146006,195
100,0,blank,0,30.0584166666667,442.163033333333,146006,146194,188
100,20,scanf,118,55.2376833333333,423.858983333333,146194,146384,190
100,19,printf,113,91.2602333333333,413.2081,146384,146575,191
100,0,blank,0,84.32758,380.167,146575,146732,157
100,19,printf,113,93.1688,408.3556,146763,146947,184
100,20,(,119,98.2460666666667,434.5318,146947,147131,184
100,20,comma,121,151.06165,421.732383333333,147131,147318,187
100,20,&,122,163.53428,432.27356,147318,147474,156
100,0,blank,0,56.033,370.197433333333,147623,147806,183
100,19,(,114,112.0608,401.72635,147806,147995,189
100,0,blank,0,111.465433333333,383.767433333333,147995,148096,101
100,22,-1,143,145.84875,477.236083333333,148127,148316,189
100,25,"\nTheelementisnotfound",157,179.966116666667,531.537616666667,148316,148501,185
100,25,"\nTheelementisnotfound",157,177.9347,537.6747,148501,148533,32
100,0,blank,0,-323,-105,148563,148742,179
100,0,blank,0,-323,-105,148742,148791,49
100,25,"\nTheelementisnotfound",157,171.6056,550.483683333333,148826,149010,184
100,25,"\nTheelementisnotfound",157,167.650416666667,545.2036,149010,149199,189
100,25,"\nTheelementisnotfound",157,148.945616666667,542.753316666667,149199,149386,187
100,25,printf,155,96.81885,535.429016666667,149386,149572,186
100,0,blank,0,170.64935,529.147033333333,149572,149759,187
100,0,blank,0,173.0752,565.7571,149759,149790,31
100,25,printf,155,53.2743333333333,542.65615,149821,150007,186
100,25,printf,155,95.2965,548.445133333333,150007,150194,187
100,25,"\nTheelementisnotfound",157,115.697233333333,536.8486,150194,150381,187
100,0,blank,0,-323,-105,150413,150592,179
100,0,blank,0,137.80605,510.903675,150635,150752,117
100,25,printf,155,82.5261333333333,548.2711,150784,150974,190
100,0,blank,0,145.0536,521.4167,150974,151163,189
100,0,blank,0,174.156316666667,525.171366666667,151163,151352,189
100,25,"\nTheelementisnotfound",157,164.64372,544.23778,151352,151510,158
100,0,blank,0,-323,-105,151574,151686,112
100,0,blank,0,238.95925,476.91405,151715,151768,53
100,21,list,130,208.103533333333,452.268633333333,151799,151891,92
100,0,blank,0,38.9053,349.6286,151985,152021,36
100,25,printf,155,50.85075,543.285583333333,152052,152245,193
100,24,else,154,48.8467166666667,516.754116666667,152245,152436,191
100,25,printf,155,101.121,547.778383333333,152436,152623,187
100,0,blank,0,175.64272,521.21428,152623,152794,171
100,25,"\nTheelementisnotfound",157,172.67045,548.7132,152794,152858,64
100,0,blank,0,-323,-105,152889,152919,30
100,23,"\nTheelementfoundat%dlocation",147,151.551583333333,500.15,153034,153211,177
100,25,"\nTheelementisnotfound",157,167.682916666667,531.946583333333,153211,153400,189
100,0,blank,0,174.735066666667,530.739566666667,153400,153587,187
100,0,blank,0,183.333166666667,518.659516666667,153587,153773,186
100,25,"\nTheelementisnotfound",157,221.9377,534.2769,153773,153958,185
100,0,blank,0,203.958966666667,527.698966666667,153958,154143,185
100,0,blank,0,224.695816666667,521.43235,154143,154328,185
100,25,"\nTheelementisnotfound",157,242.186933333333,534.636166666667,154328,154421,93
100,26,},160,6.02653333333333,560.553583333333,154452,154635,183
100,0,blank,0,18.4718,553.7936,154635,154772,137
100,0,blank,0,37.9232,544.7565,154772,154875,103
100,0,blank,0,93.3728,557.4699,154875,155064,189
100,25,"\nTheelementisnotfound",157,136.92075,544.2278,155064,155259,195
100,25,printf,155,99.2619333333333,537.8317,155259,155446,187
100,0,blank,0,100.312933333333,555.433766666667,155446,155638,192
100,25,"\nTheelementisnotfound",157,129.4556,533.483216666667,155638,155821,183
100,25,"\nTheelementisnotfound",157,164.157566666667,534.381766666667,155821,156012,191
100,25,"\nTheelementisnotfound",157,159.085116666667,548.006916666667,156012,156206,194
100,25,"\nTheelementisnotfound",157,170.182016666667,537.300633333333,156206,156403,197
100,25,"\nTheelementisnotfound",157,231.064233333333,540.528466666667,156403,156590,187
100,25,"\nTheelementisnotfound",157,249.39536,541.09872,156590,156746,156
100,27,int,172,14.2691333333333,580.509716666667,156808,156995,187
100,0,blank,0,16.3842666666667,563.6649,156995,157182,187
100,0,blank,0,1.06008333333333,557.637383333333,157182,157370,188
100,0,blank,0,-27.2471333333333,550.66315,157370,157560,190
100,0,blank,0,-32.1074333333333,562.341866666667,157560,157654,94
100,0,blank,0,-323,-105,157721,157827,106
100,16,%,99,253.803325,338.9314,157925,158043,118
100,0,blank,0,-323,-105,158102,158291,189
100,0,blank,0,-323,-105,158291,158458,167
100,0,blank,0,-323,-105,158458,158657,199
100,0,blank,0,-323,-105,158657,158839,182
100,0,blank,0,-323,-105,158839,159007,168
100,0,blank,0,-323,-105,159007,159201,194
100,0,blank,0,-323,-105,159201,159387,186
100,0,blank,0,-323,-105,159387,159563,176
100,0,blank,0,-323,-105,159563,159738,175
100,0,blank,0,-323,-105,159738,159915,177
100,0,blank,0,-323,-105,159915,160098,183
100,0,blank,0,-323,-105,160098,160271,173
100,0,blank,0,-323,-105,160271,160467,196
100,0,blank,0,-323,-105,160467,160610,143
100,0,blank,0,-323,-105,160723,160915,192
100,0,blank,0,-323,-105,160915,161093,178
100,0,blank,0,-323,-105,161093,161239,146
100,23,"\nTheelementfoundat%dlocation",147,205.8165,487.3766,161470,161585,115
100,23,"\nTheelementfoundat%dlocation",147,275.66545,504.7065,161585,161718,133
100,23,"\nTheelementfoundat%dlocation",147,314.0959,502.73505,161718,161849,131
100,0,blank,0,-323,-105,161890,161999,109
100,0,blank,0,327.630133333333,481.932433333333,162059,162223,164
100,23,"\nTheelementfoundat%dlocation",147,449.391166666667,503.992366666667,162305,162493,188
100,23,"\nTheelementfoundat%dlocation",147,464.885166666667,488.54885,162493,162673,180
100,23,index,149,494.54995,498.753633333333,162673,162856,183
100,23,comma,148,480.326866666667,498.620283333333,162856,163036,180
100,23,"\nTheelementfoundat%dlocation",147,449.7942,497.8452,163036,163065,29
100,0,blank,0,309.1055,529.303433333333,163095,163273,178
100,23,"\nTheelementfoundat%dlocation",147,323.3582,505.7647,163273,163422,149
100,23,"\nTheelementfoundat%dlocation",147,472.94385,504.074816666667,163452,163637,185
100,23,"\nTheelementfoundat%dlocation",147,445.72785,498.77785,163637,163700,63
100,0,blank,0,243.358533333333,527.404833333333,163731,163910,179
100,0,blank,0,250.0749,512.704866666667,163910,164089,179
100,0,blank,0,249.592,515.2648,164089,164119,30
100,23,"\nTheelementfoundat%dlocation",147,464.095316666667,499.641683333333,164149,164335,186
100,23,"\nTheelementfoundat%dlocation",147,453.090183333333,500.079433333333,164335,164519,184
100,23,"\nTheelementfoundat%dlocation",147,463.1173,490.666966666667,164519,164698,179
100,23,comma,148,480.65335,506.91615,164698,164761,63
100,23,"\nTheelementfoundat%dlocation",147,337.5132,496.59015,164792,164913,121
100,0,blank,0,-323,-105,164943,165049,106
100,0,blank,0,395.1648,509.1902,165074,165108,34
100,0,blank,0,370.887033333333,509.6583,165174,165345,171
100,25,"\nTheelementisnotfound",157,253.621866666667,544.538066666667,165345,165526,181
100,0,blank,0,336.153766666667,513.241833333333,165526,165707,181
100,0,blank,0,330.95735,486.722483333333,165707,165886,179
100,0,blank,0,258.383083333333,515.170466666667,165886,166064,178
100,0,blank,0,246.5245,518.717516666667,166064,166237,173
100,0,blank,0,243.8628,517.5139,166237,166266,29
100,0,blank,0,-56.7126,509.87414,166550,166726,176
100,0,blank,0,-16.5680333333333,515.41105,166726,166908,182
100,0,blank,0,28.5152333333333,547.846066666667,166908,167089,181
100,0,blank,0,1.10053333333333,560.43445,167089,167271,182
100,0,blank,0,38.7561166666667,546.545916666667,167271,167455,184
100,25,printf,155,91.4132333333333,536.967833333333,167455,167642,187
100,0,blank,0,110.809816666667,528.682033333333,167642,167827,185
100,0,blank,0,149.352233333333,528.833083333333,167827,168016,189
100,25,"\nTheelementisnotfound",157,159.1326,544.3703,168016,168079,63
100,0,blank,0,-323,-105,168111,168243,132
100,0,blank,0,407.3542,481.9855,168269,168294,25
100,23,"\nTheelementfoundat%dlocation",147,404.1997,493.701133333333,168353,168525,172
100,23,"\nTheelementfoundat%dlocation",147,423.720733333333,500.92405,168525,168707,182
100,23,"\nTheelementfoundat%dlocation",147,461.353966666667,492.467233333333,168707,168888,181
100,23,comma,148,479.9267,507.4296,168888,169071,183
100,0,blank,0,482.056716666667,514.908716666667,169071,169253,182
100,0,blank,0,476.6901,524.34585,169253,169314,61
100,25,"\nTheelementisnotfound",157,235.891383333333,538.013016666667,169375,169559,184
100,25,"\nTheelementisnotfound",157,196.216533333333,539.434166666667,169559,169741,182
100,25,"\nTheelementisnotfound",157,215.49155,550.671883333333,169741,169925,184
100,25,"\nTheelementisnotfound",157,246.183583333333,547.913183333333,169925,170110,185
100,0,blank,0,249.295866666667,552.550733333333,170110,170296,186
100,25,"\nTheelementisnotfound",157,215.771816666667,536.656983333333,170296,170482,186
100,0,blank,0,208.11635,529.309583333333,170482,170668,186
100,0,blank,0,245.82395,521.531766666667,170668,170855,187
100,0,blank,0,268.043566666667,519.102083333333,170855,171041,186
100,25,"\nTheelementisnotfound",157,265.781433333333,537.391683333333,171041,171228,187
100,25,"\nTheelementisnotfound",157,261.9224,551.91,171228,171288,60
100,0,blank,0,-323,-105,171319,171500,181
100,0,blank,0,-323,-105,171500,171557,57
100,0,blank,0,244.367983333333,529.176366666667,171590,171765,175
100,25,"\nTheelementisnotfound",157,235.31425,546.598966666667,171765,171952,187
100,0,blank,0,239.0228,473.386,171952,171983,31
100,0,blank,0,191.92705,567.339083333333,172013,172196,183
100,0,blank,0,255.6824,563.626666666667,172196,172385,189
100,0,blank,0,270.520483333333,559.712916666667,172385,172573,188
100,0,blank,0,295.658733333333,560.59655,172573,172760,187
100,0,blank,0,340.447883333333,560.669716666667,172760,172945,185
100,0,blank,0,353.668383333333,560.889066666667,172945,173128,183
100,0,blank,0,383.403783333333,554.475266666667,173128,173315,187
100,0,blank,0,435.359316666667,549.350166666667,173315,173503,188
100,0,blank,0,442.348183333333,551.17385,173503,173690,187
100,0,blank,0,483.03466,555.9167,173690,173846,156
100,0,blank,0,-323,-105,173876,173983,107
100,0,blank,0,535.455833333333,523.587666666667,174126,174301,175
100,0,blank,0,576.953416666667,549.252766666667,174301,174489,188
100,0,blank,0,599.610533333333,555.416216666667,174489,174679,190
100,0,blank,0,607.812566666667,553.5101,174679,174871,192
100,0,blank,0,626.631166666667,536.654833333333,174871,175063,192
100,0,blank,0,622.6851,518.3117,175063,175116,53
100,0,blank,0,306.8121,519.2751,175198,175294,96
100,25,"\nTheelementisnotfound",157,203.33836,537.83634,175411,175607,196
100,25,"\nTheelementisnotfound",157,235.877475,551.200675,175607,175733,126
100,0,blank,0,598.912416666667,562.993683333333,175766,175962,196
100,0,blank,0,588.472466666667,543.194383333333,175962,176153,191
100,0,blank,0,580.196833333333,533.2639,176153,176251,98
100,0,blank,0,336.822716666667,569.4901,176283,176475,192
100,0,blank,0,251.064883333333,570.267216666667,176475,176667,192
100,25,"\nTheelementisnotfound",157,235.028616666667,542.26775,176667,176856,189
100,0,blank,0,221.2407,474.8043,176856,176887,31
100,0,blank,0,282.34235,523.23915,176985,177111,126
100,23,"\nTheelementfoundat%dlocation",147,303.063783333333,498.95965,177173,177357,184
100,21,1,134,341.2344,452.621625,177357,177480,123
100,0,blank,0,321.129616666667,479.114816666667,177511,177694,183
100,0,blank,0,334.212366666667,471.633883333333,177694,177876,182
100,0,blank,0,338.9647,481.65165,177876,178060,184
100,23,"\nTheelementfoundat%dlocation",147,335.945516666667,489.243966666667,178060,178244,184
100,0,blank,0,336.5936,483.146366666667,178244,178335,91
100,23,"\nTheelementfoundat%dlocation",147,378.08895,504.9414,178398,178575,177
100,23,"\nTheelementfoundat%dlocation",147,376.5722,500.901483333333,178575,178760,185
100,23,"\nTheelementfoundat%dlocation",147,401.401683333333,495.2715,178760,178946,186
100,23,"\nTheelementfoundat%dlocation",147,398.1565,498.724216666667,178946,179132,186
100,0,blank,0,408.050466666667,486.62255,179132,179320,188
100,0,blank,0,419.8824,443.699016666667,179320,179507,187
100,0,blank,0,410.194916666667,480.075516666667,179507,179694,187
100,23,"\nTheelementfoundat%dlocation",147,394.27415,491.11635,179694,179756,62
100,0,blank,0,278.6031,482.509116666667,179787,179972,185
100,23,"\nTheelementfoundat%dlocation",147,230.651683333333,488.005433333333,179972,180157,185
100,0,blank,0,225.393283333333,478.77945,180157,180342,185
100,23,"\nTheelementfoundat%dlocation",147,273.179016666667,501.248666666667,180342,180527,185
100,0,blank,0,283.610083333333,511.268283333333,180527,180712,185
100,0,blank,0,203.41395,519.613383333333,180712,180900,188
100,23,"\nTheelementfoundat%dlocation",147,201.11125,503.450883333333,180900,181088,188
100,0,blank,0,198.211233333333,510.90845,181088,181277,189
100,23,"\nTheelementfoundat%dlocation",147,246.831583333333,501.578433333333,181277,181461,184
100,0,blank,0,272.850716666667,509.081516666667,181461,181649,188
100,0,blank,0,-323,-105,181679,181799,120
100,23,"\nTheelementfoundat%dlocation",147,405.806683333333,499.992766666667,181947,182129,182
100,0,blank,0,403.485066666667,485.501816666667,182129,182317,188
100,23,"\nTheelementfoundat%dlocation",147,431.543716666667,488.640983333333,182317,182504,187
100,23,"\nTheelementfoundat%dlocation",147,413.9667,501.268866666667,182504,182597,93
100,23,"\nTheelementfoundat%dlocation",147,216.1194,497.841083333333,182630,182815,185
100,23,"\nTheelementfoundat%dlocation",147,186.45055,507.687166666667,182815,183002,187
100,0,blank,0,207.082,517.020766666667,183002,183191,189
100,0,blank,0,206.6509,510.538733333333,183191,183378,187
100,23,"\nTheelementfoundat%dlocation",147,198.028166666667,505.5608,183378,183568,190
100,0,blank,0,235.857816666667,516.2215,183568,183754,186
100,0,blank,0,258.541416666667,483.8633,183754,183946,192
100,23,"\nTheelementfoundat%dlocation",147,259.684383333333,499.017416666667,183946,184130,184
100,0,blank,0,249.91165,486.906216666667,184130,184316,186
100,0,blank,0,221.932716666667,520.35515,184316,184508,192
100,0,blank,0,213.689733333333,520.807066666667,184508,184698,190
100,0,blank,0,-323,-105,184762,184885,123
100,0,blank,0,254.556766666667,684.366366666667,185064,185253,189
100,31,),187,268.232266666667,682.475333333333,185253,185348,95
100,0,blank,0,219.837783333333,654.103516666667,185411,185609,198
100,0,blank,0,188.857566666667,622.811266666667,185609,185705,96
100,0,blank,0,192.223266666667,630.4321,185768,185956,188
100,0,blank,0,205.3885,479.419025,185956,186083,127
100,25,"\nTheelementisnotfound",157,223.953333333333,532.887,186114,186306,192
100,23,"\nTheelementfoundat%dlocation",147,266.534616666667,487.798533333333,186306,186500,194
100,23,"\nTheelementfoundat%dlocation",147,201.712716666667,495.841966666667,186500,186687,187
100,0,blank,0,195.0071,525.32035,186687,186873,186
100,23,"\nTheelementfoundat%dlocation",147,229.4434,494.85865,186873,187060,187
100,0,blank,0,228.226933333333,522.268433333333,187060,187250,190
100,0,blank,0,264.365533333333,510.81215,187250,187437,187
100,23,"\nTheelementfoundat%dlocation",147,285.38275,501.0644,187437,187625,188
100,0,blank,0,270.82885,476.8112,187625,187810,185
100,0,blank,0,257.6792,482.232333333333,187810,187910,100
100,23,"\nTheelementfoundat%dlocation",147,196.367733333333,506.627483333333,187941,188129,188
100,0,blank,0,-323,-105,188161,188280,119
100,0,blank,0,203.077433333333,484.019816666667,188424,188601,177
100,0,blank,0,250.1622,453.989116666667,188601,188784,183
100,21,index,132,262.863416666667,448.224283333333,188784,188972,188
100,0,blank,0,250.17015,517.396983333333,188972,189159,187
100,0,blank,0,258.299183333333,524.545616666667,189159,189345,186
100,0,blank,0,287.59662,474.3417,189345,189501,156
100,23,"\nTheelementfoundat%dlocation",147,371.66845,501.309866666667,189532,189721,189
100,0,blank,0,389.8692,512.1696,189721,189751,30
100,0,blank,0,-323,-105,189782,189952,170
100,0,blank,0,402.199966666667,462.0554,190067,190249,182
100,0,blank,0,396.441483333333,485.4671,190249,190435,186
100,0,blank,0,399.14626,471.50566,190435,190593,158
100,0,blank,0,240.37045,423.613733333333,190625,190811,186
100,0,blank,0,221.0721,386.932883333333,190811,190995,184
100,0,blank,0,217.032483333333,317.08895,190995,191180,185
100,14,size,85,211.377266666667,303.816583333333,191180,191363,183
100,0,blank,0,197.032383333333,289.30025,191363,191546,183
100,0,blank,0,253.302666666667,296.405433333333,191546,191733,187
100,23,"\nTheelementfoundat%dlocation",147,425.574216666667,493.432816666667,191763,191949,186
100,23,"\nTheelementfoundat%dlocation",147,462.19455,502.832766666667,191949,192135,186
100,23,"\nTheelementfoundat%dlocation",147,464.916566666667,492.676283333333,192135,192321,186
100,23,comma,148,474.6323,499.77835,192321,192444,123
100,0,blank,0,284.394533333333,515.319916666667,192474,192662,188
100,23,comma,148,481.253566666667,503.072333333333,192691,192877,186
100,0,blank,0,449.2649,519.0213,192877,192908,31
100,0,blank,0,269.944983333333,520.885466666667,192940,193129,189
100,25,"\nTheelementisnotfound",157,253.54455,531.404316666667,193129,193315,186
100,23,"\nTheelementfoundat%dlocation",147,270.406166666667,501.9005,193315,193502,187
100,23,"\nTheelementfoundat%dlocation",147,251.659166666667,494.251333333333,193502,193688,186
100,0,blank,0,220.176033333333,476.8539,193688,193874,186
100,0,blank,0,224.738,515.6167,193874,193906,32
100,0,blank,0,412.141075,428.271975,193937,194062,125
100,0,blank,0,238.914666666667,569.88565,194125,194311,186
100,25,"\nTheelementisnotfound",157,228.0805,546.093083333333,194311,194497,186
100,25,"\nTheelementisnotfound",157,233.320516666667,550.884716666667,194497,194684,187
100,25,"\nTheelementisnotfound",157,265.664,539.0783,194684,194780,96
100,0,blank,0,-323,-105,194841,195002,161
100,0,blank,0,-323,-105,195002,195048,46
100,0,blank,0,257.3192,517.6345,195085,195106,21
100,0,blank,0,244.02225,562.2001,195136,195197,61
100,0,blank,0,229.8542,735.4195,195260,195285,25
100,0,blank,0,-323,-105,195319,195476,157
100,0,blank,0,-321.9924,313.7613,195531,195565,34
100,0,blank,0,898.813,297.4134,195675,195802,127
100,0,blank,0,823.218,675.8863,195915,195948,33
100,0,blank,0,22.5212,556.424,196100,196259,159
100,0,blank,0,833.665666666667,285.768183333333,196410,196600,190
100,0,blank,0,836.963,285.344233333333,196600,196787,187
100,0,blank,0,824.8665,314.63915,196787,196848,61
100,0,blank,0,908.387166666667,99.0445,196878,197063,185
100,0,blank,0,893.3845,105.8434,197063,197122,59
100,0,blank,0,882.423,241.32,197153,197342,189
100,0,blank,0,881.191333333333,218.5754,197342,197528,186
100,0,blank,0,876.850166666667,233.017083333333,197528,197712,184
100,0,blank,0,881.376333333333,221.8516,197712,197901,189
100,0,blank,0,874.5775,225.83345,197901,197964,63
100,0,blank,0,929.457,162.0605,197995,198028,33
100,0,blank,0,218.969225,256.468625,198211,198386,175
100,0,blank,0,125.950033333333,322.1786,198431,198571,140
101,29,int,176,43.3527,392.0484,198829,198910,81
101,0,blank,0,-323,-105,198952,199034,82
101,27,search,162,90.4611,341.9829,199072,199146,74
101,0,blank,0,143.342766666667,318.839133333333,199229,199392,163
101,0,blank,0,180.19194,318.46602,199392,199581,189
101,0,blank,0,223.684575,317.3129,199581,199697,116
101,0,blank,0,-323,-105,199725,199910,185
101,0,blank,0,-323,-105,199910,200093,183
101,0,blank,0,-323,-105,200093,200384,291
101,0,blank,0,-323,-105,200384,200570,186
101,0,blank,0,-323,-105,200570,200748,178
101,0,blank,0,-323,-105,200748,200859,111
101,0,blank,0,-323,-105,200859,201040,181
101,0,blank,0,-323,-105,201040,201220,180
101,0,blank,0,-323,-105,201220,201397,177
101,0,blank,0,-323,-105,201397,201576,179
101,0,blank,0,-323,-105,201576,201775,199
101,0,blank,0,-323,-105,201775,201952,177
101,0,blank,0,-323,-105,201952,202133,181
101,0,blank,0,-323,-105,202133,202315,182
101,0,blank,0,-323,-105,202315,202473,158
101,0,blank,0,-323,-105,202473,202732,259
101,0,blank,0,-323,-105,202732,202955,223
101,19,"\nEnterthekeytosearch:",115,153.51245,172.3459,202992,203053,61
101,17,list,106,235.2315,123.1171,203090,203252,162
101,16,%,99,261.654233333333,109.521633333333,203252,203353,101
101,14,;,86,247.53268,49.46496,203381,203526,145
101,0,blank,0,244.54652,6.60908,203526,203693,167
101,13,"Printingthelist:\n",74,242.55505,32.949225,203693,203876,183
101,13,"Printingthelist:\n",74,241.71375,35.72235,203876,203928,52
101,0,blank,0,280.126566666667,143.31635,204034,204223,189
101,0,blank,0,283.6754,133.73775,204223,204404,181
101,0,blank,0,292.984971428571,187.6832,204404,204590,186
101,21,-,133,316.103033333333,204.380933333333,204618,204705,87
101,0,blank,0,340.2258,202.6047,204705,204914,209
101,0,blank,0,340.2258,202.6047,204914,204939,25
101,0,blank,0,-323,-105,205289,205556,267
101,0,blank,0,-323,-105,205556,205723,167
101,0,blank,0,302.186,191.1161,205832,205862,30
101,0,blank,0,405.3151,287.5181,205883,206070,187
101,0,blank,0,405.78435,276.924,206070,206254,184
101,0,blank,0,384.43555,269.43185,206254,206304,50
101,0,blank,0,-323,-105,206329,206459,130
101,0,blank,0,321.14465,320.1921,206579,206697,118
101,21,key,136,393.0366,208.07315,206852,206935,83
101,0,blank,0,339.855,143.4323,206974,207014,40
101,0,blank,0,361.8616,378.618,207135,207175,40
101,0,blank,0,317.7114,373.60415,207335,207474,139
101,29,int,176,70.6716428571429,383.257185714286,207502,207701,199
101,0,blank,0,73.4695333333333,417.184833333333,207701,207872,171
101,0,blank,0,59.8027,472.4294,207872,207901,29
101,0,blank,0,62.531,420.93585,207930,208101,171
101,0,blank,0,101.0543,417.06725,208101,208272,171
101,0,blank,0,149.930028571429,378.359642857143,208272,208470,198
101,29,location,177,102.838285714286,394.972057142857,208470,208668,198
101,0,blank,0,103.3557,404.584471428571,208668,208865,197
101,31,(,180,75.3985,425.682971428571,208865,209063,198
101,0,blank,0,104.388228571429,456.155914285714,209063,209261,198
101,33,return,189,104.140733333333,484.5417,209261,209346,85
101,33,return,189,142.144785714286,469.7609,209374,209570,196
101,0,blank,0,-323,-105,209599,209702,103
101,0,blank,0,142.8213,465.064,209727,209758,31
101,0,blank,0,180.984042857143,455.534214285714,209818,210006,188
101,0,blank,0,196.004357142857,453.052057142857,210006,210204,198
101,31,size,183,152.4048,443.087328571429,210236,210432,196
101,0,blank,0,-323,-105,210489,210622,133
101,0,blank,0,87.4999428571429,419.991428571429,210749,210948,199
101,31,(,180,76.1034333333333,430.602816666667,210948,211129,181
101,0,blank,0,70.82485,421.906116666667,211129,211311,182
101,0,blank,0,100.104183333333,414.675883333333,211311,211492,181
101,0,blank,0,125.910283333333,420.918033333333,211492,211673,181
101,31,[,182,135.365383333333,426.2813,211673,211855,182
101,0,blank,0,139.083883333333,420.513783333333,211855,212035,180
101,0,blank,0,145.4581,406.502583333333,212035,212225,190
101,0,blank,0,170.794133333333,331.991983333333,212225,212413,188
101,0,blank,0,198.360016666667,325.359516666667,212413,212595,182
101,27,int,172,138.63235,340.1602,212595,212778,183
101,29,location,177,132.45755,382.380716666667,212778,212959,181
101,0,blank,0,108.06705,405.8211,212959,213140,181
101,0,blank,0,74.63215,385.147633333333,213140,213322,182
101,0,blank,0,99.5703,379.0595,213322,213503,181
101,0,blank,0,132.03145,406.869533333333,213503,213684,181
101,31,size,183,157.07565,426.202433333333,213684,213863,179
101,0,blank,0,200.280116666667,429.931333333333,213863,214050,187
101,0,blank,0,200.6208,426.7464,214050,214141,91
101,0,blank,0,-323,-105,214172,214202,30
101,33,return,189,142.993242857143,482.530514285714,214304,214503,199
101,33,return,189,105.953216666667,477.376683333333,214503,214687,184
101,0,blank,0,107.4658,492.55468,214687,214870,183
101,0,blank,0,149.019816666667,475.971883333333,214870,215054,184
101,31,size,183,153.7564,441.62545,215054,215115,61
101,25,"\nTheelementisnotfound",157,167.76725,306.5614,215144,215331,187
101,23,"\nTheelementfoundat%dlocation",147,192.057933333333,247.166933333333,215331,215510,179
101,21,list,130,195.077816666667,208.41005,215510,215693,183
101,20,key,123,189.45702,201.69766,215693,215845,152
101,0,blank,0,186.5595,226.6765,215845,215896,51
101,0,blank,0,256.8464,190.7444,215896,216067,171
101,0,blank,0,323.05215,188.98235,216067,216234,167
101,0,blank,0,330.4215,189.46125,216234,216305,71
101,20,"%d",120,132.631733333333,195.438066666667,216336,216514,178
101,20,"%d",120,130.919966666667,195.073533333333,216514,216693,179
101,0,blank,0,117.66455,214.28935,216693,216812,119
101,31,array,181,96.3127333333334,432.35475,216842,217026,184
101,0,blank,0,92.2618,409.453216666667,217026,217205,179
101,0,blank,0,165.1635,358.393566666667,217205,217388,183
101,27,int,172,245.845883333333,348.506716666667,217388,217584,196
101,0,blank,0,269.024383333333,334.304883333333,217584,217767,183
101,0,blank,0,240.834616666667,331.568916666667,217767,217952,185
101,19,"\nEnterthekeytosearch:",115,270.907933333333,176.935983333333,217980,218172,192
101,0,blank,0,252.75325,208.153033333333,218172,218370,198
101,21,list,130,227.232566666667,214.525933333333,218370,218555,185
101,0,blank,0,285.43965,185.2604,218555,218754,199
101,0,blank,0,282.59656,195.23482,218754,218947,193
101,0,blank,0,255.8034,184.31644,218947,219120,173
101,19,"\nEnterthekeytosearch:",115,226.2037,177.161333333333,219120,219308,188
101,20,key,123,190.171083333333,181.51445,219308,219497,189
101,19,"\nEnterthekeytosearch:",115,155.75826,179.66934,219497,219651,154
101,0,blank,0,38.5658,146.867857142857,219840,220039,199
101,16,list,91,103.110316666667,113.465666666667,220039,220223,184
101,16,list,91,100.592283333333,109.717716666667,220223,220416,193
101,0,blank,0,94.7053666666666,80.1976,220416,220600,184
101,0,blank,0,98.61405,77.68525,220600,220660,60
101,0,blank,0,-323,-105,220691,220778,87
101,17,"%d\t",104,154.9086,124.5904,220803,220838,35
101,0,blank,0,154.42896,142.8354,220901,221046,145
101,0,blank,0,280.332016666667,238.721066666667,221077,221261,184
101,0,blank,0,271.775466666667,227.922166666667,221261,221445,184
101,0,blank,0,253.338066666667,208.498616666667,221445,221633,188
101,0,blank,0,253.284766666667,206.81605,221633,221819,186
101,0,blank,0,269.5721,181.728333333333,221819,221911,92
101,0,blank,0,139.4871,497.081,221941,222126,185
101,33,return,189,129.30825,470.968416666667,222126,222312,186
101,35,if,194,112.223033333333,514.394333333333,222312,222496,184
101,35,size,196,145.860316666667,511.691983333333,222496,222681,185
101,0,blank,0,134.562733333333,500.676166666667,222681,222867,186
101,35,else,193,82.8830166666667,511.821733333333,222867,223054,187
101,0,blank,0,102.014566666667,545.666383333333,223054,223242,188
101,37,return,201,125.183866666667,560.459783333333,223242,223434,192
101,0,blank,0,103.8122,632.8679,223434,223626,192
101,41,location,209,169.519366666667,656.55585,223626,223816,190
101,41,=,210,258.721066666667,652.290483333333,223816,224014,198
101,41,=,210,256.811016666667,654.65815,224014,224205,191
101,41,location,209,234.0657,644.1262,224205,224236,31
101,0,blank,0,49.9508833333333,567.9796,224268,224453,185
101,0,blank,0,54.5942333333333,586.15585,224453,224644,191
101,0,blank,0,104.464733333333,639.829466666667,224644,224835,191
101,0,blank,0,199.53885,640.02495,224835,224960,125
101,0,blank,0,-323,-105,225020,225152,132
101,0,blank,0,315.433971428571,686.806542857143,225178,225376,198
101,0,blank,0,330.054716666667,683.00725,225376,225563,187
101,0,blank,0,340.98445,669.487816666667,225563,225749,186
101,41,=,210,253.709666666667,651.933183333333,225749,225937,188
101,0,blank,0,252.302966666667,657.503183333333,225937,226130,193
101,41,search,211,279.70756,657.1151,226130,226304,174
101,41,array,213,349.172216666667,662.392933333333,226304,226499,195
101,0,blank,0,396.4437,667.565216666667,226499,226688,189
101,41,size,215,417.94515,651.8582,226688,226875,187
101,41,size,215,442.693566666667,652.8725,226875,227063,188
101,41,size,215,438.868875,657.7953,227063,227189,126
101,0,blank,0,-323,-105,227220,227389,169
101,0,blank,0,230.021975,702.181575,227419,227543,124
101,0,blank,0,122.911333333333,497.734883333333,227605,227800,195
101,0,blank,0,128.34685,489.05025,227800,227992,192
101,0,blank,0,138.190566666667,407.756983333333,227992,228182,190
101,0,blank,0,176.833983333333,409.733166666667,228182,228369,187
101,0,blank,0,196.281366666667,419.0125,228369,228552,183
101,0,blank,0,195.86075,420.9102,228552,228614,62
101,0,blank,0,-323,-105,228644,228779,135
101,0,blank,0,144.2759,570.9774,228804,228831,27
101,31,[,182,137.103328571429,428.296557142857,228902,229099,197
101,0,blank,0,91.0025166666667,445.971283333333,229099,229279,180
101,0,blank,0,90.5877,464.787083333333,229279,229456,177
101,0,blank,0,137.982533333333,544.29875,229456,229631,175
101,0,blank,0,133.436566666667,549.904066666667,229631,229804,173
101,37,return,201,130.008616666667,562.562116666667,229804,229978,174
101,0,blank,0,138.63776,580.5953,229978,230123,145
101,0,blank,0,-323,-105,230152,230338,186
101,0,blank,0,-323,-105,230338,230374,36
101,23,"\nTheelementfoundat%dlocation",147,126.517042857143,265.209085714286,230425,230622,197
101,19,"\nEnterthekeytosearch:",115,178.88495,175.956283333333,230622,230797,175
101,20,&,122,172.617383333333,188.636716666667,230797,230971,174
101,23,"\nTheelementfoundat%dlocation",147,168.2517,267.0346,230971,231001,30
101,0,blank,0,226.981014285714,91.9787428571428,231029,231227,198
101,16,),98,239.445257142857,109.7335,231227,231426,199
101,0,blank,0,293.122366666667,136.9099,231426,231512,86
101,0,blank,0,-323,-105,231540,231644,104
101,0,blank,0,-323,-105,231644,231823,179
101,0,blank,0,-323,-105,231823,231913,90
101,17,],109,298.114,118.7985,231958,231985,27
101,0,blank,0,283.54,186.049,231985,232170,185
101,0,blank,0,283.54,186.049,232170,232195,25
101,19,"\nEnterthekeytosearch:",115,181.301614285714,177.018414285714,232219,232411,192
101,21,(,129,187.20695,203.9956,232411,232468,57
101,0,blank,0,-323,-105,232527,232707,180
101,0,blank,0,-323,-105,232707,232868,161
101,0,blank,0,178.477166666667,71.9570666666667,232905,232979,74
101,19,"\nEnterthekeytosearch:",115,229.64505,178.96875,233477,233589,112
101,20,&,122,164.9521,188.9253,233589,234261,672
101,20,&,122,174.17552,191.13432,234261,234413,152
101,0,blank,0,269.479633333333,153.65315,234441,234618,177
101,0,blank,0,268.6502,181.6851,234618,234647,29
101,0,blank,0,227.8038,230.0994,234647,235138,491
101,0,blank,0,239.62172,227.79976,235138,235281,143
101,0,blank,0,306.325933333333,200.859216666667,235311,235486,175
101,0,blank,0,-323,-105,235515,235594,79
101,19,"\nEnterthekeytosearch:",115,313.158257142857,168.434085714286,235748,235946,198
101,19,"\nEnterthekeytosearch:",115,277.1925,177.2551,235946,236123,177
101,19,"\nEnterthekeytosearch:",115,290.0271,174.3806,236123,236293,170
101,0,blank,0,213.92695,188.95465,236293,236448,155
101,23,"\nTheelementfoundat%dlocation",147,208.7883,263.3055,236448,236555,107
101,0,blank,0,122.639366666667,157.48435,236616,236807,191
101,20,"%d",120,136.673966666667,187.706716666667,236807,236980,173
101,0,blank,0,99.2309166666667,158.973633333333,236980,237153,173
101,0,blank,0,92.37285,155.2731,237153,237211,58
101,19,"\nEnterthekeytosearch:",115,310.043766666667,166.905166666667,237270,237450,180
101,0,blank,0,288.59685,191.0807,237450,237636,186
101,0,blank,0,283.734466666667,184.986383333333,237636,237812,176
101,0,blank,0,224.81185,96.62605,237841,238018,177
101,0,blank,0,202.912066666667,86.3233833333333,238018,238195,177
101,0,blank,0,161.010583333333,56.8955666666667,238195,238374,179
101,13,"Printingthelist:\n",74,185.429433333333,32.8236,238374,238553,179
101,14,size,85,215.186083333333,68.3272833333333,238553,238731,178
101,0,blank,0,-323,-105,238791,238895,104
101,0,blank,0,182.180828571429,109.239271428571,239032,239229,197
101,0,blank,0,216.5712,91.4711666666667,239229,239413,184
101,0,blank,0,219.91035,87.3891,239413,239473,60
101,13,"Printingthelist:\n",74,141.50555,44.3438333333333,239502,239680,178
101,13,"Printingthelist:\n",74,142.002916666667,36.0448,239680,239860,180
101,13,"Printingthelist:\n",74,147.4056,35.8560166666667,239860,240036,176
101,0,blank,0,186.209316666667,82.4397166666667,240036,240214,178
101,0,blank,0,196.233633333333,74.5458833333333,240214,240390,176
101,0,blank,0,301.68625,182.5839,240419,240597,178
101,19,"\nEnterthekeytosearch:",115,289.91805,179.4554,240597,240774,177
101,20,key,123,195.078366666667,199.141716666667,240774,240951,177
101,0,blank,0,223.638866666667,192.4238,240951,241126,175
101,0,blank,0,254.4047,188.057566666667,241126,241303,177
101,0,blank,0,255.966083333333,192.195783333333,241303,241478,175
101,0,blank,0,257.39735,201.915483333333,241478,241652,174
101,0,blank,0,263.8653,146.9601,241652,241681,29
101,19,"\nEnterthekeytosearch:",115,162.163633333333,176.990516666667,241710,241884,174
101,0,blank,0,152.022583333333,187.89725,241884,242059,175
101,20,;,125,218.0514,191.505383333333,242059,242232,173
101,21,list,130,226.154816666667,204.270966666667,242232,242405,173
101,21,list,130,223.0989,223.06806,242405,242549,144
101,0,blank,0,-323,-105,242606,242710,104
101,19,"\nEnterthekeytosearch:",115,232.560057142857,169.733542857143,242826,243018,192
101,0,blank,0,230.2546,182.6506,243018,243190,172
101,20,;,125,218.800233333333,201.905233333333,243190,243362,172
101,0,blank,0,266.481728571429,200.195328571429,243362,243555,193
101,19,"\nEnterthekeytosearch:",115,271.4499,175.63225,243555,243611,56
101,0,blank,0,144.089766666667,408.435483333333,243814,243981,167
101,0,blank,0,192.708257142857,365.734528571429,244038,244237,199
101,0,blank,0,118.022733333333,402.496133333333,244237,244408,171
101,31,array,181,117.832514285714,432.743914285714,244408,244607,199
101,31,array,181,130.832914285714,429.448014285714,244607,244806,199
101,0,blank,0,115.187683333333,468.503633333333,244806,244979,173
101,0,blank,0,86.1505,453.859333333333,244979,245150,171
101,0,blank,0,109.57395,406.019366666667,245150,245322,172
101,31,size,183,149.432583333333,432.149333333333,245322,245496,174
101,31,size,183,145.865516666667,439.391916666667,245496,245671,175
101,31,[,182,141.2348,425.56265,245671,245843,172
101,0,blank,0,159.51425,402.489416666667,245843,246017,174
101,0,blank,0,238.974366666667,342.581833333333,246017,246190,173
101,0,blank,0,266.103,330.72345,246190,246365,175
101,0,blank,0,268.9615,330.8149,246365,246394,29
101,0,blank,0,236.955783333333,145.103916666667,246423,246598,175
101,0,blank,0,245.348016666667,142.9162,246598,246773,175
101,0,blank,0,251.3569,183.206116666667,246773,246946,173
101,19,"\nEnterthekeytosearch:",115,293.46058,172.52038,246946,247091,145
101,0,blank,0,297.50332,195.58358,247149,247295,146
101,0,blank,0,-323,-105,247324,247404,80
101,0,blank,0,235.15736,319.25958,247524,247658,134
101,0,blank,0,150.780033333333,419.284766666667,247687,247864,177
101,0,blank,0,147.82895,412.497416666667,247864,248041,177
101,0,blank,0,198.106416666667,415.985933333333,248041,248217,176
101,31,size,183,163.859133333333,423.330533333333,248217,248393,176
101,0,blank,0,149.1505,407.529533333333,248393,248572,179
101,31,array,181,124.463016666667,438.448133333333,248572,248751,179
101,0,blank,0,124.101716666667,454.965566666667,248751,248929,178
101,31,size,183,155.155466666667,437.27555,248929,249109,180
101,31,==,185,204.681833333333,430.599016666667,249109,249286,177
101,0,blank,0,201.05725,424.052316666667,249286,249465,179
101,0,blank,0,-323,-105,249524,249650,126
101,33,size,190,187.422514285714,479.656957142857,249676,249861,185
101,0,blank,0,201.58075,437.403066666667,249861,250037,176
101,0,blank,0,134.982883333333,460.39995,250037,250214,177
101,0,blank,0,159.25005,446.4343,250214,250391,177
101,0,blank,0,153.010916666667,486.795766666667,250391,250567,176
101,0,blank,0,129.895283333333,508.091783333333,250567,250742,175
101,0,blank,0,133.486466666667,504.8918,250742,250919,177
101,0,blank,0,145.496283333333,495.466416666667,250919,251097,178
101,0,blank,0,153.742133333333,471.426466666667,251097,251273,176
101,0,blank,0,160.04095,451.460316666667,251273,251452,179
101,0,blank,0,107.532516666667,467.564233333333,251452,251631,179
101,0,blank,0,121.828866666667,455.281916666667,251631,251809,178
101,31,size,183,173.187916666667,424.796766666667,251809,251986,177
101,0,blank,0,166.3394,419.889783333333,251986,252163,177
101,33,return,189,128.134,470.779816666667,252163,252342,179
101,33,return,189,116.379716666667,476.827066666667,252342,252520,178
101,0,blank,0,109.200616666667,509.491216666667,252520,252696,176
101,0,blank,0,76.2992666666667,508.247766666667,252696,252875,179
101,35,else,193,83.3551333333333,522.358533333333,252875,253055,180
101,35,if,194,110.6211,524.876066666667,253055,253233,178
101,35,(,195,126.42475,511.455166666667,253233,253410,177
101,0,blank,0,183.408783333333,510.892966666667,253410,253587,177
101,35,==,197,185.46495,515.6315,253587,253705,118
101,0,blank,0,-323,-105,253735,253866,131
101,0,blank,0,127.682042857143,537.833128571429,253954,254148,194
101,0,blank,0,117.944033333333,510.234166666667,254148,254326,178
101,35,size,196,154.1238,518.10725,254326,254505,179
101,35,==,197,198.5255,529.962616666667,254505,254680,175
101,37,return,201,139.90805,574.1011,254680,254857,177
101,0,blank,0,124.198716666667,555.636316666667,254857,255031,174
101,35,(,195,125.2674,524.4233,255031,255206,175
101,35,size,196,146.17615,519.687383333333,255206,255382,176
101,35,size,196,170.428916666667,515.023833333333,255382,255559,177
101,37,return,201,130.887283333333,559.477216666667,255559,255736,177
101,0,blank,0,142.684683333333,549.203316666667,255736,255913,177
101,35,size,196,164.232966666667,527.92275,255913,256091,178
101,0,blank,0,159.585883333333,503.985533333333,256091,256271,180
101,0,blank,0,94.95725,556.2257,256271,256449,178
101,0,blank,0,95.72695,545.92925,256449,256509,60
101,0,blank,0,-323,-105,256567,256750,183
101,35,(,195,125.662733333333,523.257483333333,257044,257217,173
101,0,blank,0,133.70155,511.298,257217,257396,179
101,0,blank,0,174.937716666667,513.255033333333,257396,257573,177
101,0,blank,0,180.3769,526.54335,257573,257691,118
101,0,blank,0,-323,-105,257750,257933,183
101,0,blank,0,-323,-105,257933,257968,35
101,0,blank,0,131.9165,507.812925,257999,258112,113
101,0,blank,0,86.1469,533.3301,258143,258172,29
101,0,blank,0,-323,-105,258288,258469,181
101,0,blank,0,-323,-105,258469,258657,188
101,0,blank,0,-323,-105,258657,258844,187
101,0,blank,0,-323,-105,258844,259013,169
101,0,blank,0,-323,-105,259013,259204,191
101,0,blank,0,-323,-105,259204,259300,96
101,21,list,130,225.89735,216.43385,259458,259519,61
101,0,blank,0,244.131,388.0615,259549,259613,64
101,0,blank,0,186.4777,317.7375,259613,259760,147
101,0,blank,0,236.0295,403.237,259760,259881,121
101,0,blank,0,206.1086,239.054516666667,259948,260141,193
101,0,blank,0,193.581,246.1104,260141,260207,66
101,0,blank,0,372.4398,389.6965,260267,260327,60
101,0,blank,0,317.48824,238.02434,260354,260548,194
101,23,"\nTheelementfoundat%dlocation",147,375.804825,258.52475,260548,260680,132
101,0,blank,0,439.835066666667,285.301666666667,260713,260912,199
101,0,blank,0,449.497066666667,273.490533333333,260912,261108,196
101,23,"\nTheelementfoundat%dlocation",147,460.511033333333,249.140683333333,261108,261304,196
101,23,"\nTheelementfoundat%dlocation",147,467.4815,265.68065,261304,261402,98
101,0,blank,0,284.633325,227.877575,261436,261600,164
101,21,(,129,192.8086,205.0208,261719,261747,28
101,0,blank,0,202.42962,231.92748,261909,262068,159
101,21,list,130,201.79338,217.26776,262068,262263,195
101,0,blank,0,203.830266666667,202.895966666667,262263,262427,164
101,23,"\nTheelementfoundat%dlocation",147,242.899,258.87415,262427,262515,88
101,0,blank,0,209.2807,242.4027,262547,262740,193
101,0,blank,0,227.1929,278.9869,262740,262804,64
101,25,"\nTheelementisnotfound",157,270.5916,294.826433333333,262896,263025,129
101,0,blank,0,-323,-105,263058,263240,182
101,0,blank,0,-323,-105,263240,263343,103
101,0,blank,0,187.61465,384.4841,263515,263632,117
101,0,blank,0,241.219875,285.2942,263662,263820,158
101,0,blank,0,285.5713,283.8936,263820,263912,92
101,27,key,173,406.514225,336.157075,263943,264127,184
101,0,blank,0,416.6234,317.265433333333,264127,264312,185
101,25,),158,394.43495,304.68105,264312,264374,62
101,0,blank,0,355.6274,490.9564,264439,264529,90
101,23,"\nTheelementfoundat%dlocation",147,200.56982,249.08904,264618,264806,188
101,21,(,129,188.26455,205.868175,264806,264963,157
101,0,blank,0,199.5244,231.35388,264963,265150,187
101,21,search,128,176.065333333333,213.39775,265218,265416,198
101,21,search,128,169.404375,213.564975,265541,265738,197
101,21,search,128,170.23495,213.98795,265738,265828,90
101,0,blank,0,-323,-105,265962,265989,27
101,0,blank,0,-323,-105,266065,266115,50
101,19,"\nEnterthekeytosearch:",115,181.907466666667,178.483966666667,266351,266541,190
101,21,(,129,190.331316666667,205.771766666667,266541,266727,186
101,0,blank,0,215.643533333333,229.455866666667,266727,266864,137
101,21,search,128,176.6652,223.5738,266864,266951,87
101,21,search,128,181.7172,203.4528,267017,267092,75
101,21,search,128,179.77335,216.55255,267180,267358,178
101,21,search,128,183.86545,205.42895,267358,267418,60
101,21,search,128,174.0122,207.7471,267483,267508,25
101,0,blank,0,-323,-105,267730,267838,108
101,0,blank,0,-323,-105,267994,268021,27
101,21,search,128,164.646466666667,203.928083333333,268108,268305,197
101,20,key,123,184.205433333333,201.971516666667,268305,268492,187
101,20,key,123,183.918866666667,199.344166666667,268492,268677,185
101,0,blank,0,181.099266666667,224.956333333333,268677,268862,185
101,21,(,129,190.625766666667,220.850583333333,268862,269049,187
101,0,blank,0,190.60695,202.311183333333,269049,269230,181
101,20,key,123,176.100333333333,199.976216666667,269230,269413,183
101,21,search,128,160.66275,206.281183333333,269413,269594,181
101,20,&,122,166.798983333333,192.758733333333,269594,269769,175
101,20,key,123,196.84355,187.66735,269769,269950,181
101,20,key,123,192.82388,198.00966,269950,270101,151
101,0,blank,0,207.440333333333,492.847466666667,270161,270343,182
101,0,blank,0,253.68515,502.256883333333,270343,270525,182
101,0,blank,0,241.46585,472.236383333333,270525,270703,178
101,0,blank,0,214.112183333333,389.777716666667,270703,270882,179
101,0,blank,0,206.75465,395.968816666667,270882,271062,180
101,0,blank,0,200.128633333333,396.646066666667,271062,271151,89
101,0,blank,0,194.14055,578.755233333333,271182,271361,179
101,0,blank,0,193.124916666667,566.494633333333,271361,271538,177
101,35,==,197,201.3617,520.356716666667,271538,271718,180
101,0,blank,0,190.280633333333,488.7075,271718,271809,91
101,0,blank,0,261.06,499.488283333333,271839,272022,183
101,35,-1,198,221.941233333333,521.699366666667,272022,272200,178
101,0,blank,0,197.337766666667,538.6241,272200,272379,179
101,0,blank,0,229.258783333333,532.40935,272379,272559,180
101,35,),199,237.292333333333,514.4838,272559,272740,181
101,0,blank,0,228.440366666667,537.67845,272740,272920,180
101,0,blank,0,198.68945,573.002833333333,272920,273098,178
101,37,-1,202,157.19966,572.75054,273098,273248,150
101,23,"\nTheelementfoundat%dlocation",147,216.629683333333,262.719,273279,273461,182
101,23,"\nTheelementfoundat%dlocation",147,220.1261,258.3308,273461,273490,29
101,35,-1,198,221.4836,512.8805,273551,273736,185
101,0,blank,0,245.0003,522.1973,273736,273915,179
101,0,blank,0,257.25335,517.792766666667,273915,274092,177
101,33,;,191,195.8101,485.778,274092,274123,31
101,23,"\nTheelementfoundat%dlocation",147,159.008425,264.102575,274332,274478,146
101,23,"\nTheelementfoundat%dlocation",147,424.133375,260.06095,274528,274698,170
101,23,"\nTheelementfoundat%dlocation",147,424.77295,253.24415,274698,274789,91
101,0,blank,0,402.5094,243.9263,274920,274961,41
101,0,blank,0,212.690475,240.06345,275003,275175,172
101,21,list,130,215.684516666667,215.124316666667,275175,275367,192
101,21,list,130,209.878933333333,220.385433333333,275367,275545,178
101,21,key,136,373.4548,214.5502,275575,275604,29
101,0,blank,0,533.047566666667,233.060683333333,275634,275817,183
101,0,blank,0,558.525683333333,247.465883333333,275817,275995,178
101,0,blank,0,560.431266666667,231.88475,275995,276173,178
101,0,blank,0,539.485366666667,221.45965,276173,276350,177
101,0,blank,0,537.198983333333,226.371933333333,276350,276530,180
101,0,blank,0,518.535866666667,226.803233333333,276530,276709,179
101,0,blank,0,529.202216666667,227.462983333333,276709,276888,179
101,0,blank,0,568.96908,223.71942,276888,277060,172
101,0,blank,0,298.68125,225.85895,277152,277338,186
101,0,blank,0,294.31222,231.2096,277338,277532,194
101,0,blank,0,300.4787,235.715133333333,277532,277710,178
101,0,blank,0,317.2991,283.3426,277710,277740,30
101,23,"\nTheelementfoundat%dlocation",147,185.676433333333,260.090116666667,277771,277951,180
101,23,"\nTheelementfoundat%dlocation",147,181.696166666667,255.222883333333,277951,278132,181
101,25,"\nTheelementisnotfound",157,214.7991,295.4417,278132,278162,30
101,0,blank,0,388.681266666667,276.611783333333,278192,278371,179
101,0,blank,0,-323,-105,278431,278605,174
101,0,blank,0,-321.986266666667,504.734866666667,278748,278870,122
101,0,blank,0,276.531516666667,551.7831,279022,279206,184
101,0,blank,0,231.96798,565.69712,279206,279363,157
101,0,blank,0,241.77935,537.30695,279422,279483,61
101,0,blank,0,247.0988,492.929033333333,279516,279699,183
101,0,blank,0,278.90458,510.62566,279699,279885,186
101,0,blank,0,283.809483333333,501.7034,279949,280133,184
101,0,blank,0,252.249916666667,607.847016666667,280133,280313,180
101,0,blank,0,296.451633333333,608.534216666667,280313,280496,183
101,0,blank,0,369.967016666667,632.4656,280496,280677,181
101,41,size,215,447.317966666667,650.3163,280677,280858,181
101,0,blank,0,475.863966666667,664.238583333333,280858,281044,186
101,0,blank,0,454.542533333333,634.602816666667,281044,281234,190
101,0,blank,0,461.654966666667,637.2477,281234,281422,188
101,0,blank,0,462.343183333333,648.448433333333,281422,281606,184
101,41,key,219,513.13395,648.0076,281606,281792,186
101,0,blank,0,474.679466666667,655.037433333333,281792,281980,188
101,0,blank,0,392.541316666667,668.37525,281980,282171,191
101,41,size,215,450.440533333333,654.7097,282171,282361,190
101,41,comma,218,495.318783333333,651.97395,282361,282548,187
101,41,key,219,529.687366666667,656.21255,282548,282740,192
101,0,blank,0,-323,-105,282771,282958,187
101,0,blank,0,-323,-105,282958,283137,179
101,0,blank,0,-323,-105,283137,283314,177
101,0,blank,0,-323,-105,283314,283492,178
101,0,blank,0,-323,-105,283492,283672,180
101,0,blank,0,-323,-105,283672,283818,146
101,0,blank,0,-323,-105,283818,283982,164
101,0,blank,0,-323,-105,283982,284174,192
101,0,blank,0,-323,-105,284174,284352,178
101,0,blank,0,-323,-105,284352,284531,179
101,0,blank,0,-323,-105,284531,284725,194
101,0,blank,0,-323,-105,284725,284757,32
101,0,blank,0,-323,-105,284757,284952,195
101,0,blank,0,-323,-105,284952,285153,201
101,0,blank,0,-323,-105,285153,285389,236
101,0,blank,0,-323,-105,285389,285567,178
101,0,blank,0,-323,-105,285567,285745,178
101,0,blank,0,-323,-105,285745,285782,37
101,0,blank,0,-323,-105,285782,286038,256
101,0,blank,0,-323,-105,286038,286292,254
101,0,blank,0,-323,-105,286292,286546,254
101,0,blank,0,-323,-105,286546,286726,180
101,0,blank,0,-323,-105,286726,286906,180
101,0,blank,0,-323,-105,286906,287026,120
101,0,blank,0,-323,-105,287026,287228,202
101,0,blank,0,-323,-105,287228,287251,23
101,0,blank,0,-323,-105,287251,287538,287
101,0,blank,0,-323,-105,287538,287745,207
101,0,blank,0,-323,-105,287745,287915,170
101,0,blank,0,565.6663,302.048,287955,288085,130
101,0,blank,0,-323,-105,288696,288885,189
101,0,blank,0,-323,-105,288885,288978,93
